,Cod_setor,0a9,10a19,20a29,30a39,40a49,50a59,60a69,70a,jovens,idosos,total_censo,perc_idosos
0,330010005000001,22,39,53,56,48,68,56,68,286,124,410,30.24390243902439
1,330010005000002,7,14,21,26,19,25,9,22,112,31,143,21.678321678321677
2,330010005000003,103,161,157,179,152,136,84,83,888,167,1055,15.829383886255924
3,330010005000004,12,31,16,40,31,40,23,26,170,49,219,22.374429223744293
4,330010005000005,99,124,123,117,104,81,39,22,648,61,709,8.603667136812412
5,330010005000006,95,89,101,112,131,104,55,53,632,108,740,14.594594594594595
6,330010005000007,164,175,253,194,154,112,91,43,1052,134,1186,11.298482293423271
7,330010005000008,110,118,144,118,134,99,64,42,723,106,829,12.78648974668275
8,330010005000009,36,91,83,87,108,108,64,87,513,151,664,22.740963855421686
9,330010005000010,51,76,62,63,77,90,62,79,419,141,560,25.178571428571427
10,330010005000011,73,126,151,113,157,134,66,85,754,151,905,16.685082872928177
11,330010005000012,131,173,168,149,162,91,64,52,874,116,990,11.717171717171718
12,330010005000013,80,94,141,145,79,77,39,32,616,71,687,10.334788937409025
13,330010005000014,80,80,118,121,74,67,31,36,540,67,607,11.037891268533773
14,330010005000015,105,117,140,162,114,103,70,59,741,129,870,14.827586206896552
15,330010005000016,68,82,97,81,93,55,30,23,476,53,529,10.01890359168242
16,330010005000017,69,101,139,130,122,104,79,33,665,112,777,14.414414414414415
17,330010005000018,149,180,212,157,204,125,72,50,1027,122,1149,10.61792863359443
18,330010005000019,186,248,236,215,158,88,56,27,1131,83,1214,6.8369028006589785
19,330010005000020,74,90,126,182,89,55,26,16,616,42,658,6.382978723404255
20,330010005000021,97,130,163,150,170,107,74,59,817,133,950,14.0
21,330010005000022,107,111,153,163,139,132,60,39,805,99,904,10.951327433628318
22,330010005000023,133,142,171,250,149,166,98,38,1011,136,1147,11.857018308631211
23,330010005000024,42,69,51,83,61,45,30,15,351,45,396,11.363636363636363
24,330010005000025,119,158,133,128,93,87,33,9,718,42,760,5.526315789473684
25,330010005000026,89,98,85,80,53,50,19,15,455,34,489,6.952965235173824
26,330010005000027,40,43,38,37,12,18,2,2,188,4,192,2.0833333333333335
27,330010005000028,171,305,322,210,211,116,54,47,1335,101,1436,7.0334261838440115
28,330010005000029,142,163,162,159,100,72,27,7,798,34,832,4.086538461538462
29,330010005000030,23,32,36,39,49,25,6,5,204,11,215,5.116279069767442
30,330010005000031,143,186,191,198,200,154,72,41,1072,113,1185,9.535864978902953
31,330010005000032,70,74,90,110,127,81,47,34,552,81,633,12.796208530805687
32,330010005000033,17,6,1,27,15,2,1,2,68,3,71,4.225352112676056
33,330010005000034,11,8,15,6,14,10,3,3,64,6,70,8.571428571428571
34,330010005000035,58,72,72,96,88,87,53,37,473,90,563,15.985790408525755
35,330010005000036,26,30,33,43,30,31,19,3,193,22,215,10.232558139534884
36,330010005000037,76,126,80,113,86,61,32,18,542,50,592,8.445945945945946
37,330010005000038,26,24,28,27,21,20,6,2,146,8,154,5.194805194805195
38,330010005000040,0,6,6,6,9,4,3,1,31,4,35,11.428571428571429
39,330010005000041,57,77,86,68,88,69,38,26,445,64,509,12.573673870333987
40,330010005000044,51,54,71,64,61,58,33,18,359,51,410,12.439024390243903
41,330010005000045,229,261,291,261,224,163,85,73,1429,158,1587,9.955891619407687
42,330010005000046,135,170,201,191,147,102,73,50,946,123,1069,11.506080449017773
43,330010005000047,68,80,78,91,82,59,41,31,458,72,530,13.584905660377359
44,330010005000048,158,185,206,176,191,131,68,51,1047,119,1166,10.20583190394511
45,330010005000049,46,73,92,84,77,70,39,29,442,68,510,13.333333333333334
46,330010005000050,24,36,61,49,30,34,23,11,234,34,268,12.686567164179104
47,330010005000051,145,166,171,139,100,82,36,24,803,60,863,6.952491309385863
48,330010005000052,102,106,112,101,90,54,27,8,565,35,600,5.833333333333333
49,330010005000053,16,27,28,32,26,16,10,12,145,22,167,13.173652694610778
50,330010005000054,161,198,192,166,155,85,37,23,957,60,1017,5.899705014749262
51,330010005000055,140,179,176,227,186,124,104,55,1032,159,1191,13.350125944584383
52,330010005000056,145,202,188,169,160,116,38,28,980,66,1046,6.309751434034417
53,330010005000057,110,138,173,143,104,82,36,18,750,54,804,6.7164179104477615
54,330010005000058,112,106,174,151,95,87,50,20,725,70,795,8.80503144654088
55,330010005000059,53,86,93,72,87,66,41,16,457,57,514,11.089494163424124
56,330010005000060,250,273,225,252,166,103,53,27,1269,80,1349,5.930318754633062
57,330010005000061,126,159,130,140,119,71,28,20,745,48,793,6.0529634300126105
58,330010005000062,132,168,189,199,155,142,66,25,985,91,1076,8.45724907063197
59,330010005000063,70,69,111,130,99,68,27,11,547,38,585,6.495726495726496
60,330010005000064,49,83,104,71,72,74,27,20,453,47,500,9.4
61,330010005000065,109,133,190,134,131,136,53,23,833,76,909,8.36083608360836
62,330010005000066,6,14,10,10,13,7,3,3,60,6,66,9.090909090909092
63,330010005000067,129,159,190,157,147,105,44,10,887,54,941,5.738575982996812
64,330010005000068,130,120,202,146,143,154,73,35,895,108,1003,10.767696909272184
65,330010005000069,106,128,181,131,103,101,33,22,750,55,805,6.832298136645963
66,330010005000070,31,49,66,45,41,35,14,5,267,19,286,6.643356643356643
67,330010005000071,87,107,148,126,116,178,77,27,762,104,866,12.009237875288683
68,330010005000072,106,131,104,124,148,87,24,5,700,29,729,3.978052126200274
69,330010005000073,125,141,137,118,92,58,22,14,671,36,707,5.091937765205092
70,330010005000074,58,49,54,63,38,19,16,8,281,24,305,7.868852459016393
71,330010005000075,180,209,205,175,126,105,46,27,1000,73,1073,6.803355079217148
72,330010005000076,131,127,156,141,102,101,43,26,758,69,827,8.34340991535671
73,330010005000077,112,146,139,116,84,70,25,23,667,48,715,6.713286713286713
74,330010005000078,150,172,158,149,110,76,38,24,815,62,877,7.069555302166477
75,330010005000079,149,181,148,171,133,78,43,23,860,66,926,7.1274298056155505
76,330010005000080,86,91,83,108,74,70,48,32,512,80,592,13.513513513513514
77,330010005000081,48,69,55,55,71,43,23,26,341,49,390,12.564102564102564
78,330010005000082,35,23,40,35,25,32,24,6,190,30,220,13.636363636363637
79,330010005000083,51,49,53,47,37,29,14,18,266,32,298,10.738255033557047
80,330010005000084,16,16,6,9,10,9,4,3,66,7,73,9.58904109589041
81,330010005000085,2,2,3,4,0,2,2,1,13,3,16,18.75
82,330010005000086,69,89,97,96,122,55,15,4,528,19,547,3.473491773308958
83,330010005000087,54,66,60,62,55,34,25,18,331,43,374,11.497326203208557
84,330010005000088,83,98,88,85,66,46,29,22,466,51,517,9.864603481624759
85,330010005000089,25,23,19,27,29,12,25,9,135,34,169,20.118343195266274
86,330010005000090,69,88,80,105,82,78,43,30,502,73,575,12.695652173913043
87,330010005000091,1,8,0,3,4,3,4,5,19,9,28,32.142857142857146
88,330010005000092,220,234,274,243,162,101,82,47,1234,129,1363,9.46441672780631
89,330010005000093,50,67,71,77,66,57,48,33,388,81,469,17.270788912579956
90,330010005000094,124,161,107,119,106,59,33,26,676,59,735,8.02721088435374
91,330010005000095,31,42,43,31,32,29,17,11,208,28,236,11.864406779661017
92,330010005000096,10,8,5,15,9,2,4,2,49,6,55,10.909090909090908
93,330010005000097,3,3,6,5,4,3,1,1,24,2,26,7.6923076923076925
94,330010005000098,114,145,156,123,143,93,31,37,774,68,842,8.076009501187649
95,330010005000099,107,117,116,111,127,58,44,16,636,60,696,8.620689655172415
96,330010005000100,67,65,81,92,98,66,46,27,469,73,542,13.468634686346864
97,330010005000101,63,101,101,101,109,110,54,36,585,90,675,13.333333333333334
98,330010005000102,139,141,147,140,89,45,25,6,701,31,732,4.2349726775956285
99,330010005000103,45,81,71,47,69,45,18,8,358,26,384,6.770833333333333
100,330010005000104,143,142,184,166,89,87,32,18,811,50,861,5.807200929152149
101,330010005000105,95,72,71,81,67,30,23,16,416,39,455,8.571428571428571
102,330010005000106,54,82,96,78,83,83,62,49,476,111,587,18.909710391822827
103,330010005000107,82,94,108,91,89,71,40,22,535,62,597,10.385259631490788
104,330010005000108,35,45,37,48,45,33,32,22,243,54,297,18.181818181818183
105,330010010000001,81,94,107,97,90,43,37,23,512,60,572,10.48951048951049
106,330010010000002,150,128,195,197,116,106,60,39,892,99,991,9.989909182643794
107,330010010000003,38,56,80,58,55,59,42,20,346,62,408,15.196078431372548
108,330010010000004,65,84,77,62,56,41,21,18,385,39,424,9.19811320754717
109,330010010000005,5,3,3,7,6,1,5,3,25,8,33,24.242424242424242
110,330010010000007,7,2,4,14,5,4,2,2,36,4,40,10.0
111,330010010000008,21,13,12,17,14,25,7,9,102,16,118,13.559322033898304
114,330010010000011,26,24,21,16,21,20,17,7,128,24,152,15.789473684210526
115,330010010000012,8,20,16,6,19,14,10,14,83,24,107,22.429906542056074
116,330010010000013,9,8,15,4,6,5,2,0,47,2,49,4.081632653061225
117,330010010000014,7,3,3,8,1,1,4,4,23,8,31,25.806451612903224
118,330010010000015,9,17,16,12,22,10,14,9,86,23,109,21.10091743119266
119,330010010000016,50,54,39,41,35,22,17,16,241,33,274,12.043795620437956
120,330010010000018,18,25,38,27,17,26,23,17,151,40,191,20.94240837696335
121,330010010000019,8,8,8,8,2,0,6,0,34,6,40,15.0
122,330010010000020,138,188,163,169,140,98,63,26,896,89,985,9.035532994923859
124,330010010000022,13,13,26,13,13,4,8,3,82,11,93,11.827956989247312
125,330010010000023,19,59,47,33,45,34,19,9,237,28,265,10.566037735849056
126,330010010000024,0,0,0,1,2,3,2,3,6,5,11,45.45454545454545
127,330010010000031,13,15,25,16,9,22,10,6,100,16,116,13.793103448275861
128,330010015000001,83,99,101,110,93,85,32,31,571,63,634,9.936908517350158
129,330010015000002,102,114,139,127,112,72,53,37,666,90,756,11.904761904761905
130,330010015000003,26,28,16,22,35,30,15,10,157,25,182,13.736263736263735
131,330010015000004,20,20,19,35,18,26,5,5,138,10,148,6.756756756756757
132,330010015000005,26,25,16,20,24,13,6,2,124,8,132,6.0606060606060606
133,330010015000006,209,231,231,188,134,51,31,15,1044,46,1090,4.220183486238532
134,330010015000007,172,193,203,188,132,76,32,24,964,56,1020,5.490196078431373
135,330010015000008,148,186,193,211,122,86,26,16,946,42,988,4.251012145748988
136,330010015000009,155,171,166,206,127,72,37,29,897,66,963,6.853582554517134
137,330010015000010,127,146,182,194,143,92,41,20,884,61,945,6.455026455026455
138,330010015000011,81,92,129,99,100,66,41,24,567,65,632,10.284810126582279
139,330010015000012,52,73,85,103,66,57,24,14,436,38,474,8.016877637130802
140,330010015000013,69,82,73,77,33,26,9,9,360,18,378,4.761904761904762
141,330010015000014,272,265,283,247,160,91,43,23,1318,66,1384,4.76878612716763
144,330010015000017,18,37,48,40,55,71,40,8,269,48,317,15.141955835962145
145,330010015000018,8,12,11,7,15,13,6,7,66,13,79,16.455696202531644
146,330010015000019,374,494,325,329,370,164,80,29,2056,109,2165,5.034642032332563
147,330010015000020,93,158,86,131,108,29,6,6,605,12,617,1.9448946515397083
148,330010015000021,1,2,2,1,2,5,2,0,13,2,15,13.333333333333334
149,330010015000022,44,57,54,45,68,52,27,16,320,43,363,11.845730027548209
150,330010015000023,20,19,28,29,32,20,15,3,148,18,166,10.843373493975903
151,330010015000024,91,50,32,106,49,7,5,3,335,8,343,2.3323615160349855
152,330010015000025,180,267,254,195,161,100,51,32,1157,83,1240,6.693548387096774
153,330010015000026,175,186,182,270,208,152,66,29,1173,95,1268,7.492113564668769
154,330010015000027,52,57,52,61,41,30,23,17,293,40,333,12.012012012012011
155,330010015000028,208,230,255,277,176,126,52,29,1272,81,1353,5.986696230598669
156,330010015000029,92,135,139,113,86,49,29,24,614,53,667,7.946026986506746
157,330010015000030,141,139,171,183,101,69,41,25,804,66,870,7.586206896551724
158,330010015000031,144,138,179,156,107,100,46,23,824,69,893,7.726763717805151
159,330010015000032,144,177,130,134,87,46,26,14,718,40,758,5.277044854881266
160,330010015000033,272,339,239,272,161,76,30,25,1359,55,1414,3.8896746817538896
161,330010015000034,253,285,236,208,144,108,64,29,1234,93,1327,7.008289374529013
162,330010015000035,161,146,167,154,139,75,40,20,842,60,902,6.651884700665189
163,330010015000036,248,252,279,282,205,109,44,29,1375,73,1448,5.041436464088398
164,330010015000037,122,149,170,155,120,96,21,28,812,49,861,5.691056910569106
165,330010015000038,203,325,172,300,231,79,33,29,1310,62,1372,4.518950437317784
166,330010015000039,253,275,332,241,186,88,56,40,1375,96,1471,6.5261726716519375
167,330010015000040,188,248,231,166,155,82,36,34,1070,70,1140,6.140350877192983
168,330010015000041,131,188,196,212,110,62,42,18,899,60,959,6.256517205422315
169,330010015000042,136,138,200,176,130,83,58,33,863,91,954,9.538784067085954
170,330010015000043,264,313,253,219,194,138,73,27,1381,100,1481,6.75219446320054
171,330010015000044,164,225,165,119,127,73,46,16,873,62,935,6.6310160427807485
172,330010015000045,122,132,136,117,93,67,32,22,667,54,721,7.489597780859917
173,330010015000046,136,165,169,133,129,101,51,31,833,82,915,8.96174863387978
174,330010015000047,114,135,117,121,96,60,36,24,643,60,703,8.534850640113797
175,330010015000048,118,128,158,115,96,83,44,25,698,69,767,8.996088657105606
176,330010015000049,192,176,182,177,113,77,65,27,917,92,1009,9.117938553022794
177,330010015000050,36,59,57,45,53,33,21,9,283,30,313,9.584664536741213
178,330010015000051,34,47,51,50,39,37,17,13,258,30,288,10.416666666666666
180,330010015000053,3,4,1,3,3,2,0,1,16,1,17,5.882352941176471
181,330010015000055,28,23,34,34,37,18,8,6,174,14,188,7.446808510638298
182,330010015000057,135,164,143,154,98,58,22,1,752,23,775,2.967741935483871
183,330010015000058,60,94,85,87,60,31,11,8,417,19,436,4.3577981651376145
184,330010015000059,128,167,162,150,101,64,39,17,772,56,828,6.763285024154589
185,330010015000060,174,187,160,139,123,72,27,21,855,48,903,5.3156146179401995
186,330010015000061,151,250,244,249,164,97,65,41,1155,106,1261,8.406026962727994
187,330010015000062,7,7,8,4,5,3,4,2,34,6,40,15.0
188,330010015000063,55,80,56,82,55,25,14,4,353,18,371,4.8517520215633425
189,330010015000064,111,118,112,113,101,49,23,16,604,39,643,6.065318818040436
190,330010015000065,114,165,136,107,105,71,34,14,698,48,746,6.434316353887399
191,330010015000066,119,124,156,134,94,62,17,18,689,35,724,4.834254143646409
192,330010015000067,187,186,209,146,101,51,25,16,880,41,921,4.451682953311618
193,330010015000068,264,347,282,227,193,95,63,27,1408,90,1498,6.008010680907877
194,330010015000069,86,100,64,82,50,27,13,12,409,25,434,5.76036866359447
195,330010015000070,153,148,133,142,85,46,39,18,707,57,764,7.460732984293194
196,330010015000071,164,186,155,136,95,73,48,17,809,65,874,7.437070938215103
197,330010015000072,215,223,184,191,164,100,42,20,1077,62,1139,5.443371378402107
198,330010015000073,175,186,165,162,130,72,32,20,890,52,942,5.520169851380042
199,330010015000074,143,188,177,142,107,120,47,33,877,80,957,8.359456635318704
200,330010015000075,152,163,208,164,128,107,67,32,922,99,1021,9.69637610186092
201,330010015000076,122,121,100,141,82,55,23,22,621,45,666,6.756756756756757
202,330010015000077,117,121,151,110,101,75,38,21,675,59,734,8.038147138964577
203,330010015000078,102,99,107,125,84,52,34,25,569,59,628,9.394904458598726
204,330010015000079,25,32,32,30,20,11,11,3,150,14,164,8.536585365853659
205,330010015000080,5,23,11,5,10,3,1,0,57,1,58,1.7241379310344827
206,330010015000081,76,76,86,82,80,67,41,23,467,64,531,12.052730696798493
207,330010015000082,53,67,51,68,68,26,23,24,333,47,380,12.368421052631579
208,330010015000083,38,42,43,45,31,36,14,12,235,26,261,9.96168582375479
209,330010015000084,40,55,41,32,33,22,18,4,223,22,245,8.979591836734693
210,330010015000085,2,7,5,2,5,0,3,0,21,3,24,12.5
212,330010015000087,1,3,13,2,3,2,4,1,24,5,29,17.24137931034483
213,330010015000090,119,66,53,25,10,7,6,12,280,18,298,6.040268456375839
214,330010015000091,7,3,5,5,3,3,2,0,26,2,28,7.142857142857143
215,330010015000092,13,17,10,9,3,7,2,1,59,3,62,4.838709677419355
216,330010015000093,125,154,217,159,86,74,23,22,815,45,860,5.232558139534884
217,330010015000094,34,28,21,27,15,23,12,7,148,19,167,11.377245508982035
218,330010015000095,47,89,90,72,55,38,25,6,391,31,422,7.345971563981043
219,330010015000096,119,139,111,96,91,56,30,15,612,45,657,6.8493150684931505
220,330010015000097,82,129,88,83,72,48,18,20,502,38,540,7.037037037037037
221,330010015000098,294,372,281,295,266,152,96,59,1660,155,1815,8.539944903581267
222,330010015000099,135,203,202,196,117,90,49,30,943,79,1022,7.729941291585127
223,330010015000100,152,172,163,130,84,70,34,19,771,53,824,6.432038834951456
224,330010015000101,253,316,314,269,221,117,49,42,1490,91,1581,5.755850727387729
225,330010015000102,107,113,127,118,88,61,34,20,614,54,668,8.083832335329342
226,330010015000103,152,189,143,115,94,56,34,11,749,45,794,5.667506297229219
227,330010015000104,86,116,124,152,114,73,32,22,665,54,719,7.510431154381084
228,330010015000105,114,133,131,129,82,55,51,17,644,68,712,9.55056179775281
229,330010015000106,170,194,189,150,126,66,37,35,895,72,967,7.445708376421924
230,330010015000107,164,198,204,125,117,71,12,10,879,22,901,2.4417314095449503
231,330010015000108,144,177,208,158,156,124,52,34,967,86,1053,8.167141500474834
232,330010015000109,238,271,286,211,148,86,43,31,1240,74,1314,5.6316590563165905
233,330010025000001,75,119,97,108,109,95,63,40,603,103,706,14.589235127478753
235,330010025000003,12,28,17,25,17,14,15,4,113,19,132,14.393939393939394
236,330010025000004,121,86,105,130,129,152,39,9,723,48,771,6.22568093385214
237,330010025000005,100,104,142,162,122,142,32,10,772,42,814,5.15970515970516
238,330010025000006,85,120,108,106,85,75,36,20,579,56,635,8.818897637795276
239,330010025000007,141,136,160,150,81,61,29,15,729,44,773,5.692108667529108
240,330010025000008,132,142,190,139,104,81,37,32,788,69,857,8.051341890315053
241,330010025000009,124,137,146,138,89,108,44,20,742,64,806,7.94044665012407
242,330010025000010,122,131,163,113,92,65,27,15,686,42,728,5.769230769230769
243,330010025000011,197,164,171,196,119,81,38,13,928,51,979,5.209397344228805
244,330010025000012,66,80,93,99,62,41,19,12,441,31,472,6.567796610169491
245,330010025000013,68,98,111,97,101,45,15,6,520,21,541,3.8817005545286505
246,330010025000014,84,95,137,114,84,99,41,22,613,63,676,9.319526627218934
247,330010025000015,71,91,104,111,73,96,43,16,546,59,605,9.75206611570248
248,330010025000016,66,71,80,81,56,25,15,12,379,27,406,6.650246305418719
249,330010025000017,119,149,155,117,96,76,31,16,712,47,759,6.19235836627141
250,330010025000018,148,145,198,132,115,99,59,22,837,81,918,8.823529411764707
251,330010025000019,219,243,232,240,172,155,64,33,1261,97,1358,7.142857142857143
252,330010025000020,222,268,213,202,130,98,37,15,1133,52,1185,4.3881856540084385
254,330010025000022,199,266,215,167,161,114,54,35,1122,89,1211,7.349298100743187
255,330010025000023,78,102,94,89,88,45,25,21,496,46,542,8.487084870848708
256,330010025000024,75,104,103,81,57,48,21,14,468,35,503,6.958250497017892
257,330010025000025,248,311,260,250,198,158,59,30,1425,89,1514,5.878467635402906
258,330010025000026,78,78,80,73,65,65,15,9,439,24,463,5.183585313174946
259,330010025000027,131,150,132,120,92,50,35,9,675,44,719,6.119610570236439
260,330010025000028,196,215,211,128,149,102,53,29,1001,82,1083,7.571560480147737
261,330010025000029,192,243,186,162,138,89,42,30,1010,72,1082,6.654343807763401
262,330010025000030,11,23,8,13,13,19,18,10,87,28,115,24.347826086956523
263,330010025000031,17,12,15,13,14,13,4,1,84,5,89,5.617977528089888
264,330010025000032,126,122,152,139,97,76,26,5,712,31,743,4.172274562584119
265,330015905000001,73,86,125,103,97,106,70,56,590,126,716,17.59776536312849
266,330015905000002,97,91,98,112,78,44,53,31,520,84,604,13.907284768211921
267,330015905000003,55,82,96,72,104,90,64,68,499,132,631,20.91917591125198
268,330015905000004,73,98,92,109,104,88,59,52,564,111,675,16.444444444444443
269,330015905000005,82,91,107,99,93,63,35,32,535,67,602,11.129568106312293
270,330015905000006,57,71,88,80,59,38,31,37,393,68,461,14.750542299349242
271,330015905000007,124,140,187,164,173,143,84,72,931,156,1087,14.351425942962281
272,330015905000008,96,136,142,129,130,97,61,68,730,129,859,15.017462165308498
273,330015905000009,83,101,140,93,113,69,51,31,599,82,681,12.041116005873715
274,330015905000010,116,113,143,90,96,84,46,38,642,84,726,11.570247933884298
275,330015905000011,87,95,92,84,76,50,47,25,484,72,556,12.949640287769784
276,330015905000012,55,54,81,86,59,56,34,17,391,51,442,11.538461538461538
277,330015905000013,50,72,74,93,86,42,40,35,417,75,492,15.24390243902439
278,330015905000014,40,41,53,36,34,35,35,20,239,55,294,18.707482993197278
279,330015905000015,58,95,90,61,75,74,53,43,453,96,549,17.48633879781421
280,330015905000016,105,157,142,128,117,107,47,35,756,82,838,9.785202863961814
281,330020905000001,50,53,62,63,78,62,45,52,368,97,465,20.86021505376344
282,330020905000002,86,111,102,113,107,99,58,50,618,108,726,14.87603305785124
283,330020905000003,59,63,66,64,79,51,38,33,382,71,453,15.673289183222957
284,330020905000004,22,26,29,31,20,32,18,15,160,33,193,17.098445595854923
285,330020905000005,79,93,101,103,77,81,45,38,534,83,617,13.452188006482983
286,330020905000006,52,73,65,56,84,35,31,26,365,57,422,13.507109004739336
287,330020905000007,30,36,47,43,34,31,24,26,221,50,271,18.45018450184502
288,330020905000008,28,40,46,31,42,38,40,45,225,85,310,27.419354838709676
289,330020905000009,41,48,51,57,47,39,31,26,283,57,340,16.764705882352942
290,330020905000010,50,60,51,58,60,45,23,22,324,45,369,12.195121951219512
291,330020905000011,63,111,65,79,100,63,39,37,481,76,557,13.644524236983843
292,330020905000012,20,28,15,27,14,25,18,7,129,25,154,16.233766233766232
293,330020905000013,43,40,44,33,47,62,35,32,269,67,336,19.94047619047619
294,330020905000014,20,27,31,38,34,45,39,35,195,74,269,27.509293680297397
295,330020905000015,29,36,31,33,33,31,37,35,193,72,265,27.169811320754718
296,330020905000016,34,51,49,39,40,38,18,18,251,36,287,12.543554006968641
297,330020905000017,97,121,80,87,81,62,43,29,528,72,600,12.0
298,330020905000018,15,37,22,26,34,32,23,28,166,51,217,23.502304147465438
299,330020905000019,51,53,55,64,38,59,48,40,320,88,408,21.568627450980394
300,330020905000020,38,38,32,35,43,29,45,24,215,69,284,24.295774647887324
301,330020905000021,78,74,86,88,59,65,42,25,450,67,517,12.959381044487428
302,330020905000022,59,76,63,57,55,73,32,24,383,56,439,12.75626423690205
303,330020905000023,26,42,21,36,37,23,23,13,185,36,221,16.289592760180994
304,330020905000024,28,26,24,30,34,18,27,17,160,44,204,21.568627450980394
305,330020905000025,17,33,26,22,32,34,23,18,164,41,205,20.0
306,330020905000026,12,19,31,31,20,36,13,25,149,38,187,20.32085561497326
307,330020905000027,21,29,25,27,26,30,23,21,158,44,202,21.782178217821784
308,330020905000028,27,39,46,33,55,40,33,42,240,75,315,23.80952380952381
309,330020905000029,51,61,45,59,63,49,39,34,328,73,401,18.204488778054863
310,330020905000030,43,51,48,45,45,44,24,21,276,45,321,14.018691588785046
311,330020905000031,69,86,78,65,48,64,50,26,410,76,486,15.637860082304528
312,330020905000032,44,66,30,61,61,68,45,34,330,79,409,19.315403422982886
313,330020905000033,25,46,34,48,47,42,30,19,242,49,291,16.83848797250859
314,330020905000034,31,45,48,45,51,68,52,58,288,110,398,27.63819095477387
315,330020905000035,61,77,84,62,65,68,45,31,417,76,493,15.415821501014198
316,330020905000036,79,71,92,80,90,73,75,43,485,118,603,19.56882255389718
317,330020905000037,69,115,110,92,105,94,71,65,585,136,721,18.8626907073509
318,330020905000038,124,130,86,108,96,64,40,31,608,71,679,10.456553755522828
319,330020905000039,88,115,82,96,81,60,37,21,522,58,580,10.0
320,330020905000040,102,106,107,95,92,88,41,38,590,79,669,11.80866965620329
321,330020905000041,122,188,163,144,140,95,57,47,852,104,956,10.878661087866108
322,330020905000042,73,81,87,68,65,58,16,7,432,23,455,5.054945054945055
323,330020905000043,76,91,111,66,85,83,48,38,512,86,598,14.381270903010034
324,330020905000044,49,73,56,55,62,48,23,26,343,49,392,12.5
325,330020905000045,33,59,70,42,52,64,28,38,320,66,386,17.098445595854923
326,330020905000046,56,74,59,63,69,55,50,37,376,87,463,18.79049676025918
327,330020905000047,55,73,74,77,84,65,75,62,428,137,565,24.24778761061947
328,330020905000048,53,81,88,68,92,77,46,56,459,102,561,18.181818181818183
329,330020905000049,48,87,101,64,86,65,44,36,451,80,531,15.065913370998116
330,330020905000050,46,71,71,63,74,62,49,68,387,117,504,23.214285714285715
331,330020905000051,86,102,87,89,95,50,37,33,509,70,579,12.089810017271157
332,330020905000052,83,134,122,104,122,83,63,61,648,124,772,16.06217616580311
333,330020905000053,97,96,97,107,117,77,49,43,591,92,683,13.469985358711567
334,330020905000054,110,166,97,121,124,83,65,39,701,104,805,12.919254658385093
335,330020905000055,141,163,125,113,110,82,47,38,734,85,819,10.378510378510379
336,330020905000056,109,124,108,102,104,74,52,47,621,99,720,13.75
337,330020905000057,96,105,109,103,94,74,45,39,581,84,665,12.631578947368421
338,330020905000058,115,144,115,167,148,95,59,52,784,111,895,12.402234636871508
339,330020905000059,31,37,27,34,36,21,33,17,186,50,236,21.1864406779661
340,330020905000060,82,116,128,106,102,88,49,36,622,85,707,12.022630834512023
341,330020905000061,110,94,87,102,67,49,26,13,509,39,548,7.116788321167883
342,330020905000062,95,110,91,108,79,57,27,17,540,44,584,7.534246575342466
343,330020905000063,74,89,103,60,102,55,31,40,483,71,554,12.815884476534295
344,330020905000064,124,170,147,176,134,117,65,50,868,115,983,11.698880976602238
345,330020905000065,93,133,110,99,89,77,43,30,601,73,674,10.830860534124628
346,330020905000066,107,117,119,122,127,104,52,56,696,108,804,13.432835820895523
347,330020905000067,87,96,117,120,90,73,47,35,583,82,665,12.330827067669173
348,330020905000068,26,39,25,26,34,28,11,19,178,30,208,14.423076923076923
349,330020905000069,36,43,49,33,24,37,25,17,222,42,264,15.909090909090908
350,330020905000070,135,211,201,151,146,86,49,24,930,73,1003,7.278165503489531
351,330020905000071,73,117,115,120,84,68,56,44,577,100,677,14.771048744460856
352,330020905000072,54,52,68,65,58,57,42,30,354,72,426,16.901408450704224
353,330020905000073,38,37,67,51,43,32,40,36,268,76,344,22.093023255813954
354,330020905000074,59,62,104,94,98,88,67,65,505,132,637,20.722135007849293
355,330020905000075,33,26,49,38,49,47,23,38,242,61,303,20.13201320132013
356,330020905000076,86,114,101,110,109,98,76,65,618,141,759,18.57707509881423
357,330020905000077,31,36,36,40,23,34,35,48,200,83,283,29.328621908127207
358,330020905000078,25,50,43,41,50,33,21,27,242,48,290,16.551724137931036
359,330020905000079,30,75,61,71,68,59,49,52,364,101,465,21.72043010752688
360,330020905000080,78,78,105,99,86,97,48,62,543,110,653,16.84532924961715
361,330020905000081,132,139,180,177,136,129,85,66,893,151,1044,14.46360153256705
362,330020905000082,55,104,85,78,78,87,61,44,487,105,592,17.736486486486488
363,330020905000083,102,88,103,83,61,58,40,31,495,71,566,12.54416961130742
364,330020905000084,75,78,80,70,60,51,25,20,414,45,459,9.803921568627452
365,330020905000085,134,106,162,162,102,99,59,49,765,108,873,12.371134020618557
366,330020905000086,53,51,70,60,42,43,26,16,319,42,361,11.634349030470915
367,330020905000087,42,62,44,36,47,23,12,12,254,24,278,8.633093525179856
368,330020905000088,48,51,63,62,52,37,26,27,313,53,366,14.480874316939891
369,330020905000089,6,5,5,10,2,2,7,3,30,10,40,25.0
370,330020905000090,13,14,13,15,10,4,7,3,69,10,79,12.658227848101266
371,330020905000091,28,59,47,40,35,19,13,18,228,31,259,11.96911196911197
372,330020905000092,99,106,73,87,56,44,24,14,465,38,503,7.5546719681908545
373,330020905000093,65,91,66,53,50,30,37,24,355,61,416,14.663461538461538
374,330020905000094,61,90,67,83,43,43,21,10,387,31,418,7.416267942583732
375,330020905000095,33,39,52,42,46,44,28,25,256,53,309,17.15210355987055
376,330020905000096,44,69,61,57,53,43,38,26,327,64,391,16.36828644501279
377,330020905000097,22,16,17,19,18,23,32,24,115,56,171,32.748538011695906
378,330020905000098,34,36,38,37,48,37,25,21,230,46,276,16.666666666666668
379,330020905000099,65,65,67,71,71,88,54,56,427,110,537,20.484171322160147
380,330020905000100,44,50,56,49,39,51,34,24,289,58,347,16.714697406340058
381,330020905000101,24,30,33,30,34,43,44,30,194,74,268,27.611940298507463
382,330020905000102,49,65,61,64,41,62,41,49,342,90,432,20.833333333333332
383,330020905000103,30,57,48,52,61,42,38,37,290,75,365,20.54794520547945
384,330020905000104,19,36,31,41,41,52,56,68,220,124,344,36.04651162790697
385,330020905000105,25,33,23,32,38,32,23,19,183,42,225,18.666666666666668
386,330020905000106,57,89,80,74,89,78,49,56,467,105,572,18.356643356643357
387,330020905000107,63,77,69,71,65,59,22,19,404,41,445,9.213483146067416
388,330020905000108,21,39,28,38,40,45,28,35,211,63,274,22.99270072992701
389,330020905000109,32,42,58,45,65,74,50,94,316,144,460,31.304347826086957
390,330020905000110,7,7,19,11,12,11,16,23,67,39,106,36.79245283018868
391,330020905000111,2,4,2,3,4,7,6,3,22,9,31,29.032258064516128
392,330020905000112,19,20,21,22,20,23,19,17,125,36,161,22.36024844720497
393,330020905000113,13,4,6,7,2,4,2,4,36,6,42,14.285714285714286
394,330020905000114,59,87,69,72,45,49,22,10,381,32,413,7.74818401937046
395,330020905000115,46,67,66,48,53,26,29,11,306,40,346,11.560693641618498
396,330020905000116,11,17,14,10,12,27,8,8,91,16,107,14.953271028037383
397,330020905000117,138,170,136,141,115,68,47,30,768,77,845,9.112426035502958
398,330020905000118,299,347,375,322,194,107,52,39,1644,91,1735,5.244956772334294
399,330020905000119,130,137,131,109,96,78,47,31,681,78,759,10.276679841897232
400,330020905000120,29,27,21,37,19,20,12,11,153,23,176,13.068181818181818
401,330020905000121,15,27,10,10,15,9,6,2,86,8,94,8.51063829787234
402,330020905000122,14,15,19,12,21,21,18,12,102,30,132,22.727272727272727
403,330020905000124,44,61,36,31,48,36,24,19,256,43,299,14.381270903010034
404,330020905000125,12,13,11,11,20,13,7,9,80,16,96,16.666666666666668
405,330020905000126,78,91,71,74,80,60,37,35,454,72,526,13.688212927756654
406,330020905000127,57,59,56,56,62,62,46,63,352,109,461,23.644251626898047
407,330020905000128,96,111,85,71,72,47,40,18,482,58,540,10.74074074074074
408,330020905000129,22,53,21,32,44,28,37,24,200,61,261,23.371647509578544
409,330020905000130,91,94,109,88,111,67,63,43,560,106,666,15.915915915915916
410,330020905000131,42,56,52,60,58,36,26,16,304,42,346,12.138728323699421
411,330020905000132,61,66,70,65,54,52,25,22,368,47,415,11.325301204819278
412,330020905000133,116,147,113,123,100,63,25,18,662,43,705,6.099290780141844
413,330020905000134,88,108,93,86,66,44,20,14,485,34,519,6.551059730250482
414,330020905000135,84,125,99,106,94,64,54,26,572,80,652,12.269938650306749
415,330020905000136,83,76,91,79,60,53,20,25,442,45,487,9.240246406570842
416,330020905000137,30,42,79,64,63,55,32,31,333,63,396,15.909090909090908
417,330020905000138,114,130,93,102,49,39,11,13,527,24,551,4.3557168784029034
418,330020905000139,29,33,13,29,22,14,11,6,140,17,157,10.828025477707007
419,330020905000140,74,86,102,54,73,46,26,26,435,52,487,10.677618069815194
420,330020905000141,76,113,67,65,53,29,19,13,403,32,435,7.35632183908046
421,330020905000142,54,58,85,80,63,55,40,23,395,63,458,13.755458515283843
422,330020905000143,71,77,84,75,80,81,47,53,468,100,568,17.6056338028169
423,330020905000144,52,55,40,56,36,37,15,9,276,24,300,8.0
424,330020905000145,58,49,45,47,38,21,28,11,258,39,297,13.131313131313131
425,330020905000146,41,70,41,67,62,48,32,27,329,59,388,15.206185567010309
426,330020905000147,73,94,88,88,80,87,57,37,510,94,604,15.562913907284768
427,330020905000148,58,89,71,77,79,68,39,34,442,73,515,14.174757281553399
428,330020905000149,21,33,22,27,20,23,7,4,146,11,157,7.006369426751593
429,330020905000150,50,48,48,28,30,23,17,7,227,24,251,9.56175298804781
430,330020905000151,25,31,21,34,30,24,19,17,165,36,201,17.91044776119403
431,330020905000152,51,58,39,43,30,26,12,7,247,19,266,7.142857142857143
432,330020905000153,85,70,84,69,42,35,25,19,385,44,429,10.256410256410257
433,330020905000154,10,5,6,8,5,4,11,4,38,15,53,28.30188679245283
434,330020905000155,11,19,13,12,14,18,12,3,87,15,102,14.705882352941176
435,330020905000156,27,35,25,34,24,15,6,5,160,11,171,6.432748538011696
436,330020905000157,124,149,136,125,87,71,38,28,692,66,758,8.70712401055409
437,330020905000158,26,22,23,19,11,10,5,5,111,10,121,8.264462809917354
438,330020905000159,16,24,28,19,22,16,12,4,125,16,141,11.347517730496454
439,330020905000160,34,39,14,27,15,11,7,4,140,11,151,7.28476821192053
440,330020905000161,79,87,63,73,49,38,22,12,389,34,423,8.037825059101655
441,330020905000162,44,53,41,38,38,24,16,18,238,34,272,12.5
442,330020905000163,21,50,25,30,27,24,4,3,177,7,184,3.8043478260869565
444,330020905000165,90,85,94,69,64,41,23,12,443,35,478,7.322175732217573
445,330020905000166,14,32,22,21,28,15,8,12,132,20,152,13.157894736842104
446,330020905000167,22,27,15,23,29,12,4,13,128,17,145,11.724137931034482
447,330020905000168,8,6,6,8,1,2,0,0,31,0,31,0.0
448,330020905000169,38,43,31,36,31,21,13,14,200,27,227,11.894273127753303
449,330020905000170,14,19,19,7,13,9,6,3,81,9,90,10.0
450,330020905000171,31,46,35,36,29,18,9,10,195,19,214,8.878504672897197
451,330020905000172,8,5,8,5,4,4,4,3,34,7,41,17.073170731707318
452,330020905000173,5,9,10,4,5,6,1,1,39,2,41,4.878048780487805
453,330020905000174,21,30,17,24,19,13,14,10,124,24,148,16.216216216216218
454,330020905000175,8,8,5,9,8,3,6,2,41,8,49,16.3265306122449
455,330020905000176,69,66,78,83,50,45,22,17,391,39,430,9.069767441860465
456,330020905000177,9,14,14,13,6,6,1,0,62,1,63,1.5873015873015872
457,330020905000178,3,3,1,4,5,1,3,3,17,6,23,26.08695652173913
458,330020905000179,72,56,57,48,33,7,9,5,273,14,287,4.878048780487805
460,330020905000181,21,25,16,14,15,12,3,9,103,12,115,10.434782608695652
461,330020905000182,14,21,13,18,26,13,10,5,105,15,120,12.5
462,330020905000183,4,10,5,7,5,4,1,0,35,1,36,2.7777777777777777
463,330020905000184,5,13,9,9,12,4,7,4,52,11,63,17.46031746031746
464,330020905000185,7,8,18,3,8,6,5,3,50,8,58,13.793103448275861
465,330020905000186,44,56,33,39,25,20,9,5,217,14,231,6.0606060606060606
466,330020905000187,14,32,17,14,15,5,5,1,97,6,103,5.825242718446602
467,330020905000188,118,109,117,80,64,41,24,3,529,27,556,4.856115107913669
468,330020905000189,91,123,98,81,73,39,28,11,505,39,544,7.169117647058823
469,330020905000190,102,122,85,82,85,79,28,22,555,50,605,8.264462809917354
470,330020905000191,90,76,80,88,79,40,42,32,453,74,527,14.041745730550284
471,330020905000192,56,52,60,58,38,34,19,9,298,28,326,8.588957055214724
472,330020908000001,14,14,26,11,23,16,14,12,104,26,130,20.0
473,330020908000002,8,12,18,9,15,25,11,8,87,19,106,17.92452830188679
474,330020908000003,22,42,19,27,33,21,21,19,164,40,204,19.607843137254903
475,330020908000004,12,19,16,20,11,16,17,8,94,25,119,21.008403361344538
476,330020908000005,54,46,51,53,53,36,29,18,293,47,340,13.823529411764707
477,330020908000006,55,64,56,76,66,37,28,24,354,52,406,12.807881773399014
478,330020908000007,20,18,18,17,22,18,15,6,113,21,134,15.671641791044776
479,330020908000008,17,29,23,17,22,23,17,9,131,26,157,16.56050955414013
480,330020908000009,7,7,9,7,13,9,4,9,52,13,65,20.0
481,330020908000010,43,53,41,51,43,39,40,23,270,63,333,18.91891891891892
482,330020908000011,84,65,58,55,45,55,34,22,362,56,418,13.397129186602871
483,330020908000012,63,72,58,47,45,37,17,4,322,21,343,6.122448979591836
484,330020908000013,59,92,58,74,48,54,44,27,385,71,456,15.570175438596491
485,330020908000014,35,44,24,32,37,37,27,12,209,39,248,15.725806451612904
486,330020908000015,16,17,21,29,20,13,21,20,116,41,157,26.11464968152866
487,330020908000016,10,19,16,15,24,19,23,19,103,42,145,28.96551724137931
488,330020908000017,12,29,19,22,19,29,15,7,130,22,152,14.473684210526315
489,330020908000018,12,16,21,11,20,11,7,7,91,14,105,13.333333333333334
490,330020908000019,16,12,9,18,20,13,20,20,88,40,128,31.25
491,330020908000020,40,64,44,45,54,48,22,16,295,38,333,11.411411411411411
492,330020908000021,66,59,54,45,54,43,20,19,321,39,360,10.833333333333334
493,330020908000022,32,43,30,24,29,23,18,16,181,34,215,15.813953488372093
494,330020908000023,79,105,80,76,64,54,35,24,458,59,517,11.411992263056092
495,330020908000024,13,14,16,21,18,24,21,19,106,40,146,27.397260273972602
496,330020908000025,18,28,24,28,30,26,31,28,154,59,213,27.699530516431924
497,330020908000026,13,7,17,13,23,24,15,16,97,31,128,24.21875
498,330020908000027,33,30,20,34,27,21,23,16,165,39,204,19.11764705882353
499,330020908000028,33,28,26,42,21,23,41,29,173,70,243,28.80658436213992
500,330020908000029,24,33,18,25,29,30,22,30,159,52,211,24.644549763033176
501,330020908000031,43,71,39,42,35,28,23,14,258,37,295,12.542372881355933
502,330020908000032,9,7,5,9,8,7,6,11,45,17,62,27.419354838709676
503,330020908000033,37,44,45,41,42,37,28,27,246,55,301,18.272425249169434
504,330020908000034,21,24,14,21,26,21,17,12,127,29,156,18.58974358974359
505,330020908000035,25,26,14,25,27,13,21,8,130,29,159,18.238993710691823
506,330020908000036,13,25,27,13,23,23,20,14,124,34,158,21.518987341772153
507,330020908000037,51,47,48,36,46,39,23,20,267,43,310,13.870967741935484
508,330020908000038,32,34,25,24,23,16,14,6,154,20,174,11.494252873563218
509,330020908000039,14,18,16,14,24,24,18,12,110,30,140,21.428571428571427
510,330020908000040,39,51,43,46,33,41,26,28,253,54,307,17.58957654723127
511,330020908000041,30,31,23,19,16,14,7,1,133,8,141,5.673758865248227
512,330020908000042,67,67,72,52,46,32,7,6,336,13,349,3.7249283667621778
513,330020908000043,10,9,12,6,7,2,1,0,46,1,47,2.127659574468085
514,330020908000044,21,31,22,22,10,7,7,1,113,8,121,6.6115702479338845
515,330020908000045,9,14,13,12,7,6,1,2,61,3,64,4.6875
516,330020908000046,15,11,15,6,12,4,4,0,63,4,67,5.970149253731344
517,330020908000047,77,112,109,80,62,46,27,19,486,46,532,8.646616541353383
518,330020908000048,42,45,37,37,29,20,12,5,210,17,227,7.488986784140969
519,330020910000001,65,64,79,61,48,47,31,22,364,53,417,12.709832134292565
520,330020910000002,118,118,122,99,92,71,38,33,620,71,691,10.274963820549928
521,330020910000003,111,196,142,119,126,70,64,62,764,126,890,14.157303370786517
522,330020910000004,90,158,126,116,95,100,44,30,685,74,759,9.749670619235836
523,330020910000005,37,37,45,48,31,20,21,8,218,29,247,11.740890688259109
524,330020910000006,103,92,90,105,79,71,37,36,540,73,613,11.908646003262643
525,330020910000007,92,93,92,86,62,47,46,32,472,78,550,14.181818181818182
526,330020910000008,106,130,89,98,79,63,28,24,565,52,617,8.427876823338735
527,330020910000009,7,8,12,8,15,18,3,2,68,5,73,6.8493150684931505
528,330020910000010,59,64,47,53,44,42,21,24,309,45,354,12.711864406779661
529,330020910000011,74,87,70,61,47,42,34,11,381,45,426,10.56338028169014
530,330020910000012,68,70,60,59,44,32,21,11,333,32,365,8.767123287671232
531,330020910000013,52,51,47,37,22,39,17,10,248,27,275,9.818181818181818
532,330020910000014,9,11,11,8,6,5,8,3,50,11,61,18.0327868852459
533,330020910000015,43,40,31,35,18,32,16,11,199,27,226,11.946902654867257
534,330020910000016,77,83,57,73,61,45,30,21,396,51,447,11.409395973154362
535,330020910000017,16,17,16,13,19,13,11,13,94,24,118,20.338983050847457
536,330020910000018,49,57,56,42,61,43,21,25,308,46,354,12.994350282485875
537,330020910000019,103,128,79,96,74,69,26,32,549,58,607,9.555189456342669
538,330020910000020,127,157,138,123,89,52,30,10,686,40,726,5.509641873278237
539,330020910000021,28,41,29,34,15,10,7,7,157,14,171,8.187134502923977
540,330020912000001,25,38,33,29,35,48,19,19,208,38,246,15.447154471544716
541,330020912000002,34,56,46,41,40,43,41,24,260,65,325,20.0
542,330020912000003,41,63,67,62,56,69,35,18,358,53,411,12.895377128953772
543,330020912000004,36,55,52,48,60,40,26,16,291,42,333,12.612612612612613
544,330020912000005,17,26,22,24,25,17,12,6,131,18,149,12.080536912751677
545,330020912000006,15,28,21,26,25,30,21,17,145,38,183,20.76502732240437
546,330020912000007,3,7,6,6,7,7,5,4,36,9,45,20.0
547,330020912000008,11,11,10,14,10,10,14,5,66,19,85,22.352941176470587
548,330020912000009,12,15,8,11,12,15,18,12,73,30,103,29.12621359223301
549,330020912000010,5,15,18,10,14,11,18,12,73,30,103,29.12621359223301
550,330020912000011,13,17,15,20,23,25,23,13,113,36,149,24.161073825503355
551,330020912000012,20,13,20,21,20,28,20,14,122,34,156,21.794871794871796
552,330020912000013,52,42,33,38,36,40,31,17,241,48,289,16.608996539792386
553,330020912000014,14,8,4,12,9,5,8,1,52,9,61,14.754098360655737
554,330020912000015,30,61,40,39,41,34,35,28,245,63,308,20.454545454545453
555,330020912000017,48,64,49,57,48,39,28,18,305,46,351,13.105413105413106
556,330020912000018,13,5,13,11,3,11,6,6,56,12,68,17.647058823529413
557,330020912000019,14,26,16,29,20,31,17,5,136,22,158,13.924050632911392
558,330020915000001,95,134,110,105,121,93,73,80,658,153,811,18.865598027127003
559,330020915000002,66,99,123,91,96,76,46,39,551,85,636,13.364779874213836
560,330020915000003,77,86,62,71,42,40,33,36,378,69,447,15.436241610738255
561,330020915000004,83,141,89,97,104,61,54,35,575,89,664,13.403614457831326
562,330020915000005,146,185,129,110,83,67,22,22,720,44,764,5.7591623036649215
563,330020915000006,51,81,72,54,60,46,35,27,364,62,426,14.553990610328638
564,330020915000007,40,51,84,54,58,57,40,51,344,91,435,20.919540229885058
565,330020915000008,61,68,84,50,81,53,33,25,397,58,455,12.747252747252746
566,330020915000009,12,3,18,14,17,19,3,5,83,8,91,8.791208791208792
567,330020915000010,48,47,44,39,22,23,15,6,223,21,244,8.60655737704918
568,330020915000011,9,11,10,7,7,6,4,11,50,15,65,23.076923076923077
569,330020915000012,30,64,58,50,47,19,14,18,268,32,300,10.666666666666666
570,330020915000013,2,3,5,9,10,2,7,3,31,10,41,24.390243902439025
571,330020915000014,40,50,41,41,48,35,24,24,255,48,303,15.841584158415841
572,330020915000015,26,21,16,22,13,8,12,4,106,16,122,13.114754098360656
573,330020915000016,26,39,24,17,28,11,16,15,145,31,176,17.613636363636363
574,330020915000017,15,11,23,13,7,12,6,3,81,9,90,10.0
575,330020915000018,157,248,195,132,116,73,52,44,921,96,1017,9.43952802359882
576,330020915000019,67,103,54,51,33,28,10,9,336,19,355,5.352112676056338
577,330020915000020,83,100,54,36,27,23,20,11,323,31,354,8.757062146892656
578,330020915000021,13,17,8,10,9,3,4,0,60,4,64,6.25
579,330020915000022,23,23,15,14,9,5,4,4,89,8,97,8.24742268041237
580,330020915000023,8,10,8,9,1,4,8,2,40,10,50,20.0
581,330020915000024,9,13,15,5,3,5,2,0,50,2,52,3.8461538461538463
582,330020915000025,8,12,4,7,3,4,4,0,38,4,42,9.523809523809524
585,330020915000028,85,134,99,77,84,59,39,47,538,86,624,13.782051282051283
586,330020915000029,93,162,117,109,88,55,54,32,624,86,710,12.112676056338028
587,330020915000030,72,119,109,94,70,47,32,22,511,54,565,9.557522123893806
588,330020915000031,170,227,153,168,135,95,62,40,948,102,1050,9.714285714285714
589,330020915000032,19,26,25,32,20,18,4,2,140,6,146,4.109589041095891
590,330020915000033,69,107,82,73,61,36,22,9,428,31,459,6.753812636165577
591,330020915000034,20,28,19,18,9,4,4,8,98,12,110,10.909090909090908
592,330020915000035,144,179,167,108,119,74,52,76,791,128,919,13.928182807399347
593,330022505000001,109,127,153,123,112,101,61,44,725,105,830,12.650602409638553
594,330022505000002,48,70,55,60,67,57,40,37,357,77,434,17.741935483870968
595,330022505000003,127,161,145,111,89,66,33,35,699,68,767,8.865710560625814
596,330022505000004,68,71,87,86,68,76,50,39,456,89,545,16.3302752293578
597,330022505000005,62,94,68,64,69,46,32,19,403,51,454,11.233480176211454
598,330022505000006,50,47,42,61,31,38,18,20,269,38,307,12.37785016286645
599,330022505000007,83,82,99,87,88,66,57,33,505,90,595,15.126050420168067
600,330022505000008,51,50,57,77,63,79,35,37,377,72,449,16.035634743875278
601,330022505000009,103,111,122,127,116,94,60,57,673,117,790,14.810126582278482
602,330022505000010,61,88,80,70,69,62,26,34,430,60,490,12.244897959183673
603,330022505000011,106,108,107,103,97,64,48,38,585,86,671,12.816691505216095
604,330022505000012,127,167,161,143,102,100,61,41,800,102,902,11.30820399113082
605,330022505000013,111,174,141,130,150,108,63,52,814,115,929,12.378902045209903
606,330022505000014,68,73,67,60,52,46,24,14,366,38,404,9.405940594059405
607,330022505000015,66,78,70,51,62,34,23,19,361,42,403,10.421836228287841
608,330022505000016,6,13,8,8,9,7,1,3,51,4,55,7.2727272727272725
609,330022505000017,49,61,49,45,43,28,22,5,275,27,302,8.940397350993377
610,330022505000018,91,145,104,89,73,69,30,22,571,52,623,8.346709470304976
611,330022505000019,51,77,64,77,66,48,41,17,383,58,441,13.151927437641723
612,330022505000020,70,103,92,94,69,66,45,28,494,73,567,12.874779541446209
613,330022505000021,16,24,20,22,22,16,5,4,120,9,129,6.976744186046512
614,330022505000022,56,56,67,50,49,39,12,7,317,19,336,5.654761904761905
615,330023305000001,12,31,32,30,30,23,19,13,158,32,190,16.842105263157894
616,330023305000002,24,31,36,40,37,26,19,12,194,31,225,13.777777777777779
617,330023305000003,18,35,31,35,38,19,21,17,176,38,214,17.757009345794394
618,330023305000004,24,28,34,45,34,31,19,3,196,22,218,10.091743119266056
619,330023305000005,21,21,31,30,27,13,10,7,143,17,160,10.625
620,330023305000006,38,52,63,47,64,52,24,16,316,40,356,11.235955056179776
621,330023305000007,46,31,28,56,28,32,20,13,221,33,254,12.992125984251969
622,330023305000008,19,21,16,19,24,16,15,2,115,17,132,12.878787878787879
623,330023305000009,15,15,30,23,34,27,15,5,144,20,164,12.195121951219512
624,330023305000010,135,125,172,136,124,93,42,26,785,68,853,7.971864009378663
625,330023305000011,80,93,107,122,80,78,46,24,560,70,630,11.11111111111111
626,330023305000012,24,38,30,39,46,27,17,4,204,21,225,9.333333333333334
627,330023305000013,23,30,36,40,32,26,11,4,187,15,202,7.425742574257426
628,330023305000014,43,40,68,48,49,36,16,21,284,37,321,11.526479750778817
629,330023305000015,11,15,16,15,24,6,4,0,87,4,91,4.395604395604396
630,330023305000016,53,58,69,72,65,41,19,16,358,35,393,8.9058524173028
631,330023305000017,49,64,33,56,77,45,40,14,324,54,378,14.285714285714286
632,330023305000018,13,15,16,23,15,10,4,3,92,7,99,7.070707070707071
633,330023305000019,67,57,63,58,48,29,9,12,322,21,343,6.122448979591836
634,330023305000020,91,122,133,100,109,70,21,17,625,38,663,5.731523378582202
635,330023305000021,94,133,127,118,107,80,39,22,659,61,720,8.472222222222221
636,330023305000022,70,92,92,92,86,58,19,15,490,34,524,6.488549618320611
637,330023305000023,82,71,75,79,61,42,8,10,410,18,428,4.205607476635514
638,330023305000024,82,103,76,103,75,40,19,18,479,37,516,7.170542635658915
639,330023305000025,149,149,138,169,109,66,25,19,780,44,824,5.339805825242719
640,330023305000026,65,74,54,60,33,39,17,9,325,26,351,7.407407407407407
641,330023305000027,133,148,147,159,106,67,47,17,760,64,824,7.766990291262136
642,330023305000028,110,158,108,150,89,55,41,22,670,63,733,8.594815825375171
643,330023305000029,88,88,76,109,67,66,37,21,494,58,552,10.507246376811594
644,330023305000030,7,3,9,13,7,6,5,3,45,8,53,15.09433962264151
645,330023305000031,17,26,19,23,26,16,7,6,127,13,140,9.285714285714286
646,330023305000032,6,18,11,13,9,7,2,3,64,5,69,7.246376811594203
647,330023305000033,39,60,84,77,61,52,56,13,373,69,442,15.610859728506787
648,330023305000034,27,36,23,49,35,30,9,1,200,10,210,4.761904761904762
649,330023305000035,34,49,42,48,69,27,15,10,269,25,294,8.503401360544217
650,330023305000036,49,60,45,56,52,54,23,15,316,38,354,10.734463276836157
651,330023305000037,73,98,112,92,94,73,27,21,542,48,590,8.135593220338983
652,330023305000038,95,108,125,109,73,74,41,15,584,56,640,8.75
653,330023305000039,16,21,21,21,33,25,9,10,137,19,156,12.179487179487179
654,330023305000040,22,38,49,33,41,38,24,7,221,31,252,12.301587301587302
655,330023305000041,11,8,9,12,15,12,3,4,67,7,74,9.45945945945946
656,330023305000042,10,18,14,27,18,17,8,4,104,12,116,10.344827586206897
657,330023305000043,28,22,38,55,30,22,19,11,195,30,225,13.333333333333334
658,330023305000045,83,107,79,75,82,46,19,11,472,30,502,5.9760956175298805
659,330023305000046,84,101,87,93,70,40,22,27,475,49,524,9.351145038167939
660,330023305000047,48,78,51,63,77,39,23,15,356,38,394,9.644670050761421
661,330023305000048,43,53,63,41,45,28,10,16,273,26,299,8.695652173913043
662,330023305000049,75,89,64,80,61,46,26,10,415,36,451,7.982261640798226
663,330023305000050,21,31,23,31,31,17,11,6,154,17,171,9.941520467836257
664,330023305000051,130,125,130,120,94,60,24,12,659,36,695,5.179856115107913
665,330023305000052,55,57,75,90,75,40,6,6,392,12,404,2.9702970297029703
666,330023305000053,58,75,79,103,78,43,22,13,436,35,471,7.43099787685775
667,330023305000054,81,84,79,104,88,75,34,18,511,52,563,9.236234458259325
668,330023305000055,31,34,50,47,48,28,16,12,238,28,266,10.526315789473685
669,330023305000056,18,21,24,25,27,10,15,1,125,16,141,11.347517730496454
670,330023305000057,90,88,101,98,57,52,15,5,486,20,506,3.952569169960474
671,330023305000058,100,147,125,133,108,57,42,24,670,66,736,8.967391304347826
672,330023305000059,111,124,125,128,128,55,22,19,671,41,712,5.758426966292135
673,330023305000060,98,113,104,131,83,58,27,10,587,37,624,5.92948717948718
674,330023305000061,51,64,51,34,27,18,18,5,245,23,268,8.582089552238806
675,330023305000062,71,67,68,59,57,44,28,23,366,51,417,12.23021582733813
676,330023305000063,19,15,21,24,29,18,17,8,126,25,151,16.556291390728475
677,330023305000064,25,38,21,35,28,15,7,7,162,14,176,7.954545454545454
678,330023305000065,36,39,32,32,37,26,4,4,202,8,210,3.8095238095238093
679,330023305000066,22,40,42,35,34,21,11,6,194,17,211,8.056872037914692
680,330023305000067,58,61,76,88,63,42,29,11,388,40,428,9.345794392523365
681,330023305000068,64,70,102,74,77,74,27,25,461,52,513,10.1364522417154
682,330023305000069,46,63,72,61,48,30,16,5,320,21,341,6.158357771260997
683,330023305000070,105,134,125,125,107,54,34,18,650,52,702,7.407407407407407
684,330023305000071,187,193,196,186,118,64,28,21,944,49,993,4.934541792547835
685,330023305000072,102,103,89,85,58,31,17,8,468,25,493,5.070993914807302
686,330025805000001,13,17,32,20,23,25,17,13,130,30,160,18.75
687,330025805000002,60,90,76,82,114,81,65,76,503,141,644,21.8944099378882
688,330025805000003,67,98,89,81,92,80,54,41,507,95,602,15.780730897009967
689,330025805000004,86,109,107,92,116,97,79,56,607,135,742,18.194070080862534
690,330025805000005,44,70,62,58,79,44,28,27,357,55,412,13.349514563106796
691,330025805000006,60,30,74,64,48,84,36,24,360,60,420,14.285714285714286
692,330025805000007,57,61,76,71,79,71,44,41,415,85,500,17.0
693,330025805000008,32,30,38,36,43,41,14,18,220,32,252,12.698412698412698
694,330025805000009,27,47,35,27,55,43,22,31,234,53,287,18.466898954703833
695,330025805000010,54,63,60,74,56,40,43,24,347,67,414,16.183574879227052
696,330025805000011,48,67,60,55,69,49,35,43,348,78,426,18.309859154929576
697,330025805000012,41,50,44,42,44,32,22,26,253,48,301,15.946843853820598
698,330025805000013,66,99,73,77,96,51,32,38,462,70,532,13.157894736842104
699,330025805000014,70,56,59,60,62,36,26,24,343,50,393,12.72264631043257
700,330025805000015,43,61,37,41,65,32,27,27,279,54,333,16.216216216216218
701,330025805000016,25,53,35,44,49,32,22,21,238,43,281,15.302491103202847
702,330025805000017,62,77,68,61,87,48,37,31,403,68,471,14.437367303609342
703,330025805000018,40,53,54,61,51,54,27,34,313,61,374,16.310160427807485
704,330025805000019,22,28,25,31,22,30,28,21,158,49,207,23.67149758454106
705,330025805000020,33,39,30,46,42,25,32,20,215,52,267,19.475655430711612
706,330025805000021,28,33,40,54,29,25,17,12,209,29,238,12.184873949579831
707,330025805000022,26,37,39,25,41,26,15,15,194,30,224,13.392857142857142
708,330025805000023,101,105,111,113,102,76,41,32,608,73,681,10.719530102790015
709,330025805000024,112,145,124,130,100,114,66,53,725,119,844,14.09952606635071
710,330025805000025,53,57,62,63,67,63,51,20,365,71,436,16.28440366972477
711,330025805000026,59,67,54,64,42,45,27,20,331,47,378,12.433862433862434
712,330025805000027,98,104,112,98,72,61,21,20,545,41,586,6.996587030716723
713,330025805000028,46,48,52,50,43,24,12,5,263,17,280,6.071428571428571
714,330025805000029,56,81,54,67,47,28,29,10,333,39,372,10.483870967741936
715,330025805000030,58,79,85,84,55,52,34,11,413,45,458,9.825327510917031
716,330025805000031,96,136,119,121,147,125,42,20,744,62,806,7.6923076923076925
717,330025805000032,21,23,18,16,25,9,2,2,112,4,116,3.4482758620689653
718,330025805000033,92,124,98,94,90,70,33,24,568,57,625,9.12
719,330025805000034,43,64,64,28,71,44,29,23,314,52,366,14.207650273224044
720,330025805000035,8,13,22,11,18,19,17,6,91,23,114,20.17543859649123
721,330025805000036,3,1,4,1,6,8,4,4,23,8,31,25.806451612903224
722,330025805000037,5,4,3,8,1,2,7,2,23,9,32,28.125
723,330025805000038,68,101,70,67,60,29,22,8,395,30,425,7.0588235294117645
724,330025805000039,90,131,95,97,91,56,24,22,560,46,606,7.590759075907591
725,330025805000040,29,24,18,13,15,4,3,3,103,6,109,5.504587155963303
726,330025805000041,83,122,131,110,103,73,50,26,622,76,698,10.888252148997134
727,330025805000042,58,77,65,67,64,42,19,14,373,33,406,8.12807881773399
728,330025805000043,10,7,11,7,8,6,1,2,49,3,52,5.769230769230769
729,330025805000044,106,126,149,111,137,77,54,34,706,88,794,11.083123425692696
730,330025805000045,57,63,60,57,64,36,29,28,337,57,394,14.467005076142131
731,330025805000046,38,39,35,48,47,39,29,17,246,46,292,15.753424657534246
732,330025805000047,33,30,32,30,30,27,20,13,182,33,215,15.348837209302326
733,330025805000048,25,25,20,16,18,21,4,2,125,6,131,4.580152671755725
734,330025805000049,14,9,17,11,12,21,9,5,84,14,98,14.285714285714286
735,330025805000050,20,18,22,16,19,15,18,12,110,30,140,21.428571428571427
736,330025805000051,19,31,25,16,20,15,12,7,126,19,145,13.10344827586207
737,330025805000052,32,26,36,26,27,21,11,14,168,25,193,12.953367875647668
738,330025805000053,33,39,30,38,26,26,18,12,192,30,222,13.513513513513514
739,330025805000054,53,67,42,51,51,37,20,11,301,31,332,9.337349397590362
740,330025805000055,30,33,25,27,39,28,26,6,182,32,214,14.953271028037383
741,330025805000056,96,100,90,76,71,55,35,21,488,56,544,10.294117647058824
742,330025805000057,9,8,4,10,15,8,7,3,54,10,64,15.625
743,330025805000058,21,23,29,23,29,29,16,13,154,29,183,15.846994535519126
744,330025805000059,74,73,58,68,64,61,33,27,398,60,458,13.100436681222707
745,330025805000060,32,33,21,36,36,30,12,11,188,23,211,10.90047393364929
746,330025805000061,21,28,31,20,24,36,11,3,160,14,174,8.045977011494253
747,330025805000062,17,21,24,26,31,35,16,12,154,28,182,15.384615384615385
748,330025805000063,55,62,50,54,50,36,21,22,307,43,350,12.285714285714286
749,330025805000064,39,49,43,41,48,50,26,18,270,44,314,14.012738853503185
750,330025805000065,35,36,33,43,31,27,27,5,205,32,237,13.50210970464135
751,330025805000066,71,122,125,162,59,48,43,20,587,63,650,9.692307692307692
752,330025805000068,12,37,21,38,36,35,33,18,179,51,230,22.17391304347826
753,330025805000069,35,44,45,30,58,33,29,28,245,57,302,18.874172185430464
754,330025805000070,6,8,9,12,9,5,8,3,49,11,60,18.333333333333332
755,330025805000071,1,3,1,1,4,6,3,4,16,7,23,30.434782608695652
756,330025805000072,25,27,28,17,23,23,10,4,143,14,157,8.9171974522293
757,330025805000073,28,43,43,49,48,39,28,14,250,42,292,14.383561643835616
758,330025805000074,3,9,4,6,8,8,6,5,38,11,49,22.448979591836736
759,330025805000075,52,76,54,62,54,39,14,17,337,31,368,8.423913043478262
760,330025805000076,38,63,45,42,56,20,18,8,264,26,290,8.96551724137931
761,330025805000077,25,22,20,23,25,18,19,5,133,24,157,15.286624203821656
762,330025805000078,17,20,23,18,27,12,6,5,117,11,128,8.59375
763,330025805000079,32,41,15,39,22,20,11,9,169,20,189,10.582010582010582
764,330025805000080,72,86,41,79,60,30,25,4,368,29,397,7.30478589420655
765,330025805000081,60,52,36,53,27,41,22,11,269,33,302,10.927152317880795
766,330025805000082,24,26,15,21,21,23,8,3,130,11,141,7.801418439716312
767,330025805000083,25,20,20,25,19,43,20,5,152,25,177,14.124293785310735
768,330025805000084,164,138,123,115,100,57,31,18,697,49,746,6.568364611260054
769,330025805000085,46,43,28,42,44,38,16,12,241,28,269,10.408921933085502
770,330030805000001,9,18,29,16,23,34,21,30,129,51,180,28.333333333333332
771,330030805000002,25,20,54,40,37,54,32,37,230,69,299,23.076923076923077
772,330030805000003,18,16,22,17,26,29,19,19,128,38,166,22.89156626506024
773,330030805000004,29,24,27,28,30,23,30,35,161,65,226,28.761061946902654
774,330030805000005,45,62,67,75,74,75,59,75,398,134,532,25.18796992481203
775,330030805000006,0,4,1,5,2,4,3,0,16,3,19,15.789473684210526
777,330030805000008,25,35,39,30,36,28,19,22,193,41,234,17.521367521367523
778,330030805000009,50,50,69,68,66,69,34,29,372,63,435,14.482758620689655
779,330030805000010,74,81,92,68,85,57,30,33,457,63,520,12.115384615384615
780,330030805000011,62,61,93,65,92,60,39,28,433,67,500,13.4
781,330030805000012,109,140,118,106,99,86,50,45,658,95,753,12.616201859229747
782,330030805000013,38,33,45,25,26,24,11,9,191,20,211,9.47867298578199
783,330030805000014,33,53,48,43,51,29,16,11,257,27,284,9.507042253521126
784,330030805000015,3,1,4,3,5,7,6,6,23,12,35,34.285714285714285
785,330030805000016,52,48,87,77,98,73,59,63,435,122,557,21.903052064631957
786,330030805000017,18,38,26,31,46,43,27,62,202,89,291,30.584192439862544
787,330030805000018,28,56,47,54,68,55,42,63,308,105,413,25.423728813559322
788,330030805000019,9,23,12,9,25,21,7,20,99,27,126,21.428571428571427
789,330030805000020,36,64,67,67,80,87,75,67,401,142,543,26.151012891344383
790,330030805000021,133,114,109,138,97,87,49,42,678,91,769,11.833550065019505
791,330030805000022,58,48,55,44,35,27,17,12,267,29,296,9.797297297297296
792,330030805000023,107,115,90,80,68,66,28,17,526,45,571,7.880910683012259
793,330030805000024,42,46,63,41,68,58,35,28,318,63,381,16.53543307086614
794,330030805000025,54,65,82,72,81,101,49,48,455,97,552,17.57246376811594
795,330030805000026,45,75,78,69,80,73,38,41,420,79,499,15.831663326653306
796,330030805000027,32,37,21,43,29,22,12,13,184,25,209,11.961722488038278
797,330030805000028,93,102,107,109,111,85,50,51,607,101,708,14.265536723163843
798,330030805000029,64,99,83,88,95,76,38,33,505,71,576,12.32638888888889
799,330030805000030,85,90,128,112,116,111,71,56,642,127,769,16.514954486345903
800,330030805000031,57,67,59,65,66,66,32,32,380,64,444,14.414414414414415
801,330030805000032,57,71,93,70,93,82,42,37,466,79,545,14.495412844036696
802,330030805000033,50,63,72,67,54,56,25,23,362,48,410,11.707317073170731
803,330030805000034,48,68,90,66,73,76,42,44,421,86,507,16.962524654832347
804,330030805000035,82,79,82,106,92,59,57,30,500,87,587,14.821124361158432
805,330030805000036,55,86,73,63,71,49,19,26,397,45,442,10.180995475113122
806,330030805000037,38,86,61,62,64,73,37,36,384,73,457,15.973741794310722
807,330030805000038,57,53,44,55,45,33,23,14,287,37,324,11.419753086419753
808,330030805000039,53,97,77,73,87,83,46,33,470,79,549,14.389799635701275
809,330030805000040,52,75,64,54,56,54,17,18,355,35,390,8.974358974358974
810,330030805000041,6,6,10,6,3,9,8,2,40,10,50,20.0
811,330030805000042,36,41,70,47,53,54,29,40,301,69,370,18.64864864864865
812,330030805000043,86,81,95,91,86,68,43,25,507,68,575,11.826086956521738
813,330030805000044,48,73,61,46,48,46,23,22,322,45,367,12.26158038147139
814,330030805000045,141,145,126,106,112,60,29,27,690,56,746,7.506702412868632
815,330030805000046,116,124,148,116,96,96,55,28,696,83,779,10.654685494223363
816,330030805000047,96,80,126,75,94,78,48,56,549,104,653,15.926493108728943
817,330030805000048,12,16,24,14,20,24,8,4,110,12,122,9.836065573770492
818,330030805000049,30,51,40,36,58,48,33,20,263,53,316,16.772151898734176
819,330030805000050,49,55,87,80,70,62,58,61,403,119,522,22.796934865900383
820,330030805000051,31,66,74,65,58,59,59,64,353,123,476,25.840336134453782
821,330030805000052,51,55,82,80,78,72,45,55,418,100,518,19.305019305019304
822,330030805000053,89,103,86,95,70,61,38,20,504,58,562,10.320284697508896
823,330030805000054,100,95,116,95,117,85,40,51,608,91,699,13.01859799713877
824,330030805000055,152,173,110,104,104,74,34,18,717,52,769,6.7620286085825745
825,330030805000056,58,57,75,69,43,26,16,15,328,31,359,8.635097493036211
826,330030805000058,72,82,87,84,82,73,46,37,480,83,563,14.742451154529308
827,330030805000059,32,28,26,28,26,18,12,11,158,23,181,12.707182320441989
828,330030805000060,203,233,193,164,140,102,57,41,1035,98,1133,8.649602824360105
829,330030805000061,70,82,84,95,75,56,33,19,462,52,514,10.116731517509727
830,330030805000062,79,97,102,84,93,66,43,32,521,75,596,12.583892617449665
831,330030805000063,137,126,149,124,115,67,32,17,718,49,767,6.388526727509778
832,330030805000064,10,11,15,8,8,5,3,2,57,5,62,8.064516129032258
833,330030805000065,27,13,21,19,8,12,3,1,100,4,104,3.8461538461538463
834,330030805000066,40,48,60,44,56,66,27,43,314,70,384,18.229166666666668
835,330030805000067,85,77,127,90,105,92,66,40,576,106,682,15.542521994134898
836,330030805000068,129,158,150,160,139,153,76,65,889,141,1030,13.689320388349515
837,330030805000069,85,115,78,93,65,60,29,9,496,38,534,7.116104868913857
838,330030805000070,66,79,102,77,66,75,48,29,465,77,542,14.206642066420665
839,330030805000071,51,109,100,91,94,74,70,49,519,119,638,18.65203761755486
840,330030805000072,59,65,91,78,93,100,47,52,486,99,585,16.923076923076923
841,330030805000073,108,142,123,119,138,116,78,70,746,148,894,16.55480984340045
842,330030805000074,31,41,36,40,42,43,27,40,233,67,300,22.333333333333332
843,330030805000075,9,8,19,17,15,28,24,25,96,49,145,33.793103448275865
844,330030805000076,17,29,31,18,26,36,22,33,157,55,212,25.943396226415093
845,330030805000077,48,88,76,75,86,75,63,69,448,132,580,22.75862068965517
846,330030805000078,103,123,121,118,128,97,52,37,690,89,779,11.424903722721437
847,330030805000079,90,108,99,99,98,78,48,28,572,76,648,11.728395061728396
849,330030805000081,101,112,124,111,92,67,37,36,607,73,680,10.735294117647058
850,330030805000082,48,72,65,62,70,49,33,25,366,58,424,13.679245283018869
851,330030805000083,50,59,46,41,52,50,27,19,298,46,344,13.372093023255815
852,330030805000084,137,183,158,122,135,90,60,49,825,109,934,11.670235546038544
853,330030805000085,93,127,106,117,104,67,41,26,614,67,681,9.838472834067547
854,330030805000086,154,160,150,157,146,104,62,40,871,102,973,10.483042137718396
855,330030805000087,75,73,78,70,72,62,34,29,430,63,493,12.778904665314402
856,330030805000088,23,40,26,17,30,16,10,17,152,27,179,15.083798882681565
857,330030805000089,45,47,34,36,24,17,14,5,203,19,222,8.558558558558559
858,330030805000090,3,5,8,4,5,0,1,0,25,1,26,3.8461538461538463
859,330030805000091,18,21,13,15,9,6,5,3,82,8,90,8.88888888888889
860,330030805000092,18,29,17,28,28,23,21,20,143,41,184,22.282608695652176
861,330030805000093,19,20,30,35,32,35,48,51,171,99,270,36.666666666666664
862,330030805000094,10,8,15,13,21,15,14,32,82,46,128,35.9375
863,330030805000095,56,74,69,106,99,84,93,111,488,204,692,29.479768786127167
864,330030805000096,11,24,19,16,36,19,17,10,125,27,152,17.763157894736842
866,330030805000098,74,100,126,108,105,100,42,40,613,82,695,11.798561151079136
867,330030805000099,62,78,79,73,78,72,36,31,442,67,509,13.163064833005894
868,330030805000100,71,52,47,79,61,38,22,14,348,36,384,9.375
869,330030805000102,106,144,134,130,126,88,47,43,728,90,818,11.00244498777506
872,330030805000105,142,142,140,123,98,61,42,31,706,73,779,9.370988446726573
873,330030805000106,71,74,86,101,78,64,35,45,474,80,554,14.440433212996389
874,330030805000107,89,103,79,113,100,84,56,51,568,107,675,15.851851851851851
875,330030805000108,33,56,55,58,57,50,43,32,309,75,384,19.53125
876,330030805000110,95,119,137,126,126,122,99,65,725,164,889,18.44769403824522
877,330030805000111,12,13,37,27,19,27,14,13,135,27,162,16.666666666666668
878,330030805000112,15,11,18,13,15,15,9,15,87,24,111,21.62162162162162
879,330030805000113,9,13,9,12,14,21,14,15,78,29,107,27.102803738317757
880,330030805000114,58,51,65,70,55,72,40,38,371,78,449,17.37193763919822
882,330030805000116,96,104,97,127,78,93,51,37,595,88,683,12.88433382137628
883,330030805000117,3,8,12,5,10,11,13,9,49,22,71,30.985915492957748
886,330030805000120,115,123,99,111,102,72,47,23,622,70,692,10.115606936416185
889,330030805000123,28,43,74,53,59,52,34,18,309,52,361,14.404432132963988
890,330030805000125,10,14,13,12,20,15,7,14,84,21,105,20.0
891,330030805000126,7,6,11,7,9,10,7,10,50,17,67,25.37313432835821
892,330030805000127,23,29,48,46,36,42,11,22,224,33,257,12.84046692607004
893,330030805000128,23,22,39,22,25,38,20,12,169,32,201,15.92039800995025
895,330030805000130,22,38,34,26,26,19,15,11,165,26,191,13.612565445026178
896,330030805000131,54,48,64,62,46,58,45,34,332,79,411,19.221411192214113
897,330030805000132,34,33,25,41,29,21,12,6,183,18,201,8.955223880597014
898,330030805000133,30,24,41,25,21,24,18,7,165,25,190,13.157894736842104
899,330030805000134,13,13,23,11,14,20,7,9,94,16,110,14.545454545454545
900,330030805000135,4,7,3,5,11,10,0,4,40,4,44,9.090909090909092
901,330030805000136,15,15,17,15,10,22,9,8,94,17,111,15.315315315315315
902,330030805000138,59,126,104,106,95,97,55,40,587,95,682,13.929618768328446
903,330030805000139,73,85,103,86,105,71,50,45,523,95,618,15.372168284789645
904,330030805000140,25,20,21,29,27,22,14,9,144,23,167,13.77245508982036
905,330030805000141,72,81,69,67,68,67,26,23,424,49,473,10.359408033826638
906,330030805000142,4,5,4,3,5,9,2,4,30,6,36,16.666666666666668
907,330030805000144,25,54,37,26,50,39,10,13,231,23,254,9.05511811023622
908,330030805000145,53,65,58,52,54,27,21,9,309,30,339,8.849557522123893
909,330030805000146,43,59,51,63,66,60,33,31,342,64,406,15.763546798029557
910,330030805000147,11,10,13,10,12,13,6,1,69,7,76,9.210526315789474
911,330030805000148,20,26,41,27,33,26,17,7,173,24,197,12.182741116751268
914,330030805000151,50,77,73,57,79,65,41,35,401,76,477,15.932914046121594
915,330030805000152,52,42,46,47,43,44,16,17,274,33,307,10.749185667752442
916,330030805000153,45,66,57,53,62,54,38,32,337,70,407,17.1990171990172
917,330030805000154,20,34,18,33,28,26,18,13,159,31,190,16.31578947368421
918,330030805000155,6,19,22,17,27,19,17,34,110,51,161,31.677018633540374
919,330030805000156,31,30,51,27,45,57,25,33,241,58,299,19.39799331103679
920,330030805000157,44,64,61,58,58,57,41,26,342,67,409,16.381418092909534
921,330030805000158,50,73,81,66,87,74,46,52,431,98,529,18.525519848771268
922,330030805000159,19,26,21,11,20,14,12,8,111,20,131,15.267175572519085
923,330030805000160,4,4,5,10,6,6,4,1,35,5,40,12.5
924,330030805000161,9,14,25,13,21,20,15,5,102,20,122,16.39344262295082
925,330030805000163,34,84,84,56,81,80,30,21,419,51,470,10.851063829787234
926,330030805000164,103,154,136,107,102,88,44,37,690,81,771,10.505836575875486
927,330030805000165,43,36,51,32,45,28,22,26,235,48,283,16.96113074204947
928,330030805000166,13,10,14,14,8,11,8,2,70,10,80,12.5
929,330030805000167,35,41,31,47,28,8,17,7,190,24,214,11.214953271028037
930,330030805000168,73,78,78,74,69,46,27,22,418,49,467,10.492505353319057
931,330030805000169,111,151,124,128,125,117,47,36,756,83,839,9.892729439809298
932,330030805000170,3,5,11,6,13,12,4,0,50,4,54,7.407407407407407
935,330030805000176,17,16,7,14,9,5,5,4,68,9,77,11.688311688311689
939,330030805000180,69,64,86,74,64,53,20,15,410,35,445,7.865168539325842
940,330030805000181,50,40,50,60,45,40,26,11,285,37,322,11.490683229813664
941,330030805000182,51,80,81,59,65,46,29,31,382,60,442,13.574660633484163
942,330030805000183,44,76,63,73,85,54,42,32,395,74,469,15.778251599147122
943,330030805000184,86,107,111,98,100,94,50,37,596,87,683,12.73792093704246
944,330030805000185,17,24,18,18,30,27,15,8,134,23,157,14.64968152866242
945,330030805000186,22,29,35,22,33,31,10,10,172,20,192,10.416666666666666
946,330030805000187,41,32,42,46,31,36,20,13,228,33,261,12.64367816091954
947,330030805000188,44,76,49,63,72,44,24,22,348,46,394,11.6751269035533
948,330030805000190,4,2,3,2,7,5,7,4,23,11,34,32.35294117647059
949,330030805000191,12,24,20,32,27,19,16,16,134,32,166,19.27710843373494
950,330030805000192,49,58,56,70,53,81,50,48,367,98,465,21.0752688172043
951,330030805000193,22,33,41,31,38,34,39,25,199,64,263,24.334600760456272
952,330030805000194,9,10,11,8,11,9,7,6,58,13,71,18.309859154929576
953,330030805000195,2,3,1,5,0,3,4,1,14,5,19,26.31578947368421
954,330030805000196,20,22,30,33,27,36,23,7,168,30,198,15.151515151515152
955,330030805000197,54,61,60,65,80,59,26,36,379,62,441,14.058956916099774
956,330030805000198,64,79,73,66,51,50,39,20,383,59,442,13.34841628959276
957,330030805000199,51,81,51,73,78,58,37,21,392,58,450,12.88888888888889
959,330030805000201,38,42,37,26,30,16,8,4,189,12,201,5.970149253731344
960,330030805000202,12,17,9,17,18,5,5,2,78,7,85,8.235294117647058
961,330030805000203,5,12,5,5,5,3,3,0,35,3,38,7.894736842105263
962,330030805000204,7,7,4,3,4,3,4,2,28,6,34,17.647058823529413
963,330030805000205,1,8,5,2,10,7,0,3,33,3,36,8.333333333333334
964,330030807000001,119,129,143,135,107,92,36,22,725,58,783,7.407407407407407
965,330030807000002,125,154,148,103,105,100,40,31,735,71,806,8.808933002481389
966,330030807000003,85,102,90,88,108,50,25,26,523,51,574,8.885017421602788
967,330030807000004,134,137,175,156,116,135,43,13,853,56,909,6.16061606160616
968,330030807000005,94,143,105,111,106,62,33,23,621,56,677,8.27178729689808
969,330030807000006,99,126,100,95,70,49,40,8,539,48,587,8.17717206132879
970,330030807000007,85,90,113,73,94,54,35,29,509,64,573,11.169284467713787
971,330030807000008,89,99,111,91,83,60,16,11,533,27,560,4.821428571428571
972,330030807000009,94,101,104,90,76,64,37,25,529,62,591,10.490693739424703
973,330030807000010,121,168,138,134,114,71,44,28,746,72,818,8.80195599022005
974,330030807000011,64,75,97,54,61,63,24,13,414,37,451,8.203991130820398
975,330030807000012,63,66,82,95,59,40,12,3,405,15,420,3.5714285714285716
976,330030807000013,101,116,96,81,82,58,30,13,534,43,577,7.452339688041595
977,330030807000014,118,110,196,173,145,134,44,25,876,69,945,7.301587301587301
978,330030807000015,56,82,118,90,82,99,42,23,527,65,592,10.97972972972973
979,330030807000016,100,117,123,104,98,85,36,32,627,68,695,9.784172661870503
980,330030807000017,140,142,166,146,108,97,50,33,799,83,882,9.410430839002268
981,330030807000018,146,88,134,164,111,69,27,14,712,41,753,5.444887118193891
982,330030807000019,70,57,79,99,72,66,24,4,443,28,471,5.944798301486199
983,330030810000001,95,131,120,121,98,86,59,30,651,89,740,12.027027027027026
984,330030810000002,66,93,140,138,94,83,47,44,614,91,705,12.907801418439716
985,330030810000003,50,71,43,54,55,29,16,12,302,28,330,8.484848484848484
986,330030810000004,38,46,60,62,49,27,32,17,282,49,331,14.803625377643504
987,330030810000005,67,79,65,64,55,52,27,26,382,53,435,12.183908045977011
988,330030815000001,122,142,117,110,106,71,48,32,668,80,748,10.695187165775401
989,330030815000002,26,29,35,35,39,24,29,24,188,53,241,21.991701244813278
990,330030815000003,109,135,112,124,151,111,75,51,742,126,868,14.516129032258064
991,330030815000004,69,96,98,96,88,72,62,52,519,114,633,18.009478672985782
992,330030815000005,42,55,51,43,66,38,25,20,295,45,340,13.235294117647058
993,330030815000006,70,88,69,71,59,40,30,29,397,59,456,12.93859649122807
994,330030815000007,97,126,103,90,81,65,38,24,562,62,624,9.935897435897436
995,330030815000008,41,64,49,50,63,46,24,23,313,47,360,13.055555555555555
996,330030815000009,7,4,2,4,4,2,0,1,23,1,24,4.166666666666667
997,330030820000001,29,45,41,49,43,51,31,28,258,59,317,18.61198738170347
998,330030820000002,24,20,20,36,22,13,3,14,135,17,152,11.18421052631579
999,330030820000003,21,20,22,21,23,21,10,14,128,24,152,15.789473684210526
1000,330030820000004,29,30,31,52,32,41,15,15,215,30,245,12.244897959183673
1001,330030825000001,69,86,94,66,66,74,52,32,455,84,539,15.584415584415584
1002,330030825000002,88,119,105,121,114,109,53,61,656,114,770,14.805194805194805
1003,330030825000003,68,89,80,94,98,57,40,33,486,73,559,13.059033989266547
1004,330030825000004,83,86,96,94,98,82,42,50,539,92,631,14.580031695721077
1005,330030825000005,34,43,44,60,28,38,21,8,247,29,276,10.507246376811594
1006,330030825000006,9,11,9,7,8,9,1,5,53,6,59,10.169491525423728
1007,330030825000007,45,56,38,50,53,19,21,17,261,38,299,12.709030100334449
1008,330030825000008,172,222,148,154,117,90,71,29,903,100,1003,9.970089730807578
1009,330030825000009,25,40,35,21,24,26,7,7,171,14,185,7.5675675675675675
1010,330030825000010,17,24,12,13,17,13,6,1,96,7,103,6.796116504854369
1011,330040705000001,1,10,11,9,11,5,4,0,47,4,51,7.8431372549019605
1012,330040705000002,48,43,36,35,21,25,15,10,208,25,233,10.729613733905579
1013,330040705000003,26,38,25,40,37,28,11,10,194,21,215,9.767441860465116
1014,330040705000004,2,4,8,5,4,6,0,1,29,1,30,3.3333333333333335
1015,330040705000006,26,18,24,22,14,14,13,3,118,16,134,11.940298507462687
1016,330040705000007,106,130,129,132,113,82,45,29,692,74,766,9.660574412532638
1017,330040705000008,70,96,69,81,69,46,34,17,431,51,482,10.58091286307054
1018,330040705000009,26,26,26,23,27,12,9,4,140,13,153,8.49673202614379
1019,330040705000010,19,28,26,15,27,26,6,2,141,8,149,5.369127516778524
1021,330040705000012,0,0,1,0,2,3,1,0,6,1,7,14.285714285714286
1023,330040705000014,9,19,12,16,12,8,5,5,76,10,86,11.627906976744185
1025,330040705000016,1,5,2,8,7,7,3,1,30,4,34,11.764705882352942
1026,330040705010001,12,25,40,18,29,45,46,51,169,97,266,36.46616541353384
1027,330040705010002,15,45,50,37,38,55,36,54,240,90,330,27.272727272727273
1028,330040705010003,6,15,24,23,14,32,22,17,114,39,153,25.49019607843137
1030,330040705010005,24,39,57,46,40,55,42,44,261,86,347,24.78386167146974
1031,330040705010006,36,53,40,48,50,42,24,15,269,39,308,12.662337662337663
1032,330040705010007,2,0,1,3,1,4,1,1,11,2,13,15.384615384615385
1033,330040705010008,57,102,97,98,103,84,51,71,541,122,663,18.401206636500753
1034,330040705010009,38,61,66,61,75,65,38,50,366,88,454,19.383259911894275
1035,330040705010010,12,19,22,32,29,37,18,31,151,49,200,24.5
1036,330040705010011,66,94,101,95,80,97,60,51,533,111,644,17.236024844720497
1037,330040705010012,17,18,28,26,21,44,11,22,154,33,187,17.647058823529413
1038,330040705010013,6,14,29,21,20,33,27,26,123,53,176,30.113636363636363
1039,330040705010014,18,26,30,44,49,46,32,26,213,58,271,21.40221402214022
1040,330040705010015,6,5,3,9,7,9,3,4,39,7,46,15.217391304347826
1041,330040705010016,51,66,88,37,77,57,23,39,376,62,438,14.155251141552512
1042,330040705010017,70,105,115,101,133,121,77,76,645,153,798,19.172932330827066
1043,330040705010018,65,80,131,97,114,117,71,58,604,129,733,17.598908594815825
1044,330040705010019,31,50,55,44,61,56,43,38,297,81,378,21.428571428571427
1045,330040705010020,34,52,64,53,67,63,36,37,333,73,406,17.980295566502463
1046,330040705010021,29,72,75,48,75,76,65,73,375,138,513,26.900584795321638
1047,330040705010022,10,29,33,15,38,25,29,33,150,62,212,29.245283018867923
1048,330040705010023,38,65,79,61,70,87,75,63,400,138,538,25.650557620817843
1049,330040705010024,32,47,65,47,49,63,33,33,303,66,369,17.88617886178862
1050,330040705010026,4,2,5,3,2,3,0,2,19,2,21,9.523809523809524
1051,330040705010027,17,21,33,29,32,30,29,15,162,44,206,21.359223300970875
1052,330040705010028,74,75,102,112,112,102,75,71,577,146,723,20.193637621023512
1053,330040705010029,0,0,1,0,0,5,7,19,6,26,32,81.25
1054,330040705010030,21,30,66,64,46,45,26,20,272,46,318,14.465408805031446
1055,330040705010031,60,95,185,102,119,125,81,69,686,150,836,17.942583732057415
1056,330040705010032,41,28,58,62,46,60,34,25,295,59,354,16.666666666666668
1057,330040705010033,37,42,63,60,73,49,34,19,324,53,377,14.058355437665783
1058,330040705010034,36,40,61,60,57,49,40,36,303,76,379,20.052770448548813
1059,330040705010035,8,18,19,10,17,12,6,6,84,12,96,12.5
1060,330040705010036,25,18,29,22,26,31,28,34,151,62,213,29.107981220657276
1061,330040705010037,36,53,45,55,54,52,35,27,295,62,357,17.366946778711483
1062,330040705010038,49,53,71,65,74,65,38,32,377,70,447,15.659955257270694
1063,330040705010039,59,97,112,89,130,111,59,51,598,110,708,15.536723163841808
1064,330040705010040,34,47,74,48,43,55,40,16,301,56,357,15.686274509803921
1065,330040705010041,34,53,51,58,59,65,29,38,320,67,387,17.31266149870801
1067,330040705010043,8,22,26,12,19,28,10,15,115,25,140,17.857142857142858
1068,330040705010044,6,3,4,8,8,4,5,9,33,14,47,29.78723404255319
1070,330040705010046,24,54,41,39,53,25,35,21,236,56,292,19.17808219178082
1071,330040705010047,6,7,10,6,9,7,10,2,45,12,57,21.05263157894737
1072,330040705010048,28,37,51,50,60,47,38,41,273,79,352,22.443181818181817
1073,330040705010050,82,120,101,103,127,100,70,49,633,119,752,15.824468085106384
1074,330040705010051,71,95,104,99,97,87,67,54,553,121,674,17.95252225519288
1075,330040705010052,8,13,17,7,20,30,14,20,95,34,129,26.356589147286822
1076,330040705010054,46,42,55,45,55,42,28,18,285,46,331,13.897280966767372
1078,330040705010056,13,6,16,25,16,17,19,24,93,43,136,31.61764705882353
1079,330040705010058,53,55,70,47,47,39,25,19,311,44,355,12.394366197183098
1080,330040705010059,28,31,63,37,44,47,21,19,250,40,290,13.793103448275861
1081,330040705010060,11,3,16,6,6,8,10,6,50,16,66,24.242424242424242
1082,330040705010061,0,3,4,3,4,2,1,0,16,1,17,5.882352941176471
1083,330040705010062,18,23,40,32,32,35,33,31,180,64,244,26.229508196721312
1084,330040705010063,38,72,72,65,80,52,22,36,379,58,437,13.272311212814646
1085,330040705010064,68,64,75,60,53,39,20,17,359,37,396,9.343434343434344
1086,330040705010065,10,22,20,13,19,9,8,11,93,19,112,16.964285714285715
1087,330040705010066,40,62,79,61,81,54,37,28,377,65,442,14.705882352941176
1088,330040705010067,28,34,35,28,37,24,18,10,186,28,214,13.08411214953271
1091,330040705010070,5,14,17,12,13,7,7,1,68,8,76,10.526315789473685
1092,330040705010072,0,0,0,0,0,6,4,1,6,5,11,45.45454545454545
1093,330040705020001,87,75,84,89,78,45,39,47,458,86,544,15.808823529411764
1094,330040705020002,109,142,135,129,129,80,54,32,724,86,810,10.617283950617283
1095,330040705020003,60,100,60,54,63,54,33,17,391,50,441,11.337868480725623
1096,330040705020004,89,99,96,83,96,66,58,32,529,90,619,14.539579967689821
1097,330040705020005,105,134,126,139,128,76,55,44,708,99,807,12.267657992565056
1098,330040705020006,98,130,120,135,147,87,47,50,717,97,814,11.916461916461916
1099,330040705020007,43,45,50,56,46,24,26,27,264,53,317,16.7192429022082
1100,330040705020008,71,104,92,90,71,68,40,22,496,62,558,11.11111111111111
1101,330040705020009,66,93,77,83,64,74,34,16,457,50,507,9.861932938856016
1102,330040705020010,68,65,77,73,58,61,21,16,402,37,439,8.428246013667426
1103,330040705020011,169,243,212,204,226,128,45,24,1182,69,1251,5.5155875299760195
1104,330040705020012,9,6,17,9,7,4,4,1,52,5,57,8.771929824561404
1105,330040705020013,9,16,15,17,13,13,8,1,83,9,92,9.782608695652174
1106,330040705020014,14,18,11,21,20,4,4,0,88,4,92,4.3478260869565215
1107,330040705020015,124,140,219,152,140,135,62,26,910,88,998,8.817635270541082
1108,330040705020016,51,66,73,67,60,63,25,14,380,39,419,9.307875894988067
1109,330040705020017,74,97,128,121,103,90,60,39,613,99,712,13.904494382022472
1110,330040705020018,30,48,39,36,51,19,21,22,223,43,266,16.165413533834588
1111,330040705020019,59,75,64,74,73,48,32,14,393,46,439,10.478359908883826
1112,330040705020020,28,42,44,41,39,29,12,7,223,19,242,7.851239669421488
1113,330040705020021,60,60,83,75,80,37,11,7,395,18,413,4.358353510895884
1114,330040705020022,71,98,120,82,87,86,34,12,544,46,590,7.796610169491525
1115,330040705020023,13,14,24,8,20,14,1,3,93,4,97,4.123711340206185
1116,330040705020024,127,178,146,155,132,87,37,20,825,57,882,6.462585034013605
1117,330040705020025,5,7,6,7,6,5,2,3,36,5,41,12.195121951219512
1118,330040705020026,71,81,87,96,72,59,28,23,466,51,517,9.864603481624759
1119,330040705020027,10,13,26,8,10,17,6,2,84,8,92,8.695652173913043
1120,330040705030001,18,19,15,25,33,16,7,16,126,23,149,15.436241610738255
1121,330040705030002,97,138,124,112,137,82,69,41,690,110,800,13.75
1122,330040705030003,152,210,189,170,173,148,72,69,1042,141,1183,11.918850380388841
1123,330040705030004,119,156,195,146,150,141,81,52,907,133,1040,12.788461538461538
1124,330040705030005,144,176,163,175,135,100,68,54,893,122,1015,12.019704433497537
1125,330040705030006,135,171,184,161,163,110,55,52,924,107,1031,10.37827352085354
1126,330040705030007,152,162,161,146,157,112,43,34,890,77,967,7.96277145811789
1127,330040705030008,71,91,72,95,65,48,31,11,442,42,484,8.677685950413224
1128,330040705030009,53,80,95,76,97,64,31,40,465,71,536,13.246268656716419
1129,330040705030010,47,54,94,46,82,70,26,27,393,53,446,11.883408071748878
1130,330040705030011,83,79,137,104,123,99,55,41,625,96,721,13.314840499306518
1131,330040705030012,52,62,61,72,48,36,18,18,331,36,367,9.809264305177111
1132,330040705030013,66,79,87,98,77,72,45,32,479,77,556,13.848920863309353
1133,330040705030014,184,190,230,215,176,148,66,42,1143,108,1251,8.633093525179856
1134,330040705030015,71,67,66,75,60,60,39,36,399,75,474,15.822784810126583
1135,330040705030016,145,173,149,165,157,101,67,46,890,113,1003,11.266201395812562
1136,330040705030017,98,106,133,130,119,95,75,55,681,130,811,16.029593094944513
1137,330040705030018,55,87,77,80,97,39,40,19,435,59,494,11.94331983805668
1138,330040705030019,87,99,124,80,94,84,25,25,568,50,618,8.090614886731391
1139,330040705030020,49,53,72,62,62,40,40,19,338,59,397,14.861460957178842
1140,330040705030021,23,34,38,27,37,28,8,15,187,23,210,10.952380952380953
1141,330040705030022,10,15,11,10,13,9,4,4,68,8,76,10.526315789473685
1142,330040705030023,37,54,59,39,56,28,19,15,273,34,307,11.074918566775244
1143,330040705030024,42,74,65,43,49,53,22,12,326,34,360,9.444444444444445
1145,330040705030026,18,19,33,28,15,25,6,7,138,13,151,8.609271523178808
1146,330040705030027,17,19,17,18,16,20,9,8,107,17,124,13.709677419354838
1147,330040705030028,6,14,16,4,12,13,11,6,65,17,82,20.73170731707317
1148,330040705030029,18,11,34,17,6,19,10,4,105,14,119,11.764705882352942
1150,330040705040001,127,139,188,153,125,103,44,37,835,81,916,8.842794759825328
1151,330040705040002,61,102,74,95,71,48,39,12,451,51,502,10.159362549800797
1152,330040705040003,18,18,23,26,9,19,14,4,113,18,131,13.740458015267176
1153,330040705040004,18,24,15,20,16,18,8,2,111,10,121,8.264462809917354
1154,330040705040005,13,23,19,22,27,6,3,8,110,11,121,9.090909090909092
1155,330040705040006,45,55,56,49,50,36,16,19,291,35,326,10.736196319018404
1156,330040705040007,151,174,170,186,154,125,64,56,960,120,1080,11.11111111111111
1157,330040705040008,21,16,20,22,22,14,8,5,115,13,128,10.15625
1158,330040705040009,94,129,152,119,141,125,59,52,760,111,871,12.743972445464983
1159,330040705040010,32,63,38,41,55,22,17,14,251,31,282,10.99290780141844
1160,330040705040011,69,97,119,111,96,90,52,56,582,108,690,15.652173913043478
1161,330040705040012,28,41,35,37,35,31,22,22,207,44,251,17.529880478087648
1162,330040705040013,23,36,53,38,57,53,32,39,260,71,331,21.45015105740181
1163,330040705040014,29,32,35,42,44,46,45,28,228,73,301,24.25249169435216
1164,330040705040015,0,0,0,0,0,1,10,31,1,41,42,97.61904761904762
1165,330040705040016,74,81,99,80,89,86,48,47,509,95,604,15.728476821192054
1166,330040705040017,15,34,38,22,56,30,9,23,195,32,227,14.09691629955947
1167,330040705040018,28,25,48,55,35,38,49,31,229,80,309,25.889967637540455
1168,330040705040019,79,111,152,128,156,131,71,71,757,142,899,15.795328142380423
1169,330040705040020,51,79,120,75,106,132,70,78,563,148,711,20.81575246132208
1170,330040705040021,74,96,124,68,106,99,47,50,567,97,664,14.608433734939759
1171,330040705040022,9,18,15,18,18,22,9,5,100,14,114,12.280701754385966
1172,330040705040023,109,111,105,149,138,84,55,32,696,87,783,11.11111111111111
1173,330040705040024,55,66,96,68,84,81,52,32,450,84,534,15.730337078651685
1174,330040705040025,17,24,15,33,26,32,24,25,147,49,196,25.0
1175,330040705040026,52,43,85,62,74,63,32,42,379,74,453,16.335540838852097
1176,330040705040027,49,60,57,84,62,65,33,25,377,58,435,13.333333333333334
1177,330040705040028,44,68,57,71,61,59,43,25,360,68,428,15.88785046728972
1178,330040705040029,63,84,78,84,87,50,43,35,446,78,524,14.885496183206106
1179,330040705040030,122,134,195,111,150,123,65,65,835,130,965,13.471502590673575
1180,330040705040031,38,52,49,56,49,28,34,17,272,51,323,15.789473684210526
1181,330040705040032,14,12,15,13,18,10,5,2,82,7,89,7.865168539325842
1182,330040705040033,141,182,178,156,177,114,72,46,948,118,1066,11.069418386491558
1183,330040705040034,62,90,62,64,56,31,22,17,365,39,404,9.653465346534654
1184,330040705040035,160,148,142,101,62,49,38,15,662,53,715,7.4125874125874125
1185,330040705040036,183,215,197,196,138,99,58,33,1028,91,1119,8.132260947274352
1186,330040705040037,77,90,87,59,55,29,16,10,397,26,423,6.1465721040189125
1187,330040705040038,7,12,6,4,4,4,0,0,37,0,37,0.0
1188,330040705040039,62,57,83,83,56,62,16,12,403,28,431,6.496519721577727
1189,330040705040040,3,11,4,8,5,4,1,1,35,2,37,5.405405405405405
1190,330040705040041,55,63,69,55,68,58,33,25,368,58,426,13.615023474178404
1191,330040705040042,42,46,51,47,39,30,12,13,255,25,280,8.928571428571429
1192,330040705040043,119,188,160,164,162,97,51,41,890,92,982,9.368635437881874
1193,330040705040044,105,115,113,109,85,76,34,42,603,76,679,11.192930780559646
1194,330040705040045,71,80,76,107,85,62,38,37,481,75,556,13.489208633093526
1195,330040705040046,48,43,34,34,23,14,13,6,196,19,215,8.837209302325581
1196,330040705040047,9,23,17,14,14,23,11,9,100,20,120,16.666666666666668
1197,330040705040048,74,102,88,59,53,50,18,21,426,39,465,8.387096774193548
1198,330040705040049,19,20,17,14,30,16,11,16,116,27,143,18.88111888111888
1199,330040705040050,54,46,61,80,48,40,16,10,329,26,355,7.323943661971831
1200,330040705040051,48,75,69,61,68,46,34,16,367,50,417,11.990407673860911
1202,330040705040053,13,24,18,19,23,21,7,0,118,7,125,5.6
1203,330040705040054,7,2,27,13,12,19,5,4,80,9,89,10.112359550561798
1204,330040705040055,9,8,13,10,9,4,4,1,53,5,58,8.620689655172415
1205,330040705040056,25,14,18,42,27,23,9,16,149,25,174,14.367816091954023
1206,330040705040057,5,12,20,14,17,8,5,3,76,8,84,9.523809523809524
1207,330040705040058,7,6,9,16,14,5,6,3,57,9,66,13.636363636363637
1208,330040705040059,83,108,103,91,85,60,35,37,530,72,602,11.960132890365449
1209,330040705040060,94,97,64,84,53,35,26,19,427,45,472,9.533898305084746
1210,330040705040061,20,22,20,13,12,10,9,4,97,13,110,11.818181818181818
1212,330040705050001,120,134,165,150,107,127,64,48,803,112,915,12.240437158469945
1213,330040705050002,83,113,94,71,97,76,43,26,534,69,603,11.442786069651742
1214,330040705050003,9,9,14,5,5,10,3,3,52,6,58,10.344827586206897
1215,330040705050004,49,99,73,56,94,47,37,25,418,62,480,12.916666666666666
1216,330040705050005,41,69,63,50,66,50,22,17,339,39,378,10.317460317460318
1217,330040705050006,31,22,43,23,32,36,12,7,187,19,206,9.223300970873787
1218,330040705050007,78,99,110,105,83,74,45,32,549,77,626,12.300319488817891
1219,330040705050008,62,55,79,67,79,64,38,26,406,64,470,13.617021276595745
1220,330040705050009,28,33,38,31,25,35,29,10,190,39,229,17.03056768558952
1221,330040705050010,3,7,10,8,7,4,5,2,39,7,46,15.217391304347826
1222,330040705050011,82,94,138,123,96,106,48,34,639,82,721,11.373092926490985
1223,330040705050012,20,37,24,27,28,15,11,4,151,15,166,9.036144578313253
1224,330040705050013,47,46,55,63,42,40,21,20,293,41,334,12.275449101796408
1225,330040705050014,11,18,4,13,6,1,3,1,53,4,57,7.017543859649122
1226,330040705050015,145,148,160,165,133,119,55,39,870,94,964,9.751037344398341
1227,330040705050016,70,86,61,86,80,36,43,21,419,64,483,13.250517598343686
1228,330040705050017,19,26,34,28,25,19,11,2,151,13,164,7.926829268292683
1229,330040705050018,86,90,131,100,110,67,57,24,584,81,665,12.180451127819548
1230,330040705050019,28,39,35,49,37,42,25,15,230,40,270,14.814814814814815
1231,330040705050020,48,45,66,52,57,49,25,11,317,36,353,10.19830028328612
1232,330040705050021,14,19,23,7,15,12,9,10,90,19,109,17.431192660550458
1233,330040705050022,30,35,61,58,24,73,41,8,281,49,330,14.848484848484848
1234,330040705050023,17,23,34,29,26,36,16,9,165,25,190,13.157894736842104
1235,330040705050024,24,34,28,26,45,20,21,19,177,40,217,18.433179723502302
1236,330040705050025,32,59,59,52,57,42,27,20,301,47,348,13.505747126436782
1237,330040705050026,15,34,40,32,31,25,15,17,177,32,209,15.311004784688995
1238,330040705050028,58,89,66,35,58,44,12,4,350,16,366,4.371584699453552
1239,330040705050029,0,2,6,1,3,6,0,1,18,1,19,5.2631578947368425
1240,330040705050030,116,163,168,108,145,121,33,22,821,55,876,6.2785388127853885
1241,330040705050032,29,33,20,11,13,6,1,1,112,2,114,1.7543859649122806
1242,330040705050033,59,44,35,30,21,9,7,4,198,11,209,5.2631578947368425
1243,330040705060001,39,44,49,40,42,39,14,15,253,29,282,10.28368794326241
1244,330040705060002,25,19,37,31,25,31,23,22,168,45,213,21.12676056338028
1245,330040705060003,25,39,42,51,43,39,36,20,239,56,295,18.983050847457626
1247,330040705060005,26,44,72,57,57,80,40,24,336,64,400,16.0
1248,330040705060006,29,40,57,48,31,26,27,9,231,36,267,13.48314606741573
1249,330040705060007,11,27,21,17,19,19,1,8,114,9,123,7.317073170731708
1250,330040705060008,57,77,43,67,82,47,35,42,373,77,450,17.11111111111111
1251,330040705060009,133,145,157,127,114,101,54,53,777,107,884,12.104072398190045
1252,330040705060010,23,22,23,21,13,17,8,3,119,11,130,8.461538461538462
1253,330040705060012,62,65,92,59,60,66,35,31,404,66,470,14.042553191489361
1254,330040705060013,53,83,81,81,70,58,44,44,426,88,514,17.120622568093385
1255,330040705060014,56,61,50,61,61,41,24,29,330,53,383,13.838120104438643
1256,330040705060015,23,41,32,30,52,22,27,14,200,41,241,17.012448132780083
1257,330040705060016,67,105,99,104,77,64,58,42,516,100,616,16.233766233766232
1258,330040705060017,46,45,55,47,54,25,31,20,272,51,323,15.789473684210526
1259,330040705060018,50,69,83,76,53,56,26,11,387,37,424,8.726415094339623
1260,330040705060019,21,9,14,18,14,8,3,2,84,5,89,5.617977528089888
1261,330040705060020,35,43,35,32,35,19,14,11,199,25,224,11.160714285714286
1262,330040705060021,18,31,20,16,25,10,3,6,120,9,129,6.976744186046512
1264,330040705060023,16,19,22,13,16,9,6,2,95,8,103,7.766990291262136
1265,330040705060024,12,18,18,17,16,23,8,4,104,12,116,10.344827586206897
1266,330040705060025,14,22,37,29,33,32,33,16,167,49,216,22.685185185185187
1267,330040705060026,24,30,28,15,31,15,9,10,143,19,162,11.728395061728396
1268,330040705060029,27,35,16,28,27,12,8,11,145,19,164,11.585365853658537
1269,330040705060031,19,37,35,20,47,28,19,15,186,34,220,15.454545454545455
1270,330040705060032,23,39,42,35,45,37,18,13,221,31,252,12.301587301587302
1271,330040705060033,7,13,5,10,19,6,5,3,60,8,68,11.764705882352942
1272,330040705060034,22,25,35,35,27,24,12,14,168,26,194,13.402061855670103
1273,330040705060035,36,29,34,25,24,17,8,8,165,16,181,8.839779005524862
1274,330040705060036,20,21,16,28,14,20,8,6,119,14,133,10.526315789473685
1275,330040705060037,53,70,64,51,41,42,16,12,321,28,349,8.022922636103152
1276,330040705060038,78,94,87,85,76,52,34,21,472,55,527,10.436432637571157
1277,330040705060039,20,26,29,22,21,18,10,6,136,16,152,10.526315789473685
1280,330040705060043,1,3,5,1,3,0,2,0,13,2,15,13.333333333333334
1281,330040705060045,47,59,56,31,34,37,13,6,264,19,283,6.713780918727915
1282,330040705060046,7,13,19,7,15,8,1,2,69,3,72,4.166666666666667
1283,330040705060047,17,21,19,8,7,7,4,0,79,4,83,4.819277108433735
1284,330040705070001,80,97,122,115,73,78,42,21,565,63,628,10.031847133757962
1285,330040705070002,2,5,4,0,5,2,1,2,18,3,21,14.285714285714286
1286,330040705070003,65,84,66,72,49,48,31,17,384,48,432,11.11111111111111
1287,330040705070004,118,117,145,99,116,84,46,23,679,69,748,9.224598930481283
1288,330040705070005,57,87,77,69,71,66,41,20,427,61,488,12.5
1289,330040705070006,103,116,124,119,95,67,44,32,624,76,700,10.857142857142858
1290,330040705070007,73,83,77,52,47,47,20,4,379,24,403,5.955334987593052
1291,330040705070008,166,164,168,164,108,88,47,26,858,73,931,7.841031149301826
1292,330040705070009,146,152,156,187,135,106,67,43,882,110,992,11.088709677419354
1293,330040705070010,12,17,4,13,11,6,1,2,63,3,66,4.545454545454546
1294,330040705070011,70,70,85,87,71,73,48,23,456,71,527,13.472485768500949
1295,330040705070013,27,28,34,19,20,21,11,5,149,16,165,9.696969696969697
1297,330040705070015,131,177,149,150,145,85,44,41,837,85,922,9.219088937093275
1298,330040705070016,127,162,155,124,118,87,38,8,773,46,819,5.616605616605616
1299,330040705070018,9,12,6,13,7,11,5,2,58,7,65,10.76923076923077
1300,330040705070019,46,72,55,47,55,29,22,15,304,37,341,10.850439882697946
1301,330040705070020,18,9,18,7,5,8,8,3,65,11,76,14.473684210526315
1303,330040705070022,7,17,15,11,11,9,9,2,70,11,81,13.580246913580247
1304,330040705070023,107,101,117,111,74,84,27,18,594,45,639,7.042253521126761
1305,330040705070024,56,85,59,70,49,50,33,9,369,42,411,10.218978102189782
1306,330040705070025,113,123,138,127,109,75,59,20,685,79,764,10.340314136125654
1307,330040705070026,31,46,53,68,44,49,16,14,291,30,321,9.345794392523365
1308,330040705070027,9,13,12,14,14,9,7,7,71,14,85,16.470588235294116
1311,330040705070030,6,4,5,3,5,2,0,0,25,0,25,0.0
1312,330040705080001,60,55,72,65,53,68,21,34,373,55,428,12.850467289719626
1315,330040705080004,65,99,131,89,99,73,56,48,556,104,660,15.757575757575758
1316,330040705080005,49,51,57,55,51,52,22,29,315,51,366,13.934426229508198
1317,330040705080006,88,133,99,97,101,74,46,49,592,95,687,13.828238719068413
1318,330040705080007,26,58,43,52,64,42,31,32,285,63,348,18.103448275862068
1319,330040705080008,74,110,76,89,99,68,38,35,516,73,589,12.393887945670627
1320,330040705080009,106,115,109,161,107,65,57,49,663,106,769,13.784135240572171
1321,330040705080010,67,66,94,77,86,55,28,24,445,52,497,10.462776659959758
1322,330040705080011,94,174,171,147,172,109,77,51,867,128,995,12.864321608040202
1323,330040705080012,93,113,115,129,94,62,49,34,606,83,689,12.04644412191582
1324,330040705080013,35,37,50,46,33,39,16,9,240,25,265,9.433962264150944
1325,330040705080014,55,74,61,51,41,31,14,11,313,25,338,7.396449704142012
1326,330040705080015,76,92,104,94,103,96,62,42,565,104,669,15.54559043348281
1327,330040705080016,43,60,75,56,94,66,27,40,394,67,461,14.533622559652928
1328,330040705080017,69,70,87,76,78,73,28,24,453,52,505,10.297029702970297
1330,330040705080019,91,118,124,100,86,72,51,32,591,83,674,12.31454005934718
1331,330040705080020,92,121,103,96,84,76,22,16,572,38,610,6.229508196721311
1332,330040705080021,15,27,17,25,19,15,2,10,118,12,130,9.23076923076923
1334,330040705090001,15,30,12,20,27,11,7,9,115,16,131,12.213740458015268
1335,330040705090002,155,196,208,196,165,132,76,44,1052,120,1172,10.238907849829351
1336,330040705090003,19,16,21,15,17,10,4,6,98,10,108,9.25925925925926
1337,330040705090004,63,122,95,65,102,45,26,15,492,41,533,7.6923076923076925
1338,330040705090005,37,49,50,45,60,37,20,13,278,33,311,10.610932475884244
1339,330040705090006,60,75,60,69,60,50,21,18,374,39,413,9.443099273607748
1340,330040705090007,31,35,41,32,27,24,16,8,190,24,214,11.214953271028037
1341,330040705090008,39,92,63,44,69,50,21,20,357,41,398,10.301507537688442
1342,330040705090009,45,56,56,53,37,49,18,9,296,27,323,8.359133126934985
1344,330040705090011,56,87,86,79,97,52,43,24,457,67,524,12.786259541984732
1346,330040705090013,10,9,6,14,3,4,3,1,46,4,50,8.0
1348,330040705090015,5,6,10,7,6,7,0,1,41,1,42,2.380952380952381
1349,330040705090016,183,223,185,184,167,91,40,16,1033,56,1089,5.142332415059688
1350,330040705090017,51,57,44,41,55,25,24,15,273,39,312,12.5
1351,330040705090018,6,5,2,5,2,6,0,0,26,0,26,0.0
1352,330040705090019,78,81,90,66,72,33,21,12,420,33,453,7.28476821192053
1353,330040705090020,62,51,54,72,32,42,15,9,313,24,337,7.121661721068249
1354,330040705090021,84,105,86,91,105,64,36,18,535,54,589,9.168081494057725
1355,330040705090022,37,36,46,34,30,28,19,16,211,35,246,14.227642276422765
1356,330040705090023,73,80,89,81,90,75,37,30,488,67,555,12.072072072072071
1357,330040705090024,35,75,56,50,44,27,16,12,287,28,315,8.88888888888889
1359,330040705100001,63,89,86,94,85,86,50,54,503,104,607,17.133443163097198
1360,330040705100002,102,140,127,118,109,79,52,39,675,91,766,11.879895561357703
1361,330040705100003,71,108,104,103,104,92,43,43,582,86,668,12.874251497005988
1362,330040705100004,50,78,57,63,64,45,21,18,357,39,396,9.848484848484848
1363,330040705100005,8,20,16,22,20,14,11,8,100,19,119,15.966386554621849
1364,330040705100006,24,34,55,29,38,25,20,11,205,31,236,13.135593220338983
1365,330040705100007,26,23,25,23,22,14,16,11,133,27,160,16.875
1367,330040705100009,78,99,92,83,84,80,39,27,516,66,582,11.34020618556701
1370,330040705100013,33,54,47,42,38,23,27,12,237,39,276,14.130434782608695
1371,330040705100014,10,14,17,14,9,16,5,8,80,13,93,13.978494623655914
1372,330040705100015,60,93,88,78,72,61,24,24,452,48,500,9.6
1373,330040705100016,34,39,39,47,48,19,23,12,226,35,261,13.409961685823754
1374,330040705100017,55,48,72,59,40,37,19,8,311,27,338,7.988165680473373
1375,330040705100018,58,59,47,70,37,24,34,21,295,55,350,15.714285714285714
1376,330040705100019,9,10,8,11,6,4,3,1,48,4,52,7.6923076923076925
1377,330040705100020,10,9,12,12,13,12,7,2,68,9,77,11.688311688311689
1378,330040705100021,25,46,51,36,43,46,36,16,247,52,299,17.391304347826086
1379,330040705100022,7,4,2,9,5,2,1,5,29,6,35,17.142857142857142
1380,330040705100023,33,61,68,50,62,53,16,9,327,25,352,7.1022727272727275
1381,330040705100024,142,139,170,134,122,73,24,8,780,32,812,3.9408866995073892
1382,330040705100025,126,218,173,170,138,104,63,32,929,95,1024,9.27734375
1383,330040705100026,42,107,82,78,96,62,36,22,467,58,525,11.047619047619047
1384,330040705100027,119,128,132,127,107,83,57,27,696,84,780,10.76923076923077
1386,330040705110001,1,3,2,2,5,4,0,0,17,0,17,0.0
1387,330040705110002,41,43,52,44,54,28,22,11,262,33,295,11.186440677966102
1388,330040705110003,83,149,132,112,127,91,51,43,694,94,788,11.928934010152284
1389,330040705110004,64,98,54,70,60,34,12,16,380,28,408,6.862745098039215
1390,330040705110005,73,84,78,63,51,50,34,13,399,47,446,10.538116591928251
1391,330040705110006,116,126,142,120,112,99,46,39,715,85,800,10.625
1392,330040705110007,88,100,133,101,104,96,69,46,622,115,737,15.603799185888738
1393,330040705110008,9,5,3,7,10,6,4,7,40,11,51,21.568627450980394
1394,330040705110009,90,107,115,95,108,61,37,30,576,67,643,10.419906687402799
1395,330040705110010,144,180,203,150,153,143,56,58,973,114,1087,10.48758049678013
1396,330040705110011,58,73,83,75,79,74,40,38,442,78,520,15.0
1397,330040705110012,71,101,102,81,65,80,37,24,500,61,561,10.87344028520499
1398,330040705110013,68,109,83,71,82,53,30,36,466,66,532,12.406015037593985
1399,330040705110014,31,29,40,28,30,20,17,9,178,26,204,12.745098039215685
1400,330040705110015,103,128,157,104,119,101,46,41,712,87,799,10.888610763454318
1401,330040705110016,21,29,22,32,27,29,15,13,160,28,188,14.893617021276595
1402,330040705110017,2,5,3,4,2,3,2,0,19,2,21,9.523809523809524
1403,330040705110018,42,48,39,32,22,21,9,5,204,14,218,6.422018348623853
1404,330040705110019,12,7,11,9,5,4,1,3,48,4,52,7.6923076923076925
1405,330040705120001,155,183,137,181,178,98,54,40,932,94,1026,9.161793372319687
1406,330040705120002,20,25,27,22,16,21,11,7,131,18,149,12.080536912751677
1407,330040705120003,84,98,97,86,78,58,39,18,501,57,558,10.21505376344086
1408,330040705120004,61,61,56,58,42,40,29,19,318,48,366,13.114754098360656
1409,330040705120005,117,124,114,87,98,45,36,20,585,56,641,8.736349453978159
1410,330040705120006,99,135,87,100,93,61,42,21,575,63,638,9.87460815047022
1411,330040705120008,116,147,124,125,121,81,49,42,714,91,805,11.304347826086957
1412,330040705120009,25,28,25,26,26,20,9,8,150,17,167,10.179640718562874
1413,330040705120010,55,52,65,39,39,32,14,7,282,21,303,6.930693069306931
1414,330040705120011,15,20,11,12,16,10,3,2,84,5,89,5.617977528089888
1415,330040705130001,94,127,182,151,133,159,121,56,846,177,1023,17.302052785923753
1416,330040705130002,118,109,132,106,103,89,35,21,657,56,713,7.854137447405329
1417,330040705130003,45,49,73,67,65,68,31,12,367,43,410,10.487804878048781
1418,330040705130004,64,89,102,96,79,83,34,18,513,52,565,9.20353982300885
1419,330040705130005,77,123,79,107,88,77,35,27,551,62,613,10.114192495921696
1420,330040705130006,79,97,94,72,84,61,33,34,487,67,554,12.093862815884476
1421,330040705130007,30,44,37,36,35,32,13,28,214,41,255,16.07843137254902
1422,330040705130008,84,114,171,132,124,102,58,34,727,92,819,11.233211233211232
1423,330040705130009,24,41,41,45,34,26,15,13,211,28,239,11.715481171548117
1424,330040705130010,85,97,117,109,95,66,33,12,569,45,614,7.328990228013029
1425,330040705130011,165,206,207,183,189,106,50,28,1056,78,1134,6.878306878306878
1426,330040705130012,53,65,61,68,91,43,33,10,381,43,424,10.141509433962264
1427,330040705130013,66,93,81,87,70,50,37,17,447,54,501,10.778443113772456
1428,330040705130014,67,82,87,67,73,57,21,19,433,40,473,8.456659619450317
1429,330040705130015,100,124,103,109,109,81,60,45,626,105,731,14.36388508891929
1430,330040705130016,81,63,91,100,53,42,19,6,430,25,455,5.4945054945054945
1431,330040705130017,69,77,53,67,64,34,28,28,364,56,420,13.333333333333334
1432,330040705130019,3,9,8,7,4,14,3,0,45,3,48,6.25
1433,330040705130020,40,49,77,66,58,61,29,14,351,43,394,10.913705583756345
1434,330040705130021,108,137,110,143,115,98,57,28,711,85,796,10.678391959798995
1435,330040705130023,6,9,12,7,9,10,4,1,53,5,58,8.620689655172415
1436,330040705130024,23,28,32,21,32,25,17,11,161,28,189,14.814814814814815
1437,330040705130025,31,30,33,33,33,35,19,14,195,33,228,14.473684210526315
1438,330040705130026,41,73,77,67,78,74,26,19,410,45,455,9.89010989010989
1439,330040705130027,17,33,43,32,33,43,12,9,201,21,222,9.45945945945946
1440,330040705130028,31,56,60,49,57,43,31,15,296,46,342,13.450292397660819
1441,330040705140001,60,89,79,76,80,61,43,34,445,77,522,14.75095785440613
1443,330040705140003,61,99,95,99,90,76,45,44,520,89,609,14.614121510673234
1444,330040705140004,53,104,85,86,94,98,48,67,520,115,635,18.11023622047244
1445,330040705140005,25,36,40,24,35,42,14,16,202,30,232,12.931034482758621
1446,330040705140006,80,130,128,117,121,94,50,28,670,78,748,10.427807486631016
1447,330040705140007,73,155,108,102,118,72,44,26,628,70,698,10.02865329512894
1448,330040705140008,65,81,92,81,79,57,36,26,455,62,517,11.992263056092844
1449,330040705140009,49,96,51,68,66,33,27,14,363,41,404,10.148514851485148
1450,330040705140010,39,61,59,66,57,47,23,15,329,38,367,10.354223433242506
1451,330040705140011,94,109,127,125,104,78,46,40,637,86,723,11.894882434301522
1452,330040705140012,40,53,67,55,43,30,11,8,288,19,307,6.188925081433225
1453,330040705140014,35,59,72,50,77,62,32,36,355,68,423,16.07565011820331
1455,330040705140016,87,137,124,120,119,91,37,45,678,82,760,10.789473684210526
1456,330040705140017,68,84,91,89,103,59,52,30,494,82,576,14.23611111111111
1457,330040705140018,75,95,116,101,93,98,60,26,578,86,664,12.951807228915662
1460,330040709000001,15,20,21,16,15,14,9,6,101,15,116,12.931034482758621
1461,330040709000002,91,88,92,93,47,60,33,31,471,64,535,11.962616822429906
1462,330040715000001,70,90,82,77,89,76,45,54,484,99,583,16.9811320754717
1463,330040715000002,72,122,65,87,84,72,26,18,502,44,546,8.058608058608058
1464,330040715000003,26,42,26,40,31,32,11,12,197,23,220,10.454545454545455
1465,330040715000004,9,6,6,9,4,8,3,6,42,9,51,17.647058823529413
1466,330040715000005,24,14,15,21,20,14,11,4,108,15,123,12.195121951219512
1467,330040715000006,7,19,10,11,12,14,5,3,73,8,81,9.876543209876543
1468,330040715000007,11,11,13,8,10,2,1,2,55,3,58,5.172413793103448
1469,330040720000001,151,182,190,153,156,140,65,92,972,157,1129,13.906111603188663
1470,330040720000002,45,41,41,35,38,32,17,10,232,27,259,10.424710424710424
1471,330040720000003,16,15,19,11,24,17,8,6,102,14,116,12.068965517241379
1472,330040730000001,128,133,144,111,128,103,54,43,747,97,844,11.492890995260664
1473,330040730000002,10,9,11,9,12,10,4,7,61,11,72,15.277777777777779
1474,330040740000001,179,233,214,199,178,111,76,51,1114,127,1241,10.233682514101531
1475,330040740000002,11,12,5,12,13,6,3,1,59,4,63,6.349206349206349
1476,330045605010001,23,22,28,29,31,25,30,19,158,49,207,23.67149758454106
1477,330045605010002,22,40,32,34,45,33,23,37,206,60,266,22.55639097744361
1478,330045605010003,73,62,81,72,49,49,28,18,386,46,432,10.648148148148149
1479,330045605010004,41,37,57,39,40,41,19,13,255,32,287,11.149825783972126
1480,330045605010005,85,83,90,82,70,67,36,24,477,60,537,11.1731843575419
1481,330045605010006,46,63,81,63,66,74,64,46,393,110,503,21.868787276341948
1482,330045605010007,87,122,125,102,102,110,58,33,648,91,739,12.313937753721245
1483,330045605010008,61,76,82,75,87,69,49,28,450,77,527,14.61100569259962
1484,330045605010009,39,45,39,27,39,30,29,14,219,43,262,16.412213740458014
1485,330045605010010,89,118,103,118,104,92,54,48,624,102,726,14.049586776859504
1486,330045605010011,76,109,82,106,103,62,49,40,538,89,627,14.19457735247209
1487,330045605010012,87,103,102,96,96,86,51,58,570,109,679,16.05301914580265
1488,330045605010013,65,88,65,83,77,70,35,33,448,68,516,13.178294573643411
1489,330045605010014,69,80,103,91,73,66,40,31,482,71,553,12.839059674502712
1490,330045605010015,74,109,76,99,62,61,34,27,481,61,542,11.254612546125461
1491,330045605010016,100,100,139,117,97,83,63,48,636,111,747,14.859437751004016
1492,330045605010017,55,84,69,80,59,69,38,29,416,67,483,13.871635610766045
1493,330045605010018,87,106,93,108,84,88,37,28,566,65,631,10.301109350237718
1494,330045605010019,92,134,100,109,96,71,65,29,602,94,696,13.505747126436782
1495,330045605010020,73,116,108,90,93,79,51,44,559,95,654,14.525993883792049
1496,330045605010021,67,60,79,66,60,63,28,18,395,46,441,10.430839002267573
1497,330045605010022,90,102,103,118,90,73,48,40,576,88,664,13.25301204819277
1498,330045605010023,74,68,80,89,46,37,45,18,394,63,457,13.785557986870897
1499,330045605010024,69,80,85,82,52,64,47,22,432,69,501,13.77245508982036
1500,330045605010025,78,95,111,89,108,81,44,45,562,89,651,13.671274961597542
1501,330045605010026,84,134,108,98,100,79,52,41,603,93,696,13.362068965517242
1502,330045605010027,75,83,86,81,54,58,27,25,437,52,489,10.633946830265849
1503,330045605010028,43,56,71,59,56,56,34,25,341,59,400,14.75
1504,330045605010029,46,47,60,51,51,55,26,27,310,53,363,14.600550964187327
1505,330045605010030,111,145,134,116,134,87,24,27,727,51,778,6.5552699228791775
1506,330045605010031,124,149,154,117,134,95,45,45,773,90,863,10.428736964078794
1507,330045605010032,92,125,123,104,111,82,38,31,637,69,706,9.773371104815864
1508,330045605010033,54,77,82,93,50,74,44,21,430,65,495,13.131313131313131
1509,330045605010034,66,72,107,69,71,74,43,40,459,83,542,15.313653136531366
1510,330045605010035,90,87,99,103,80,63,44,41,522,85,607,14.00329489291598
1511,330045605010036,99,110,111,106,84,74,43,39,584,82,666,12.312312312312311
1512,330045605010037,52,99,70,76,83,55,35,25,435,60,495,12.121212121212121
1513,330045605010038,74,87,116,72,70,71,37,31,490,68,558,12.186379928315413
1514,330045605010039,52,67,61,67,64,31,34,22,342,56,398,14.07035175879397
1515,330045605010040,53,62,69,57,57,49,23,25,347,48,395,12.151898734177216
1516,330045605010041,115,124,131,113,116,58,76,36,657,112,769,14.564369310793237
1517,330045605010042,81,130,125,104,112,80,42,32,632,74,706,10.48158640226629
1518,330045605010043,105,118,121,126,136,92,48,42,698,90,788,11.421319796954315
1519,330045605010044,71,113,116,111,125,105,43,56,641,99,740,13.378378378378379
1520,330045605010045,58,80,77,91,101,70,56,50,477,106,583,18.181818181818183
1521,330045605010046,88,128,120,107,91,64,40,18,598,58,656,8.841463414634147
1522,330045605010047,117,125,123,93,82,57,30,27,597,57,654,8.715596330275229
1523,330045605010048,89,84,102,89,109,82,36,24,555,60,615,9.75609756097561
1524,330045605010049,119,163,132,129,100,85,36,17,728,53,781,6.786171574903969
1525,330045605010050,95,148,113,112,102,88,49,24,658,73,731,9.986320109439124
1526,330045605010051,72,97,79,78,75,58,37,27,459,64,523,12.237093690248566
1527,330045605010052,91,107,101,106,90,70,53,37,565,90,655,13.740458015267176
1528,330045605010053,59,78,78,74,71,53,21,16,413,37,450,8.222222222222221
1529,330045605010054,72,126,134,107,101,91,51,36,631,87,718,12.116991643454039
1530,330045605010055,73,74,75,72,66,52,26,21,412,47,459,10.239651416122005
1531,330045605010056,55,102,98,87,91,90,44,33,523,77,600,12.833333333333334
1532,330045605010057,54,67,63,48,51,39,22,10,322,32,354,9.03954802259887
1533,330045605010058,20,30,35,21,15,23,15,8,144,23,167,13.77245508982036
1534,330045605010059,125,172,133,132,124,94,64,27,780,91,871,10.447761194029852
1535,330045605010060,37,41,44,55,45,40,23,13,262,36,298,12.080536912751677
1536,330045605010061,42,59,59,55,44,44,29,16,303,45,348,12.931034482758621
1537,330045605010062,83,101,93,94,72,85,43,31,528,74,602,12.29235880398671
1538,330045605010063,66,82,91,80,52,58,30,16,429,46,475,9.68421052631579
1539,330045605010064,73,91,101,62,65,81,32,16,473,48,521,9.213051823416507
1540,330045605010065,96,82,106,88,71,72,27,26,515,53,568,9.330985915492958
1541,330045605010066,131,178,145,121,120,81,42,43,776,85,861,9.872241579558652
1542,330045605010067,109,131,131,114,102,77,32,33,664,65,729,8.916323731138545
1543,330045605010068,97,127,125,106,108,114,38,30,677,68,745,9.12751677852349
1544,330045605010069,52,85,79,72,66,50,33,21,404,54,458,11.790393013100436
1545,330045605010070,74,89,82,72,74,56,25,22,447,47,494,9.51417004048583
1546,330045605010071,102,122,115,101,95,68,40,30,603,70,673,10.401188707280832
1547,330045605010072,116,164,109,116,118,59,34,32,682,66,748,8.823529411764707
1548,330045605010073,125,139,122,136,104,74,41,37,700,78,778,10.025706940874036
1549,330045605010074,166,193,166,178,136,91,57,35,930,92,1022,9.001956947162427
1550,330045605010075,76,82,82,87,79,66,28,25,472,53,525,10.095238095238095
1551,330045605010076,50,66,62,62,50,48,17,14,338,31,369,8.401084010840108
1552,330045605010077,55,69,83,54,75,57,20,28,393,48,441,10.884353741496598
1553,330045605010078,44,76,77,64,89,58,44,23,408,67,475,14.105263157894736
1554,330045605010079,63,69,72,72,49,50,47,21,375,68,443,15.349887133182845
1555,330045605010080,49,72,53,63,47,40,36,18,324,54,378,14.285714285714286
1556,330045605010081,77,106,89,79,81,47,32,32,479,64,543,11.786372007366483
1557,330045605010082,44,64,66,49,47,45,22,14,315,36,351,10.256410256410257
1558,330045605010083,45,70,74,52,72,55,34,26,368,60,428,14.018691588785046
1559,330045605010084,90,113,150,124,125,111,71,46,713,117,830,14.096385542168674
1560,330045605010085,83,100,94,91,76,74,45,30,518,75,593,12.647554806070826
1561,330045605010086,49,65,55,49,47,51,20,19,316,39,355,10.985915492957746
1562,330045605010087,65,96,106,70,105,91,35,48,533,83,616,13.474025974025974
1563,330045605010088,108,113,101,99,72,59,23,28,552,51,603,8.457711442786069
1564,330045605010089,74,100,69,81,72,60,27,23,456,50,506,9.881422924901186
1565,330045605010090,59,58,67,60,61,49,28,27,354,55,409,13.447432762836186
1566,330045605010091,140,179,126,151,113,86,54,27,795,81,876,9.246575342465754
1567,330045605010092,103,124,127,119,90,78,49,32,641,81,722,11.218836565096954
1568,330045605010093,48,71,54,67,61,54,18,22,355,40,395,10.126582278481013
1569,330045605010094,81,83,87,87,74,50,33,17,462,50,512,9.765625
1570,330045605010095,130,199,136,160,130,96,56,27,851,83,934,8.886509635974305
1571,330045605010096,184,215,199,164,143,96,42,39,1001,81,1082,7.486136783733826
1572,330045605010097,87,98,95,95,76,54,19,20,505,39,544,7.169117647058823
1573,330045605010098,183,247,190,174,139,95,66,37,1028,103,1131,9.106984969053935
1574,330045605010099,106,131,111,112,100,75,42,41,635,83,718,11.559888579387186
1575,330045605010100,121,142,125,129,133,62,45,29,712,74,786,9.414758269720101
1576,330045605010101,45,60,59,55,51,36,35,17,306,52,358,14.525139664804469
1577,330045605010102,113,143,120,134,99,67,35,28,676,63,739,8.525033829499323
1578,330045605010103,129,152,110,120,101,71,31,18,683,49,732,6.693989071038251
1579,330045605010104,122,141,153,116,112,96,42,29,740,71,811,8.75462392108508
1580,330045605010105,112,127,126,93,101,73,37,33,632,70,702,9.971509971509972
1581,330045605010106,111,131,103,113,121,79,60,43,658,103,761,13.534822601839684
1582,330045605010107,61,101,77,95,93,71,26,34,498,60,558,10.75268817204301
1583,330045605010108,79,81,79,80,71,54,40,25,444,65,509,12.770137524557956
1584,330045605010109,93,101,103,94,92,65,40,22,548,62,610,10.163934426229508
1585,330045605010110,81,117,106,103,105,56,49,31,568,80,648,12.345679012345679
1586,330045605010111,101,151,123,123,111,105,58,32,714,90,804,11.194029850746269
1587,330045605010112,102,135,108,111,113,64,48,34,633,82,715,11.468531468531468
1588,330045605010113,98,140,117,118,102,68,53,29,643,82,725,11.310344827586206
1589,330045605010114,60,84,49,64,47,22,24,19,326,43,369,11.653116531165312
1590,330045605010115,120,128,112,130,83,70,30,33,643,63,706,8.923512747875353
1591,330045605010116,90,91,106,93,63,65,37,33,508,70,578,12.110726643598616
1592,330045605010117,121,141,123,115,102,88,42,31,690,73,763,9.567496723460026
1593,330045605010118,134,134,147,123,102,75,45,37,715,82,797,10.288582183186952
1594,330045605010119,128,145,118,118,100,72,48,35,681,83,764,10.863874345549739
1595,330045605010120,129,209,144,123,130,85,33,26,820,59,879,6.712172923777019
1596,330045605010121,125,128,122,115,101,56,43,25,647,68,715,9.51048951048951
1597,330045605010122,102,112,119,111,99,80,39,37,623,76,699,10.872675250357654
1598,330045605010123,105,133,112,113,109,81,40,51,653,91,744,12.231182795698924
1599,330045605010124,90,101,102,110,107,64,29,34,574,63,637,9.89010989010989
1600,330045605010125,62,64,88,76,56,56,29,30,402,59,461,12.79826464208243
1601,330045605010126,93,105,117,94,102,67,54,41,578,95,673,14.115898959881129
1602,330045605010127,45,67,57,46,50,49,19,26,314,45,359,12.534818941504179
1603,330045605010128,43,68,69,53,56,54,25,22,343,47,390,12.051282051282051
1604,330045605010129,71,94,111,96,61,71,31,23,504,54,558,9.67741935483871
1605,330045605010130,112,147,113,112,103,79,39,25,666,64,730,8.767123287671232
1606,330045605010131,97,114,109,97,113,73,46,40,603,86,689,12.481857764876633
1607,330045605010132,50,54,79,60,51,45,18,19,339,37,376,9.840425531914894
1608,330045605010133,80,108,86,114,69,78,36,24,535,60,595,10.084033613445378
1609,330045605010134,68,74,86,74,79,71,49,39,452,88,540,16.296296296296298
1610,330045605010135,73,120,91,106,84,68,42,26,542,68,610,11.147540983606557
1611,330045605010136,61,57,63,91,48,59,26,28,379,54,433,12.471131639722863
1612,330045605010137,55,61,74,65,63,58,25,25,376,50,426,11.737089201877934
1613,330045605010138,75,91,97,87,88,88,34,25,526,59,585,10.085470085470085
1614,330045605010139,68,78,68,81,60,36,21,15,391,36,427,8.430913348946136
1615,330045605010140,65,79,67,77,52,66,34,24,406,58,464,12.5
1616,330045605010141,52,69,76,55,65,55,47,32,372,79,451,17.516629711751662
1617,330045605010142,76,74,85,93,66,64,30,25,458,55,513,10.721247563352826
1618,330045605010143,59,80,85,68,85,80,34,35,457,69,526,13.11787072243346
1619,330045605010144,79,65,98,80,54,61,29,27,437,56,493,11.359026369168356
1620,330045605010145,67,86,79,72,66,28,34,17,398,51,449,11.35857461024499
1621,330045605010146,12,41,38,24,59,42,30,33,216,63,279,22.580645161290324
1622,330045605010147,37,42,59,35,50,50,22,28,273,50,323,15.479876160990711
1623,330045605010148,33,51,55,59,43,45,27,18,286,45,331,13.595166163141993
1624,330045605010149,75,103,123,103,94,76,45,27,574,72,646,11.145510835913313
1625,330045605010150,54,65,74,72,81,84,32,28,430,60,490,12.244897959183673
1626,330045605010151,95,114,99,114,93,105,62,44,620,106,726,14.600550964187327
1627,330045605010152,41,59,62,44,31,35,10,5,272,15,287,5.2264808362369335
1628,330045605010153,50,78,54,47,36,31,16,13,296,29,325,8.923076923076923
1629,330045605010154,102,126,103,94,113,80,41,36,618,77,695,11.079136690647482
1630,330045605010155,59,67,76,72,81,51,28,33,406,61,467,13.062098501070663
1631,330045605010156,53,63,64,78,76,58,40,33,392,73,465,15.698924731182796
1632,330045605010157,54,89,84,81,85,53,38,34,446,72,518,13.8996138996139
1633,330045605010158,65,79,84,86,76,82,39,36,472,75,547,13.711151736745887
1634,330045605010159,44,53,56,58,64,33,29,18,308,47,355,13.23943661971831
1635,330045605010160,104,139,115,139,114,94,62,26,705,88,793,11.097099621689786
1636,330045605010161,72,125,90,73,69,45,35,28,474,63,537,11.731843575418994
1637,330045605010162,75,113,79,94,70,37,34,18,468,52,520,10.0
1638,330045605010163,42,65,49,54,48,46,26,14,304,40,344,11.627906976744185
1639,330045605010164,160,186,132,145,119,62,27,46,804,73,877,8.323831242873432
1640,330045605010165,129,138,112,151,112,76,39,35,718,74,792,9.343434343434344
1641,330045605010166,125,143,109,98,62,55,21,11,592,32,624,5.128205128205129
1642,330045605010167,30,43,53,41,22,31,18,26,220,44,264,16.666666666666668
1643,330045605010168,109,152,143,140,139,64,47,26,747,73,820,8.902439024390244
1644,330045605010169,83,100,82,100,65,68,46,12,498,58,556,10.431654676258994
1645,330045605010170,90,110,90,125,88,67,47,26,570,73,643,11.35303265940902
1646,330045605010171,99,129,138,136,117,92,47,30,711,77,788,9.771573604060913
1647,330045605010172,79,107,94,93,80,65,45,16,518,61,579,10.535405872193436
1648,330045605010173,51,95,64,70,76,52,28,20,408,48,456,10.526315789473685
1649,330045605010174,53,76,54,58,58,41,25,21,340,46,386,11.917098445595855
1650,330045605010175,57,93,86,72,101,71,36,19,480,55,535,10.280373831775702
1651,330045605010176,79,101,91,94,83,50,52,29,498,81,579,13.989637305699482
1652,330045605010177,84,123,119,122,96,66,55,38,610,93,703,13.229018492176387
1653,330045605010178,67,77,104,84,75,53,60,31,460,91,551,16.515426497277677
1654,330045605010179,128,164,144,147,113,120,60,32,816,92,908,10.13215859030837
1655,330045605010180,122,129,144,113,110,98,53,24,716,77,793,9.709962168978562
1656,330045605010181,83,102,96,89,73,56,39,43,499,82,581,14.113597246127366
1657,330045605010182,83,98,99,97,87,70,38,26,534,64,598,10.702341137123746
1658,330045605010183,90,100,113,98,93,83,50,33,577,83,660,12.575757575757576
1659,330045605010184,128,153,148,162,145,98,48,20,834,68,902,7.5388026607538805
1660,330045605010185,4,10,14,8,11,9,2,4,56,6,62,9.67741935483871
1661,330045605010186,44,68,47,58,60,50,25,28,327,53,380,13.947368421052632
1662,330045605010187,127,149,126,116,103,75,32,16,696,48,744,6.451612903225806
1663,330045605010188,93,113,91,99,80,46,38,25,522,63,585,10.76923076923077
1664,330045605010189,286,300,279,257,198,164,78,53,1484,131,1615,8.111455108359133
1665,330045605010190,53,79,65,81,77,31,35,31,386,66,452,14.601769911504425
1666,330045605010191,78,104,83,126,84,47,15,7,522,22,544,4.044117647058823
1667,330045605020001,145,163,163,142,105,97,43,34,815,77,892,8.632286995515695
1668,330045605020002,170,210,219,197,140,124,65,57,1060,122,1182,10.321489001692047
1669,330045605020003,70,94,99,75,69,53,28,25,460,53,513,10.331384015594542
1670,330045605020004,61,74,73,77,55,34,29,10,374,39,413,9.443099273607748
1671,330045605020005,125,168,157,134,108,92,44,35,784,79,863,9.154113557358054
1672,330045605020006,63,71,73,74,35,42,31,17,358,48,406,11.822660098522167
1673,330045605020007,62,70,74,61,52,48,23,18,367,41,408,10.049019607843137
1674,330045605020008,120,144,149,109,94,87,31,20,703,51,754,6.76392572944297
1675,330045605020009,48,83,83,65,47,31,27,8,357,35,392,8.928571428571429
1676,330045605020010,79,81,65,68,41,41,20,12,375,32,407,7.862407862407863
1677,330045605020011,81,106,113,83,60,52,26,19,495,45,540,8.333333333333334
1678,330045605020012,110,165,116,131,79,70,54,23,671,77,748,10.294117647058824
1679,330045605020013,168,206,172,145,113,123,53,38,927,91,1018,8.93909626719057
1680,330045605020014,250,295,208,201,177,115,46,29,1246,75,1321,5.677517032551098
1681,330045605020015,126,152,122,97,79,48,23,13,624,36,660,5.454545454545454
1682,330045605020016,158,186,139,124,104,76,29,14,787,43,830,5.180722891566265
1683,330045605020017,188,241,205,184,137,99,62,37,1054,99,1153,8.586296617519514
1684,330045605020018,141,197,149,175,153,72,73,26,887,99,986,10.040567951318458
1685,330045605020019,128,139,112,97,91,63,39,22,630,61,691,8.827785817655572
1686,330045605020020,103,120,89,121,87,74,34,20,594,54,648,8.333333333333334
1687,330045605020021,128,172,115,108,103,52,39,23,678,62,740,8.378378378378379
1688,330045605020022,117,148,103,88,94,66,33,23,616,56,672,8.333333333333334
1689,330045605020023,129,122,113,82,84,57,26,26,587,52,639,8.137715179968701
1690,330045605020024,142,168,122,120,97,82,35,28,731,63,794,7.934508816120907
1691,330045605020025,114,158,95,92,105,84,39,19,648,58,706,8.215297450424929
1692,330045605020026,190,193,157,213,143,98,46,19,994,65,1059,6.137865911237016
1693,330045605020027,254,327,225,257,187,115,55,47,1365,102,1467,6.952965235173824
1694,330045605020028,113,196,114,123,134,68,38,23,748,61,809,7.5401730531520395
1695,330045605020029,234,236,213,208,139,114,62,19,1144,81,1225,6.612244897959184
1696,330045605020030,61,90,75,65,90,50,26,17,431,43,474,9.071729957805907
1697,330045605020031,86,123,112,123,86,64,25,32,594,57,651,8.755760368663594
1698,330045605020032,63,96,101,84,90,54,41,28,488,69,557,12.387791741472173
1699,330045605020033,138,180,152,168,126,69,44,38,833,82,915,8.96174863387978
1700,330045605020034,88,116,82,90,93,45,20,26,514,46,560,8.214285714285714
1701,330045605020035,84,109,112,79,103,55,35,18,542,53,595,8.907563025210084
1702,330045605020036,64,80,62,78,69,44,38,40,397,78,475,16.42105263157895
1703,330045605020037,78,87,93,85,61,48,26,29,452,55,507,10.848126232741617
1704,330045605020038,138,175,127,126,103,73,38,8,742,46,788,5.83756345177665
1705,330045605020039,124,164,129,107,108,72,40,25,704,65,769,8.45253576072822
1706,330045605020040,38,40,53,38,30,20,11,10,219,21,240,8.75
1707,330045605020041,79,116,85,81,82,49,25,16,492,41,533,7.6923076923076925
1708,330045605020042,59,70,63,61,45,29,26,3,327,29,356,8.146067415730338
1709,330045605020043,85,126,124,102,92,66,27,45,595,72,667,10.794602698650674
1710,330045605020044,110,120,107,114,84,49,40,22,584,62,646,9.597523219814242
1711,330045605020045,79,114,85,66,69,39,24,21,452,45,497,9.054325955734406
1712,330045605020047,49,68,59,54,39,44,30,15,313,45,358,12.569832402234637
1713,330045605020048,85,104,106,91,78,58,35,11,522,46,568,8.098591549295774
1714,330045605020049,120,167,113,111,102,68,44,33,681,77,758,10.158311345646437
1715,330045605020050,258,274,230,219,157,124,47,43,1262,90,1352,6.65680473372781
1716,330045605020051,52,80,76,67,40,33,20,16,348,36,384,9.375
1717,330045605020052,178,190,183,178,115,72,53,25,916,78,994,7.847082494969819
1718,330045605020053,88,87,63,68,39,31,17,5,376,22,398,5.527638190954774
1719,330045605020054,131,153,129,119,94,60,27,18,686,45,731,6.155950752393981
1720,330045605020055,86,153,121,100,99,71,32,26,630,58,688,8.430232558139535
1721,330045605020056,49,78,67,57,58,41,25,30,350,55,405,13.580246913580247
1722,330045605020057,86,108,97,117,77,56,34,23,541,57,598,9.531772575250836
1723,330045605020058,83,102,97,108,68,65,46,24,523,70,593,11.804384485666105
1724,330045605020059,141,141,124,177,96,80,50,22,759,72,831,8.664259927797834
1725,330045605020060,228,253,212,181,158,104,42,28,1136,70,1206,5.804311774461028
1726,330045605020061,224,263,195,199,153,109,63,34,1143,97,1240,7.82258064516129
1727,330045605020062,151,177,142,116,95,69,34,12,750,46,796,5.778894472361809
1728,330045605020063,157,185,127,131,84,56,22,18,740,40,780,5.128205128205129
1729,330045605020064,157,166,162,155,99,87,42,37,826,79,905,8.7292817679558
1730,330045605020065,78,93,90,81,56,55,33,25,453,58,511,11.350293542074365
1731,330045605020066,88,125,102,101,80,71,38,34,567,72,639,11.267605633802816
1732,330045605020067,167,164,171,131,108,58,37,24,799,61,860,7.093023255813954
1733,330045605020068,101,142,97,99,79,43,28,15,561,43,604,7.119205298013245
1734,330045605020069,140,186,122,161,113,81,54,24,803,78,881,8.853575482406356
1735,330045605020070,79,76,81,75,43,41,14,8,395,22,417,5.275779376498801
1736,330045605020071,75,95,83,84,60,48,32,17,445,49,494,9.919028340080972
1737,330045605020072,108,127,132,126,119,65,53,33,677,86,763,11.271297509829619
1738,330045605020073,168,189,178,165,131,96,63,31,927,94,1021,9.20666013712047
1739,330045605020074,186,209,176,141,141,82,44,28,935,72,1007,7.149950347567031
1740,330045605020075,114,145,142,91,113,77,30,27,682,57,739,7.713125845737483
1741,330045605020076,128,158,102,98,86,71,23,23,643,46,689,6.6763425253991295
1742,330045605020077,120,129,119,92,83,74,27,18,617,45,662,6.7975830815709966
1743,330045605020078,106,83,104,76,64,49,35,16,482,51,533,9.568480300187618
1744,330045605020079,99,143,118,96,90,72,36,15,618,51,669,7.623318385650224
1745,330045605020080,123,139,117,116,125,63,35,26,683,61,744,8.198924731182796
1746,330045605020081,130,150,115,108,79,49,33,8,631,41,672,6.101190476190476
1747,330045605020082,81,96,95,68,62,50,32,5,452,37,489,7.566462167689162
1748,330045605020083,87,109,97,111,85,62,26,26,551,52,603,8.623548922056385
1749,330045605020084,120,157,115,100,104,51,37,16,647,53,700,7.571428571428571
1750,330045605020085,140,152,102,123,91,61,28,26,669,54,723,7.468879668049793
1751,330045605020086,119,130,149,133,103,61,34,33,695,67,762,8.79265091863517
1752,330045605020087,103,94,112,90,81,52,32,18,532,50,582,8.59106529209622
1753,330045605020088,194,195,205,178,118,114,56,31,1004,87,1091,7.974335472043997
1754,330045605020089,97,145,100,93,92,70,24,20,597,44,641,6.86427457098284
1755,330045605020090,205,211,162,162,129,95,53,31,964,84,1048,8.01526717557252
1756,330045605020091,279,384,204,265,231,144,67,34,1507,101,1608,6.281094527363184
1757,330045605020092,53,77,76,83,51,40,9,14,380,23,403,5.707196029776675
1758,330045605020093,93,109,63,84,64,46,19,11,459,30,489,6.134969325153374
1759,330045605020094,65,88,67,85,79,64,21,27,448,48,496,9.67741935483871
1760,330045605020095,38,69,56,43,59,47,19,17,312,36,348,10.344827586206897
1761,330045605020096,52,94,203,121,107,89,17,9,666,26,692,3.7572254335260116
1762,330045605020097,88,103,135,109,101,46,15,4,582,19,601,3.1613976705490847
1763,330045605020098,153,228,197,235,179,102,61,32,1094,93,1187,7.8348778433024435
1764,330045605020099,165,192,131,114,101,65,53,29,768,82,850,9.647058823529411
1765,330045605020100,116,154,111,112,91,68,36,20,652,56,708,7.909604519774011
1766,330045605020101,113,160,119,98,96,79,30,16,665,46,711,6.469760900140647
1767,330045605020102,240,359,260,209,184,134,51,43,1386,94,1480,6.351351351351352
1768,330045605020103,133,180,127,122,118,78,35,23,758,58,816,7.107843137254902
1769,330045605020104,147,190,130,132,112,87,33,35,798,68,866,7.852193995381063
1770,330045605020105,76,111,96,100,105,50,50,32,538,82,620,13.225806451612904
1771,330045605020106,95,132,98,101,98,50,41,31,574,72,646,11.145510835913313
1772,330045605020107,211,242,228,212,171,130,68,49,1194,117,1311,8.924485125858123
1773,330045605020108,10,17,14,15,12,11,4,5,79,9,88,10.227272727272727
1774,330045605020109,133,130,108,105,73,44,38,11,593,49,642,7.632398753894081
1775,330045605020110,132,149,97,107,85,59,25,7,629,32,661,4.841149773071105
1776,330045605020111,79,81,64,61,39,38,14,11,362,25,387,6.459948320413437
1777,330045605020112,91,120,94,79,62,64,20,7,510,27,537,5.027932960893855
1778,330045605020113,79,82,94,48,60,39,14,11,402,25,427,5.85480093676815
1779,330045605020114,230,233,198,173,146,106,62,30,1086,92,1178,7.809847198641766
1780,330045605020115,119,138,98,71,86,54,40,26,566,66,632,10.443037974683545
1781,330045605020116,87,106,91,99,76,62,37,12,521,49,570,8.596491228070175
1782,330045605020117,121,150,112,118,88,69,27,25,658,52,710,7.323943661971831
1783,330045605020118,52,58,52,46,40,34,12,15,282,27,309,8.737864077669903
1784,330045605020119,112,124,105,89,68,57,16,17,555,33,588,5.612244897959184
1785,330045605020120,106,125,94,124,86,61,31,21,596,52,648,8.024691358024691
1786,330045605020121,81,131,88,94,81,51,43,29,526,72,598,12.040133779264215
1787,330045605020122,92,124,107,77,83,69,24,19,552,43,595,7.226890756302521
1788,330045605020123,64,80,78,72,56,45,28,13,395,41,436,9.403669724770642
1789,330045605020124,57,78,56,54,57,44,22,8,346,30,376,7.9787234042553195
1790,330045605020125,127,103,83,77,52,33,20,4,475,24,499,4.809619238476954
1791,330045605020126,98,189,407,189,249,137,41,17,1269,58,1327,4.370761115297664
1792,330045605020127,176,258,165,190,143,118,55,29,1050,84,1134,7.407407407407407
1793,330045605020128,71,96,136,127,74,30,25,23,534,48,582,8.24742268041237
1794,330045605020129,119,117,103,84,61,35,26,14,519,40,559,7.155635062611807
1795,330045605020130,42,52,37,36,33,13,6,3,213,9,222,4.054054054054054
1796,330045605020131,90,112,96,71,87,37,25,16,493,41,534,7.677902621722846
1797,330045605020132,170,212,196,150,127,86,42,29,941,71,1012,7.015810276679842
1798,330045605020133,77,88,77,46,58,43,25,16,389,41,430,9.534883720930232
1799,330045605020134,117,129,100,139,87,82,32,17,654,49,703,6.970128022759602
1800,330045605020135,39,23,23,15,14,8,4,3,122,7,129,5.426356589147287
1801,330045605030001,62,93,62,82,69,56,16,13,424,29,453,6.401766004415011
1802,330045605030002,63,79,73,73,65,57,27,9,410,36,446,8.071748878923767
1803,330045605030003,58,70,74,77,61,58,31,15,398,46,444,10.36036036036036
1804,330045605030004,65,212,70,86,77,51,36,22,561,58,619,9.369951534733442
1805,330045605030005,68,102,72,100,54,48,47,20,444,67,511,13.111545988258317
1806,330045605030006,62,84,69,58,54,39,19,14,366,33,399,8.270676691729323
1807,330045605030007,31,32,30,29,38,18,10,17,178,27,205,13.170731707317072
1808,330045605030008,105,131,122,105,87,73,32,26,623,58,681,8.516886930983848
1809,330045605030009,106,121,148,119,113,97,39,34,704,73,777,9.395109395109396
1810,330045605030010,49,73,61,50,62,42,25,16,337,41,378,10.846560846560847
1811,330045605030011,121,139,126,128,112,65,40,36,691,76,767,9.908735332464145
1812,330045605030012,218,259,235,190,187,114,63,48,1203,111,1314,8.447488584474886
1813,330045605030013,101,268,275,127,185,50,13,9,1006,22,1028,2.140077821011673
1814,330045605030014,84,111,96,92,105,55,46,29,543,75,618,12.135922330097088
1815,330045605030015,54,80,66,70,65,49,23,14,384,37,421,8.788598574821853
1816,330045605030016,106,98,101,87,79,47,34,18,518,52,570,9.12280701754386
1817,330045605030017,104,126,93,106,98,57,41,34,584,75,659,11.380880121396055
1818,330045605030018,112,140,117,132,110,102,60,39,713,99,812,12.192118226600986
1819,330045605030019,74,65,94,70,59,48,26,18,410,44,454,9.691629955947137
1820,330045605030020,39,73,53,58,63,43,27,18,329,45,374,12.032085561497325
1821,330045605030021,62,89,71,75,69,39,32,21,405,53,458,11.572052401746724
1822,330045605030022,92,145,107,108,102,72,44,20,626,64,690,9.27536231884058
1823,330045605030023,117,174,135,118,100,64,33,20,708,53,761,6.964520367936925
1824,330045605030024,57,100,67,78,57,45,32,18,404,50,454,11.013215859030836
1825,330045605030025,93,122,102,121,109,63,47,18,610,65,675,9.62962962962963
1826,330045605030026,73,105,68,90,77,52,36,29,465,65,530,12.264150943396226
1827,330045605030027,60,119,91,101,81,61,34,19,513,53,566,9.363957597173146
1828,330045605030028,53,92,81,93,49,43,38,17,411,55,466,11.802575107296137
1829,330045605030029,54,60,69,59,36,38,22,17,316,39,355,10.985915492957746
1830,330045605030030,84,127,96,111,147,94,51,27,659,78,737,10.583446404341927
1831,330045605030031,72,107,84,112,103,61,43,35,539,78,617,12.641815235008103
1832,330045605030032,108,260,217,142,159,84,18,26,970,44,1014,4.339250493096647
1833,330045605030033,171,136,135,128,97,72,44,22,739,66,805,8.198757763975156
1834,330045605030034,91,119,102,124,73,71,67,22,580,89,669,13.303437967115098
1835,330045605030035,88,102,75,74,68,36,37,14,443,51,494,10.323886639676113
1836,330045605030036,238,256,167,234,172,98,54,32,1165,86,1251,6.874500399680255
1837,330045605030037,78,98,102,81,77,55,33,27,491,60,551,10.88929219600726
1838,330045605030038,153,177,168,156,129,82,61,35,865,96,961,9.989594172736732
1839,330045605030039,104,129,109,109,99,51,48,32,601,80,681,11.747430249632894
1840,330045605030040,46,73,60,48,69,43,24,19,339,43,382,11.256544502617801
1841,330045605030041,112,118,87,113,90,45,53,26,565,79,644,12.267080745341614
1842,330045605030042,39,56,60,58,62,50,47,30,325,77,402,19.154228855721392
1843,330045605030043,69,129,174,123,111,91,55,34,697,89,786,11.323155216284988
1844,330045605030044,66,96,83,75,88,88,40,37,496,77,573,13.43804537521815
1845,330045605030045,63,65,77,71,52,55,39,27,383,66,449,14.699331848552339
1846,330045605030046,125,154,145,121,113,85,42,30,743,72,815,8.83435582822086
1847,330045605030047,111,121,128,123,90,83,54,25,656,79,735,10.748299319727892
1848,330045605030048,48,68,71,67,57,56,37,17,367,54,421,12.826603325415677
1849,330045605030049,121,130,154,134,102,79,56,20,720,76,796,9.547738693467336
1850,330045605030050,123,177,160,168,153,92,86,51,873,137,1010,13.564356435643564
1851,330045605030051,11,91,81,76,84,52,19,21,395,40,435,9.195402298850574
1852,330045605030052,85,113,90,82,72,54,24,26,496,50,546,9.157509157509157
1853,330045605030053,102,110,140,120,97,76,37,32,645,69,714,9.663865546218487
1854,330045605030054,118,119,119,111,104,67,37,25,638,62,700,8.857142857142858
1855,330045605030055,51,64,76,53,69,75,31,18,388,49,437,11.212814645308924
1856,330045605030056,62,94,85,77,76,80,35,24,474,59,533,11.069418386491558
1857,330045605030057,150,205,172,147,121,98,37,26,893,63,956,6.589958158995816
1858,330045605030058,79,93,84,70,80,75,36,23,481,59,540,10.925925925925926
1859,330045605030059,44,66,78,79,74,63,34,30,404,64,468,13.675213675213675
1860,330045605030060,53,74,57,49,57,53,16,17,343,33,376,8.77659574468085
1861,330045605030061,143,158,143,163,103,74,12,40,784,52,836,6.220095693779904
1862,330045605030062,112,161,124,137,96,58,41,20,688,61,749,8.144192256341789
1863,330045605030063,152,122,128,120,86,65,27,15,673,42,715,5.874125874125874
1864,330045605030064,70,92,84,81,58,53,27,17,438,44,482,9.12863070539419
1865,330045605030065,59,97,99,81,82,71,31,23,489,54,543,9.94475138121547
1866,330045605030066,141,182,158,146,117,90,58,23,834,81,915,8.852459016393443
1867,330045605030067,99,110,95,97,100,72,38,21,573,59,632,9.335443037974683
1868,330045605030068,88,131,104,84,73,58,36,20,538,56,594,9.427609427609427
1869,330045605030069,109,131,125,86,109,78,42,20,638,62,700,8.857142857142858
1870,330045605030070,156,208,168,176,112,94,69,37,914,106,1020,10.392156862745098
1871,330045605030071,74,92,87,74,57,49,28,26,433,54,487,11.08829568788501
1872,330045605030072,106,112,97,118,83,68,52,30,584,82,666,12.312312312312311
1873,330045605030073,70,112,93,94,85,66,29,27,520,56,576,9.722222222222221
1874,330045605030074,101,88,108,73,90,62,30,17,522,47,569,8.260105448154658
1875,330045605030075,95,136,72,157,121,45,65,20,626,85,711,11.954992967651195
1876,330045605030076,112,233,180,207,158,84,59,53,974,112,1086,10.313075506445673
1877,330045605030077,89,113,118,95,80,63,46,32,558,78,636,12.264150943396226
1878,330045605030078,123,222,198,157,158,135,84,28,993,112,1105,10.135746606334841
1879,330045605030079,132,149,113,99,82,62,35,15,637,50,687,7.27802037845706
1880,330045605030080,72,92,63,100,63,46,62,30,436,92,528,17.424242424242426
1881,330045605030081,153,178,179,239,161,70,41,16,980,57,1037,5.496624879459981
1882,330045605030082,121,160,165,198,147,101,59,49,892,108,1000,10.8
1883,330045605030083,77,108,70,78,65,34,19,16,432,35,467,7.494646680942184
1884,330045605030084,94,118,102,92,76,72,25,22,554,47,601,7.820299500831947
1885,330045605030085,110,141,111,92,89,61,37,22,604,59,663,8.89894419306184
1886,330045605030086,103,172,127,129,107,72,39,25,710,64,774,8.268733850129198
1887,330045605030087,128,154,117,140,121,68,41,28,728,69,797,8.657465495608532
1888,330045605030088,70,91,86,52,51,57,41,11,407,52,459,11.328976034858387
1889,330045605030089,51,73,69,64,43,58,16,26,358,42,400,10.5
1890,330045605030090,114,133,99,116,86,55,40,23,603,63,666,9.45945945945946
1891,330045605030091,101,152,125,120,85,73,40,19,656,59,715,8.251748251748252
1892,330045605030092,104,131,111,124,84,65,45,16,619,61,680,8.970588235294118
1893,330045605030093,89,134,100,112,117,51,35,43,603,78,681,11.45374449339207
1894,330045605030094,156,200,144,154,120,72,34,22,846,56,902,6.208425720620842
1895,330045605030095,71,135,118,109,161,73,72,38,667,110,777,14.157014157014157
1896,330045605030096,145,154,114,143,100,89,53,38,745,91,836,10.885167464114833
1897,330045605030097,107,145,111,99,101,70,33,19,633,52,685,7.591240875912408
1898,330045605030098,178,216,188,185,131,112,45,31,1010,76,1086,6.998158379373849
1899,330045605030099,191,224,166,112,123,93,32,27,909,59,968,6.095041322314049
1900,330045605030100,149,198,143,151,135,87,35,33,863,68,931,7.303974221267454
1901,330045605030101,100,208,112,190,177,184,75,16,971,91,1062,8.568738229755178
1902,330045605030102,122,131,111,120,78,72,31,24,634,55,689,7.982583454281568
1903,330045605030103,99,123,119,115,70,65,34,15,591,49,640,7.65625
1904,330045605030104,131,154,114,116,75,70,39,13,660,52,712,7.303370786516854
1905,330045605030105,114,94,110,105,78,60,31,14,561,45,606,7.425742574257426
1906,330045605030106,128,180,147,132,84,75,35,13,746,48,794,6.045340050377834
1907,330045605030107,128,172,121,118,106,69,40,26,714,66,780,8.461538461538462
1908,330045605030108,95,121,112,94,89,51,30,13,562,43,605,7.107438016528926
1909,330045605030109,133,159,111,128,80,65,34,19,676,53,729,7.270233196159122
1910,330045605030110,98,162,125,131,133,91,49,26,740,75,815,9.202453987730062
1911,330045605030111,79,118,108,82,86,88,36,27,561,63,624,10.096153846153847
1912,330045605030112,165,213,169,205,141,90,53,52,983,105,1088,9.650735294117647
1913,330045605030113,78,102,75,86,77,68,41,36,486,77,563,13.676731793960924
1914,330045605030114,54,77,66,57,80,62,23,22,396,45,441,10.204081632653061
1915,330045605030115,128,154,132,122,80,59,39,24,675,63,738,8.536585365853659
1916,330045605030116,58,59,50,53,63,42,23,23,325,46,371,12.398921832884097
1917,330045605030117,44,70,39,53,54,24,14,13,284,27,311,8.681672025723472
1918,330045605030118,72,97,76,92,69,56,40,16,462,56,518,10.81081081081081
1919,330045605030119,63,71,74,74,49,47,23,21,378,44,422,10.42654028436019
1920,330045605030120,170,181,154,163,148,85,53,20,901,73,974,7.494866529774128
1921,330045605030121,76,90,74,54,55,42,23,11,391,34,425,8.0
1922,330045605030122,102,126,72,92,61,59,16,19,512,35,547,6.39853747714808
1923,330045605030123,108,130,101,78,67,58,21,9,542,30,572,5.244755244755245
1924,330045605030124,224,235,187,190,151,123,44,18,1110,62,1172,5.290102389078498
1925,330045605030125,142,154,152,104,115,66,34,20,733,54,787,6.861499364675985
1926,330045605030126,93,80,70,80,52,31,16,10,406,26,432,6.018518518518518
1927,330045605030127,46,72,66,65,64,44,24,14,357,38,395,9.620253164556962
1928,330045605030128,85,111,82,51,63,55,16,8,447,24,471,5.095541401273885
1929,330045605030129,19,34,32,30,45,25,25,24,185,49,234,20.94017094017094
1930,330045605030130,110,125,113,139,76,33,24,13,596,37,633,5.845181674565561
1931,330045605030131,84,112,78,82,76,49,34,11,481,45,526,8.55513307984791
1932,330045605030132,85,79,89,66,54,37,37,15,410,52,462,11.255411255411255
1933,330045605030133,89,148,171,139,131,91,40,46,769,86,855,10.058479532163743
1934,330045605030134,65,68,48,46,49,23,21,11,299,32,331,9.667673716012084
1935,330045605030135,79,128,84,92,79,51,37,14,513,51,564,9.042553191489361
1936,330045605030136,98,119,93,104,65,48,45,15,527,60,587,10.221465076660989
1937,330045605030137,156,145,150,277,163,73,45,11,964,56,1020,5.490196078431373
1938,330045605030138,79,109,84,73,73,58,27,24,476,51,527,9.67741935483871
1939,330045605030139,59,89,56,94,75,46,30,13,419,43,462,9.307359307359308
1940,330045605030140,98,100,83,86,57,36,22,15,460,37,497,7.44466800804829
1941,330045605030141,61,55,30,32,24,10,14,3,212,17,229,7.423580786026201
1942,330045605040001,81,123,109,88,93,86,48,25,580,73,653,11.179173047473201
1943,330045605040002,70,109,86,88,95,60,34,27,508,61,569,10.720562390158172
1944,330045605040003,113,195,137,154,154,95,42,37,848,79,927,8.522114347357066
1945,330045605040004,60,79,66,55,57,48,15,24,365,39,404,9.653465346534654
1946,330045605040005,114,119,99,85,65,59,25,15,541,40,581,6.884681583476764
1947,330045605040006,130,156,151,165,90,79,66,37,771,103,874,11.784897025171624
1948,330045605040007,89,104,73,94,73,41,30,19,474,49,523,9.369024856596559
1949,330045605040008,92,103,108,97,62,53,34,17,515,51,566,9.010600706713781
1950,330045605040009,131,147,116,111,108,50,58,32,663,90,753,11.952191235059761
1951,330045605040010,123,193,105,153,126,72,59,28,772,87,859,10.128055878928988
1952,330045605040011,207,210,194,181,146,96,45,46,1034,91,1125,8.088888888888889
1953,330045605040012,200,279,178,175,136,67,45,28,1035,73,1108,6.588447653429603
1954,330045605040013,63,77,50,44,33,30,17,10,297,27,324,8.333333333333334
1955,330045605040014,56,84,59,72,56,40,22,26,367,48,415,11.566265060240964
1956,330045605040015,91,130,88,86,80,55,26,20,530,46,576,7.986111111111111
1957,330045605040016,180,203,209,277,127,104,55,21,1100,76,1176,6.462585034013605
1958,330045605040017,56,82,70,62,64,53,25,19,387,44,431,10.208816705336426
1959,330045605040018,42,89,122,128,54,83,30,13,518,43,561,7.664884135472371
1960,330045605040019,60,68,61,44,54,32,12,13,319,25,344,7.267441860465116
1961,330045605040020,144,200,165,112,111,69,36,15,801,51,852,5.985915492957746
1962,330045605040021,69,90,60,47,41,34,16,11,341,27,368,7.336956521739131
1963,330045605040022,45,74,56,65,60,58,25,25,358,50,408,12.254901960784315
1964,330045605040023,126,159,125,106,109,81,46,21,706,67,773,8.667529107373868
1965,330045605040024,112,123,108,107,85,79,53,25,614,78,692,11.271676300578035
1966,330045605040025,102,148,121,121,114,91,56,33,697,89,786,11.323155216284988
1967,330045605040026,195,209,164,136,130,85,39,35,919,74,993,7.452165156092649
1968,330045605040027,88,102,87,72,67,54,20,5,470,25,495,5.05050505050505
1969,330045605040028,203,208,264,170,138,90,36,35,1073,71,1144,6.206293706293707
1970,330045605040029,84,129,97,104,84,57,33,18,555,51,606,8.415841584158416
1971,330045605040030,85,130,118,109,85,89,42,23,616,65,681,9.544787077826726
1972,330045605040031,100,119,117,122,103,83,43,21,644,64,708,9.03954802259887
1973,330045605040032,65,101,72,84,77,55,29,28,454,57,511,11.154598825831702
1974,330045605040033,117,127,134,95,100,77,35,29,650,64,714,8.96358543417367
1975,330045605040034,119,150,186,124,100,81,39,37,760,76,836,9.090909090909092
1976,330045605040035,61,70,74,69,73,61,29,29,408,58,466,12.446351931330472
1977,330045605040036,60,101,88,89,76,81,73,53,495,126,621,20.28985507246377
1978,330045605040037,37,57,49,46,43,34,21,14,266,35,301,11.627906976744185
1979,330045605040038,108,152,156,140,118,100,66,28,774,94,868,10.829493087557603
1980,330045605040039,93,143,114,140,144,86,47,56,720,103,823,12.515188335358445
1981,330045605040040,158,182,137,161,144,95,56,31,877,87,964,9.024896265560166
1982,330045605040041,126,168,132,125,127,102,63,46,780,109,889,12.260967379077615
1983,330045605040042,139,155,154,122,127,72,25,32,769,57,826,6.900726392251816
1984,330045605040043,77,70,75,73,57,49,22,13,401,35,436,8.027522935779816
1985,330045605040044,64,66,89,66,62,62,26,22,409,48,457,10.50328227571116
1986,330045605040045,81,137,122,104,82,74,37,28,600,65,665,9.774436090225564
1987,330045605040046,59,100,57,75,60,42,25,26,393,51,444,11.486486486486486
1988,330045605040047,80,124,109,89,91,84,37,30,577,67,644,10.403726708074535
1989,330045605040048,109,134,103,120,106,55,29,28,627,57,684,8.333333333333334
1990,330045605040049,187,188,168,225,161,122,67,49,1051,116,1167,9.940017137960583
1991,330045605040050,208,256,244,213,152,91,54,32,1164,86,1250,6.88
1992,330045605040051,65,135,84,108,109,58,31,16,559,47,606,7.755775577557756
1993,330045605040052,118,142,137,116,128,58,62,18,699,80,779,10.269576379974326
1994,330045605040053,108,138,139,105,102,67,30,24,659,54,713,7.5736325385694245
1995,330045605040054,155,192,152,148,114,101,35,27,862,62,924,6.70995670995671
1996,330045605040055,48,67,68,69,54,51,26,21,357,47,404,11.633663366336634
1997,330045605040056,270,289,215,277,178,138,59,47,1367,106,1473,7.196198234894773
1998,330045605040057,142,186,155,136,93,82,41,30,794,71,865,8.208092485549132
1999,330045605040058,79,104,97,74,77,40,26,34,471,60,531,11.299435028248588
2000,330045605040059,107,130,99,99,103,57,33,19,595,52,647,8.0370942812983
2001,330045605040060,72,101,79,79,73,57,24,26,461,50,511,9.784735812133073
2002,330045605040061,116,128,87,98,71,58,28,20,558,48,606,7.920792079207921
2003,330045605040062,94,111,122,76,84,57,42,17,544,59,603,9.78441127694859
2004,330045605040063,42,61,60,44,63,37,12,25,307,37,344,10.755813953488373
2005,330045605040064,76,109,96,91,87,55,33,35,514,68,582,11.683848797250858
2006,330045605040065,94,116,130,98,108,86,48,30,632,78,710,10.985915492957746
2007,330045605040066,124,132,116,133,85,65,49,29,655,78,733,10.641200545702592
2008,330045605040067,139,153,161,141,113,93,58,25,800,83,883,9.39977349943375
2009,330045605040068,66,80,86,75,67,57,27,26,431,53,484,10.950413223140496
2010,330045605040069,110,148,92,101,114,63,32,27,628,59,687,8.58806404657933
2011,330045605040070,95,107,105,86,70,41,29,20,504,49,553,8.860759493670885
2012,330045605040071,86,113,105,92,94,57,24,16,547,40,587,6.814310051107325
2013,330045605040072,57,79,88,77,77,42,31,21,420,52,472,11.016949152542374
2014,330045605040073,81,124,119,98,82,68,33,24,572,57,629,9.062003179650238
2015,330045605040074,96,76,90,99,63,47,19,23,471,42,513,8.187134502923977
2016,330045605040075,120,92,119,97,86,64,59,16,578,75,653,11.485451761102603
2017,330045605040076,59,83,101,88,58,56,30,19,445,49,494,9.919028340080972
2018,330045605040077,58,74,71,66,61,52,20,12,382,32,414,7.729468599033816
2019,330045605040078,596,1090,496,274,609,207,52,60,3272,112,3384,3.309692671394799
2020,330045605040079,131,168,116,132,118,63,50,27,728,77,805,9.565217391304348
2021,330045605040080,87,115,110,86,96,66,31,36,560,67,627,10.685805422647528
2022,330045605040081,67,90,79,87,62,68,33,21,453,54,507,10.650887573964496
2023,330045605040082,56,49,63,62,55,37,25,23,322,48,370,12.972972972972974
2024,330045605040083,44,62,70,44,50,40,17,17,310,34,344,9.883720930232558
2025,330045605040084,45,45,61,62,47,27,18,24,287,42,329,12.76595744680851
2026,330045605040085,80,104,82,88,72,43,34,21,469,55,524,10.49618320610687
2027,330045605040086,51,46,51,69,32,23,30,8,272,38,310,12.258064516129032
2028,330045605040087,70,106,85,77,79,48,30,20,465,50,515,9.70873786407767
2029,330045605040088,52,63,71,66,60,47,17,20,359,37,396,9.343434343434344
2030,330045605040089,55,116,100,94,72,63,64,22,500,86,586,14.675767918088738
2031,330045605040090,70,103,92,87,88,73,35,16,513,51,564,9.042553191489361
2032,330045605040091,42,57,59,59,50,38,22,18,305,40,345,11.594202898550725
2033,330045605040092,31,30,37,47,40,40,21,21,225,42,267,15.730337078651685
2034,330045605040093,98,115,105,115,82,53,28,17,568,45,613,7.3409461663947795
2035,330045605040094,93,95,74,69,74,53,23,16,458,39,497,7.847082494969819
2036,330045605040095,195,257,214,217,180,104,57,53,1167,110,1277,8.613938919342209
2037,330045605040096,117,93,85,84,58,34,23,13,471,36,507,7.100591715976331
2038,330045605040097,51,76,53,60,56,41,18,15,337,33,370,8.91891891891892
2039,330045605040098,145,163,130,145,126,62,47,26,771,73,844,8.649289099526067
2040,330045605040099,78,121,79,84,79,44,30,15,485,45,530,8.49056603773585
2041,330045605040100,58,76,64,67,56,39,21,15,360,36,396,9.090909090909092
2042,330045605040101,99,125,117,107,82,75,44,23,605,67,672,9.970238095238095
2043,330045605040102,112,126,85,103,68,43,26,6,537,32,569,5.62390158172232
2044,330045605040103,114,125,75,106,72,46,31,16,538,47,585,8.034188034188034
2045,330045605040104,82,74,72,59,48,39,16,11,374,27,401,6.733167082294265
2046,330045605040105,266,256,202,196,171,97,62,21,1188,83,1271,6.5302911093627065
2047,330045605040106,48,83,68,68,58,45,33,22,370,55,425,12.941176470588236
2048,330045605040107,74,120,94,87,101,59,32,17,535,49,584,8.39041095890411
2049,330045605040108,65,74,91,60,77,45,30,24,412,54,466,11.587982832618026
2050,330045605040109,132,143,129,120,98,60,15,9,682,24,706,3.3994334277620397
2051,330045605040110,122,134,137,98,73,65,20,10,629,30,659,4.552352048558422
2052,330045605050001,62,103,93,89,94,77,28,29,518,57,575,9.91304347826087
2053,330045605050002,113,119,139,100,123,97,36,41,691,77,768,10.026041666666666
2054,330045605050003,111,144,112,113,110,76,38,35,666,73,739,9.878213802435724
2055,330045605050004,159,191,170,145,138,87,60,32,890,92,982,9.368635437881874
2056,330045605050005,95,132,110,103,78,58,18,25,576,43,619,6.946688206785137
2057,330045605050006,106,194,158,161,126,87,66,25,832,91,923,9.859154929577464
2058,330045605050007,59,109,78,81,82,50,35,17,459,52,511,10.176125244618396
2059,330045605050008,118,138,113,127,104,64,46,45,664,91,755,12.052980132450331
2060,330045605050009,106,142,142,149,119,112,59,41,770,100,870,11.494252873563218
2061,330045605050010,113,155,159,111,109,110,71,30,757,101,858,11.771561771561771
2062,330045605050011,48,46,49,71,50,27,31,20,291,51,342,14.912280701754385
2063,330045605050012,146,214,174,140,160,81,52,33,915,85,1000,8.5
2064,330045605050013,144,176,140,150,136,77,44,24,823,68,891,7.631874298540965
2065,330045605050014,42,45,61,50,50,35,15,19,283,34,317,10.725552050473187
2066,330045605050015,44,68,71,61,53,57,36,30,354,66,420,15.714285714285714
2067,330045605050016,111,114,106,104,89,48,33,16,572,49,621,7.890499194847021
2068,330045605050017,150,205,161,143,142,100,29,28,901,57,958,5.949895615866389
2069,330045605050018,142,226,134,157,142,80,40,37,881,77,958,8.037578288100208
2070,330045605050019,94,120,150,90,79,73,59,26,606,85,691,12.301013024602026
2071,330045605050020,93,107,104,96,83,70,34,30,553,64,617,10.372771474878444
2072,330045605050021,63,75,97,73,64,59,29,24,431,53,484,10.950413223140496
2073,330045605050022,71,92,93,79,76,65,42,25,476,67,543,12.338858195211786
2074,330045605050023,116,124,129,136,79,79,52,32,663,84,747,11.244979919678714
2075,330045605050024,176,190,163,153,101,79,51,26,862,77,939,8.20021299254526
2076,330045605050025,124,163,181,158,105,105,45,18,836,63,899,7.007786429365962
2077,330045605050026,116,146,107,145,84,76,57,29,674,86,760,11.31578947368421
2078,330045605050027,118,155,107,106,120,65,42,37,671,79,750,10.533333333333333
2079,330045605050028,56,82,65,73,59,39,37,21,374,58,432,13.425925925925926
2080,330045605050029,172,189,166,155,145,80,58,39,907,97,1004,9.661354581673306
2081,330045605050030,119,143,99,102,101,59,44,19,623,63,686,9.183673469387756
2082,330045605050031,124,171,127,123,113,84,43,24,742,67,809,8.281829419035846
2083,330045605050032,156,182,170,130,157,80,34,32,875,66,941,7.0138150903294365
2084,330045605050033,127,154,103,89,61,40,18,14,574,32,606,5.2805280528052805
2085,330045605050034,166,155,112,101,85,67,39,16,686,55,741,7.422402159244265
2086,330045605050035,110,137,126,104,91,68,34,24,636,58,694,8.357348703170029
2087,330045605050036,108,108,94,78,67,51,37,17,506,54,560,9.642857142857142
2088,330045605050037,140,174,113,126,119,83,40,21,755,61,816,7.4754901960784315
2089,330045605050038,117,135,101,126,139,57,44,20,675,64,739,8.660351826792963
2090,330045605050039,94,127,140,105,136,80,41,36,682,77,759,10.144927536231885
2091,330045605050040,168,170,206,148,166,102,50,31,960,81,1041,7.780979827089337
2092,330045605050041,97,124,110,118,95,78,39,16,622,55,677,8.124076809453472
2093,330045605050042,184,199,208,181,162,135,83,38,1069,121,1190,10.168067226890756
2094,330045605050043,96,120,114,85,107,53,34,24,575,58,633,9.162717219589258
2095,330045605050044,99,111,116,109,75,63,31,25,573,56,629,8.90302066772655
2096,330045605050045,80,95,88,104,80,49,36,24,496,60,556,10.79136690647482
2097,330045605050046,39,43,32,32,25,18,9,6,189,15,204,7.352941176470588
2098,330045605050047,127,163,121,130,91,75,36,17,707,53,760,6.973684210526316
2099,330045605050048,87,100,106,81,49,70,36,26,493,62,555,11.17117117117117
2100,330045605050049,107,124,99,86,84,32,34,22,532,56,588,9.523809523809524
2101,330045605050050,164,204,159,149,114,84,31,30,874,61,935,6.524064171122995
2102,330045605050051,119,156,122,119,98,69,36,19,683,55,738,7.452574525745257
2103,330045605050052,66,84,73,78,94,51,24,27,446,51,497,10.261569416498993
2104,330045605050053,97,125,93,127,86,65,49,17,593,66,659,10.015174506828528
2105,330045605050054,121,146,133,107,97,51,48,26,655,74,729,10.150891632373114
2106,330045605050055,93,141,89,99,80,55,32,38,557,70,627,11.164274322169058
2107,330045605050056,127,137,149,143,97,99,44,34,752,78,830,9.397590361445783
2108,330045605050057,180,238,207,212,176,131,68,39,1144,107,1251,8.553157474020784
2109,330045605050058,126,120,96,109,90,54,43,25,595,68,663,10.256410256410257
2110,330045605050059,123,149,124,112,84,74,46,23,666,69,735,9.387755102040817
2111,330045605050060,153,179,167,155,116,73,41,46,843,87,930,9.35483870967742
2112,330045605050061,162,169,166,161,123,71,53,33,852,86,938,9.168443496801705
2113,330045605050062,72,107,95,89,90,69,40,20,522,60,582,10.309278350515465
2114,330045605050063,202,252,206,225,151,104,41,37,1140,78,1218,6.403940886699507
2115,330045605050064,64,87,72,77,57,40,36,14,397,50,447,11.185682326621924
2116,330045605050065,248,289,260,243,183,135,71,41,1358,112,1470,7.619047619047619
2117,330045605050066,101,87,99,92,52,53,34,14,484,48,532,9.022556390977444
2118,330045605050067,127,131,140,102,85,67,21,13,652,34,686,4.956268221574344
2119,330045605050068,85,101,100,98,86,52,63,24,522,87,609,14.285714285714286
2120,330045605050069,109,168,105,95,97,65,30,26,639,56,695,8.057553956834532
2121,330045605050070,101,144,84,118,88,60,42,26,595,68,663,10.256410256410257
2122,330045605050071,60,84,75,80,72,41,21,20,412,41,453,9.050772626931566
2123,330045605050072,131,161,173,147,132,85,76,37,829,113,942,11.995753715498939
2124,330045605050073,153,218,190,159,143,138,54,46,1001,100,1101,9.082652134423252
2125,330045605050074,67,97,87,70,83,47,47,20,451,67,518,12.934362934362934
2126,330045605050075,143,194,139,133,95,86,47,21,790,68,858,7.925407925407925
2127,330045605050076,108,135,122,102,97,65,44,35,629,79,708,11.158192090395481
2128,330045605050077,61,81,65,55,58,36,15,17,356,32,388,8.24742268041237
2129,330045605050078,136,148,118,147,97,64,30,17,710,47,757,6.208718626155878
2130,330045605050079,166,195,132,163,132,69,48,22,857,70,927,7.5512405609492985
2131,330045605050080,79,105,102,71,77,51,38,25,485,63,548,11.496350364963504
2132,330045605050081,173,202,199,181,102,60,33,19,917,52,969,5.366357069143447
2133,330045605050082,78,98,97,97,64,71,38,14,505,52,557,9.335727109515261
2134,330045605050083,126,150,132,148,104,98,77,29,758,106,864,12.268518518518519
2135,330045605050084,154,214,134,162,117,75,48,26,856,74,930,7.956989247311828
2136,330045605050085,61,93,91,106,75,55,64,31,481,95,576,16.493055555555557
2137,330045605050086,54,84,72,107,97,66,54,28,480,82,562,14.590747330960854
2138,330045605050087,136,180,128,139,121,82,48,23,786,71,857,8.284714119019837
2139,330045605050088,128,173,126,144,104,75,42,26,750,68,818,8.312958435207824
2140,330045605050089,73,89,69,67,61,27,18,8,386,26,412,6.310679611650485
2141,330045605050090,60,88,90,73,81,35,41,31,427,72,499,14.428857715430862
2142,330045605050091,50,76,78,73,65,65,44,33,407,77,484,15.909090909090908
2143,330045605050092,56,42,85,51,46,51,28,24,331,52,383,13.577023498694517
2144,330045605050093,89,112,152,144,135,82,65,43,714,108,822,13.138686131386862
2145,330045605050094,60,66,87,87,90,80,63,43,470,106,576,18.40277777777778
2146,330045605050095,62,76,88,88,89,80,53,47,483,100,583,17.152658662092623
2147,330045605050096,84,82,88,94,65,26,24,12,439,36,475,7.578947368421052
2148,330045605050097,70,142,80,102,70,48,27,10,512,37,549,6.739526411657559
2149,330045605050098,140,171,180,158,139,148,79,34,936,113,1049,10.772163965681601
2150,330045605050099,114,135,146,114,110,98,48,30,717,78,795,9.81132075471698
2151,330045605050100,154,183,227,195,199,166,67,34,1124,101,1225,8.244897959183673
2152,330045605050101,147,207,163,156,105,68,49,37,846,86,932,9.227467811158798
2153,330045605050102,67,102,107,92,80,69,29,16,517,45,562,8.00711743772242
2154,330045605050103,53,85,95,80,62,81,36,15,456,51,507,10.059171597633137
2155,330045605050104,70,108,111,99,81,85,32,25,554,57,611,9.328968903436989
2156,330045605050105,100,143,132,130,117,77,30,24,699,54,753,7.171314741035856
2157,330045605050106,61,86,61,90,74,42,21,22,414,43,457,9.409190371991247
2158,330045605050107,60,141,147,145,110,61,54,70,664,124,788,15.736040609137056
2159,330045605050108,65,98,98,82,71,61,31,22,475,53,528,10.037878787878787
2160,330045605050109,39,59,52,30,52,42,25,11,274,36,310,11.612903225806452
2161,330045605050110,86,87,84,86,86,38,33,25,467,58,525,11.047619047619047
2162,330045605050111,64,83,71,75,81,49,28,24,423,52,475,10.947368421052632
2163,330045605050112,11,52,71,77,64,38,36,27,313,63,376,16.75531914893617
2164,330045605050113,86,111,117,161,122,86,80,51,683,131,814,16.093366093366093
2165,330045605050114,131,156,159,143,110,73,42,58,772,100,872,11.46788990825688
2166,330045605050115,119,134,123,116,93,61,28,13,646,41,687,5.967976710334789
2167,330045605050116,124,163,167,150,126,91,58,39,821,97,918,10.566448801742919
2168,330045605050117,71,122,81,82,83,53,29,26,492,55,547,10.054844606946984
2169,330045605050118,170,185,183,174,123,96,56,31,931,87,1018,8.546168958742633
2170,330045605050119,58,82,87,86,80,69,31,28,462,59,521,11.324376199616124
2171,330045605050120,91,125,114,99,105,44,31,39,578,70,648,10.802469135802468
2172,330045605050121,99,103,75,108,85,19,21,16,489,37,526,7.034220532319392
2173,330045605050122,69,79,88,71,76,39,46,19,422,65,487,13.347022587268993
2174,330045605050123,136,175,121,125,123,87,43,22,767,65,832,7.8125
2175,330045605050124,52,82,75,78,70,61,29,22,418,51,469,10.874200426439232
2176,330045605050125,80,88,96,76,72,36,27,19,448,46,494,9.31174089068826
2177,330045605050126,58,100,88,87,69,55,41,22,457,63,520,12.115384615384615
2178,330045605050127,62,65,65,51,50,31,15,5,324,20,344,5.813953488372093
2179,330045605050128,72,97,57,75,66,32,15,14,399,29,428,6.775700934579439
2180,330045605050129,113,146,108,131,85,46,55,17,629,72,701,10.271041369472183
2181,330045605050130,81,92,92,84,64,63,39,17,476,56,532,10.526315789473685
2182,330045605050131,60,73,65,46,63,29,19,13,336,32,368,8.695652173913043
2183,330045605050132,96,94,74,67,49,42,21,14,422,35,457,7.658643326039387
2184,330045605050133,69,99,83,77,100,51,26,14,479,40,519,7.707129094412331
2185,330045605050134,107,156,123,147,101,52,39,31,686,70,756,9.25925925925926
2186,330045605050135,65,104,73,91,72,49,28,26,454,54,508,10.62992125984252
2187,330045605050136,53,73,76,70,71,62,43,18,405,61,466,13.090128755364807
2188,330045605050137,79,97,87,73,55,30,22,22,421,44,465,9.46236559139785
2189,330045605050138,152,215,150,170,132,59,37,19,878,56,934,5.995717344753747
2190,330045605050139,77,63,61,49,66,26,18,9,342,27,369,7.317073170731708
2191,330045605050140,50,38,38,38,31,19,8,4,214,12,226,5.3097345132743365
2192,330045605050141,64,85,76,78,69,47,33,14,419,47,466,10.085836909871245
2193,330045605050142,52,73,81,67,76,64,37,20,413,57,470,12.127659574468085
2194,330045605050143,7,5,1,6,5,5,3,2,29,5,34,14.705882352941176
2195,330045605050144,5,5,4,10,7,2,0,2,33,2,35,5.714285714285714
2196,330050605000001,70,136,145,104,151,149,93,128,755,221,976,22.64344262295082
2197,330050605000002,149,183,222,196,164,128,82,61,1042,143,1185,12.067510548523206
2198,330050605000003,45,45,59,61,58,30,24,17,298,41,339,12.094395280235988
2199,330050605000004,35,27,50,36,38,44,27,27,230,54,284,19.014084507042252
2200,330050605000005,148,143,180,151,143,93,60,57,858,117,975,12.0
2201,330050605000006,30,61,56,35,46,24,17,14,252,31,283,10.954063604240282
2202,330050605000007,117,126,134,142,128,85,64,50,732,114,846,13.47517730496454
2203,330050605000008,111,125,157,150,107,93,37,29,743,66,809,8.15822002472188
2204,330050605000009,132,165,171,188,147,111,71,64,914,135,1049,12.869399428026693
2205,330050605000010,85,119,144,126,124,112,59,54,710,113,823,13.730255164034022
2206,330050605000011,2,6,6,7,11,8,5,8,40,13,53,24.528301886792452
2207,330050605000012,26,33,34,46,46,32,22,31,217,53,270,19.62962962962963
2208,330050605000013,36,41,43,36,27,25,25,14,208,39,247,15.789473684210526
2209,330050605000014,45,79,28,52,41,25,18,15,270,33,303,10.891089108910892
2210,330050605000015,54,58,48,46,48,45,16,14,299,30,329,9.118541033434651
2211,330050605000016,33,50,40,44,51,36,27,17,254,44,298,14.765100671140939
2212,330050605000017,108,107,101,142,83,55,38,24,596,62,658,9.422492401215806
2213,330050605000018,32,24,32,25,28,21,14,9,162,23,185,12.432432432432432
2214,330050605000019,136,159,178,181,149,112,51,32,915,83,998,8.316633266533065
2215,330050605000020,82,102,125,98,77,58,35,39,542,74,616,12.012987012987013
2216,330050605000021,191,234,231,174,146,121,62,53,1097,115,1212,9.488448844884488
2217,330050605000022,52,76,92,72,74,69,24,28,435,52,487,10.677618069815194
2218,330050605000023,113,135,122,131,133,76,43,35,710,78,788,9.898477157360405
2219,330050605000024,95,118,167,138,126,97,35,36,741,71,812,8.74384236453202
2220,330050610000001,150,152,149,180,125,91,57,63,847,120,967,12.409513960703206
2221,330050610000002,111,106,129,110,103,102,43,57,661,100,761,13.140604467805518
2222,330050610000003,44,51,50,47,38,35,19,18,265,37,302,12.251655629139073
2223,330050610000004,68,93,85,76,74,67,38,67,463,105,568,18.485915492957748
2224,330050610000005,85,107,78,103,82,62,43,30,517,73,590,12.372881355932204
2225,330050615000001,40,45,40,38,43,24,31,21,230,52,282,18.43971631205674
2226,330050615000002,44,51,52,61,63,47,39,24,318,63,381,16.53543307086614
2227,330050615000003,119,156,124,133,159,96,82,64,787,146,933,15.64844587352626
2228,330050615000004,94,103,79,82,91,58,50,26,507,76,583,13.036020583190394
2229,330050615000005,62,96,107,99,76,62,34,24,502,58,560,10.357142857142858
2230,330050620000001,129,175,171,156,140,123,88,72,894,160,1054,15.180265654648956
2231,330050620000002,45,67,46,63,50,36,28,25,307,53,360,14.722222222222221
2232,330050620000003,67,87,62,91,100,79,39,26,486,65,551,11.796733212341199
2233,330050620000004,53,36,74,55,41,34,20,17,293,37,330,11.212121212121213
2234,330050620000005,44,60,63,50,48,53,34,24,318,58,376,15.425531914893616
2235,330050620000006,37,63,50,52,54,32,36,18,288,54,342,15.789473684210526
2236,330050620000007,28,24,33,21,17,28,14,10,151,24,175,13.714285714285714
2237,330050620000008,21,36,21,25,33,29,17,18,165,35,200,17.5
2238,330050620000009,217,208,193,201,149,106,73,45,1074,118,1192,9.899328859060402
2239,330060505000001,22,36,56,40,60,62,42,53,276,95,371,25.606469002695416
2240,330060505000002,15,24,36,29,27,31,27,27,162,54,216,25.0
2241,330060505000003,36,56,61,60,107,81,76,122,401,198,599,33.0550918196995
2242,330060505000004,10,17,22,22,29,22,17,11,122,28,150,18.666666666666668
2243,330060505000005,58,43,76,72,70,87,59,72,406,131,537,24.394785847299815
2244,330060505000006,27,34,34,35,40,37,29,32,207,61,268,22.761194029850746
2245,330060505000007,26,68,61,39,65,73,50,52,332,102,434,23.502304147465438
2246,330060505000008,37,60,41,51,46,46,41,45,281,86,367,23.43324250681199
2247,330060505000009,13,24,23,25,26,23,20,28,134,48,182,26.373626373626372
2248,330060505000010,20,15,25,31,29,15,24,27,135,51,186,27.419354838709676
2249,330060505000011,51,66,58,57,38,34,13,9,304,22,326,6.748466257668712
2250,330060505000012,135,163,134,105,94,85,42,24,716,66,782,8.439897698209718
2251,330060505000013,64,72,65,54,52,43,35,17,350,52,402,12.935323383084578
2252,330060505000014,32,38,63,44,37,39,27,14,253,41,294,13.945578231292517
2253,330060505000015,30,25,40,32,20,29,9,5,176,14,190,7.368421052631579
2254,330060505000016,94,113,122,105,93,57,40,38,584,78,662,11.782477341389727
2255,330060505000017,65,106,62,77,74,39,18,25,423,43,466,9.227467811158798
2256,330060505000018,56,91,90,63,83,69,37,41,452,78,530,14.716981132075471
2257,330060505000019,60,73,63,84,49,23,29,15,352,44,396,11.11111111111111
2258,330060505000020,65,90,87,64,68,44,28,38,418,66,484,13.636363636363637
2259,330060505000021,94,101,107,80,88,69,46,40,539,86,625,13.76
2260,330060505000022,113,139,132,111,120,79,51,38,694,89,783,11.366538952745849
2261,330060505000023,89,112,89,92,109,56,41,39,547,80,627,12.759170653907496
2262,330060505000024,87,124,128,88,94,83,62,65,604,127,731,17.3734610123119
2263,330060505000025,65,67,49,57,35,23,14,18,296,32,328,9.75609756097561
2264,330060505000026,35,46,44,46,39,23,19,16,233,35,268,13.059701492537313
2265,330060505000027,7,9,6,11,10,5,11,5,48,16,64,25.0
2266,330060505000028,45,47,55,50,57,70,26,15,324,41,365,11.232876712328768
2267,330060505000029,57,84,99,95,81,56,25,30,472,55,527,10.436432637571157
2268,330060505000030,70,119,89,89,109,83,54,49,559,103,662,15.558912386706949
2269,330060505000031,49,90,86,90,86,55,48,51,456,99,555,17.83783783783784
2270,330060505000032,92,108,116,93,108,78,53,50,595,103,698,14.756446991404012
2271,330060505000033,67,85,109,73,99,94,50,67,527,117,644,18.167701863354036
2272,330060505000034,86,110,114,118,104,72,51,31,604,82,686,11.9533527696793
2273,330060505000035,15,16,19,13,18,14,4,4,95,8,103,7.766990291262136
2274,330060505000036,206,206,196,235,210,157,78,55,1210,133,1343,9.903201787043932
2275,330060505000040,131,137,129,115,105,82,54,51,699,105,804,13.059701492537313
2276,330060505000041,8,6,7,4,6,2,2,1,33,3,36,8.333333333333334
2277,330060505000042,11,26,15,19,26,10,13,9,107,22,129,17.05426356589147
2278,330060505000043,89,114,105,98,127,77,56,66,610,122,732,16.666666666666668
2280,330060505000045,41,49,35,55,65,39,15,10,284,25,309,8.090614886731391
2282,330060505000047,43,43,28,41,48,56,33,48,259,81,340,23.823529411764707
2283,330060505000048,88,135,128,119,165,155,85,80,790,165,955,17.277486910994764
2284,330060505000049,20,17,17,23,33,19,26,34,129,60,189,31.746031746031747
2285,330060505000050,61,70,78,70,72,61,36,16,412,52,464,11.206896551724139
2286,330060505000051,35,47,52,44,62,45,17,15,285,32,317,10.094637223974763
2287,330060505000052,11,21,12,20,34,21,15,8,119,23,142,16.197183098591548
2288,330060505000053,39,33,38,49,34,38,26,14,231,40,271,14.760147601476016
2289,330060505000054,6,12,13,14,7,20,5,10,72,15,87,17.24137931034483
2290,330060505000055,96,116,88,102,113,61,42,34,576,76,652,11.656441717791411
2291,330060505000056,36,53,50,65,43,30,18,16,277,34,311,10.932475884244372
2292,330060505000057,40,50,48,43,39,34,18,12,254,30,284,10.56338028169014
2293,330060505000058,193,205,184,143,110,93,40,28,928,68,996,6.827309236947791
2294,330060505000059,33,51,58,49,53,51,30,32,295,62,357,17.366946778711483
2295,330060505000060,147,192,157,126,149,104,75,47,875,122,997,12.236710130391174
2296,330060505000061,78,135,79,98,103,74,52,27,567,79,646,12.229102167182663
2297,330060505000062,9,24,10,18,15,8,5,5,84,10,94,10.638297872340425
2298,330060505000063,67,98,82,69,80,62,40,39,458,79,537,14.711359404096834
2299,330060505000064,58,65,58,50,38,44,23,23,313,46,359,12.813370473537605
2300,330060505000065,69,95,61,56,73,53,39,32,407,71,478,14.853556485355648
2301,330060505000066,108,115,114,101,123,61,41,36,622,77,699,11.015736766809729
2302,330060510000001,68,114,84,82,87,72,51,57,507,108,615,17.5609756097561
2303,330060510000002,37,56,56,35,43,33,24,14,260,38,298,12.751677852348994
2304,330060510000003,131,205,127,105,118,79,29,40,765,69,834,8.273381294964029
2305,330060515000001,45,87,78,57,83,57,47,61,407,108,515,20.97087378640777
2306,330060515000002,82,126,88,101,113,87,69,75,597,144,741,19.4331983805668
2307,330060515000003,41,61,30,41,37,29,13,5,239,18,257,7.003891050583658
2308,330060515000004,52,82,57,53,50,49,33,21,343,54,397,13.602015113350125
2309,330060515000005,83,107,89,99,85,87,68,49,550,117,667,17.541229385307346
2310,330060515000006,41,43,35,32,25,33,13,7,209,20,229,8.733624454148472
2311,330060515000007,4,13,14,10,8,12,5,3,61,8,69,11.594202898550725
2312,330060520000001,46,72,54,48,49,33,24,40,302,64,366,17.48633879781421
2313,330060520000002,8,9,7,7,4,5,4,1,40,5,45,11.11111111111111
2314,330060520000003,23,21,23,20,23,11,11,10,121,21,142,14.788732394366198
2315,330060525000001,77,116,84,81,88,85,60,77,531,137,668,20.508982035928145
2316,330060525000002,103,121,91,110,91,86,31,41,602,72,674,10.682492581602373
2317,330060525000003,28,48,29,34,41,31,21,10,211,31,242,12.809917355371901
2318,330060530000001,47,54,51,65,45,42,28,36,304,64,368,17.391304347826086
2319,330060530000002,18,26,28,21,19,29,10,11,141,21,162,12.962962962962964
2320,330070405000001,22,34,50,44,38,53,38,46,241,84,325,25.846153846153847
2321,330070405000002,4,4,10,9,14,11,11,30,52,41,93,44.086021505376344
2322,330070405000003,21,35,29,29,29,48,25,35,191,60,251,23.904382470119522
2323,330070405000004,17,15,29,25,23,31,24,22,140,46,186,24.731182795698924
2324,330070405000005,17,29,25,27,32,29,19,13,159,32,191,16.75392670157068
2325,330070405000006,8,28,19,24,27,31,29,37,137,66,203,32.51231527093596
2326,330070405000007,17,39,29,37,33,34,39,29,189,68,257,26.459143968871594
2327,330070405000008,33,40,42,35,44,34,33,33,228,66,294,22.448979591836736
2328,330070405000009,45,88,66,65,92,86,51,54,442,105,547,19.195612431444243
2329,330070405000010,51,97,81,59,97,80,51,45,465,96,561,17.112299465240643
2330,330070405000011,11,22,22,20,31,41,20,24,147,44,191,23.036649214659686
2331,330070405000012,34,49,36,20,31,17,15,4,187,19,206,9.223300970873787
2332,330070405000013,36,46,35,41,44,40,24,15,242,39,281,13.87900355871886
2333,330070405000014,8,9,5,10,5,11,7,7,48,14,62,22.580645161290324
2334,330070405000015,13,24,15,20,32,14,14,5,118,19,137,13.86861313868613
2335,330070405000016,10,10,12,9,16,12,5,11,69,16,85,18.823529411764707
2336,330070405000017,24,43,50,44,45,53,34,26,259,60,319,18.808777429467085
2337,330070405000018,28,45,43,28,52,27,27,23,223,50,273,18.315018315018314
2338,330070405000019,20,32,27,35,34,34,43,28,182,71,253,28.063241106719367
2339,330070405000020,26,23,36,20,32,27,27,11,164,38,202,18.81188118811881
2340,330070405000021,5,12,6,14,10,12,12,9,59,21,80,26.25
2341,330070405000022,3,8,11,4,16,12,9,15,54,24,78,30.76923076923077
2342,330070405000023,2,2,4,1,7,7,4,1,23,5,28,17.857142857142858
2343,330070405000024,22,22,29,36,21,30,17,11,160,28,188,14.893617021276595
2344,330070405000025,7,10,8,7,11,13,10,3,56,13,69,18.840579710144926
2345,330070405000026,12,16,24,13,19,26,19,13,110,32,142,22.535211267605632
2346,330070405000027,4,7,7,11,6,16,10,9,51,19,70,27.142857142857142
2347,330070405000028,3,13,12,12,18,14,15,21,72,36,108,33.333333333333336
2348,330070405000029,14,22,16,23,27,22,22,13,124,35,159,22.0125786163522
2349,330070405000030,11,23,41,25,37,40,32,40,177,72,249,28.91566265060241
2350,330070405000031,15,33,30,21,41,39,30,37,179,67,246,27.235772357723576
2351,330070405000032,38,53,48,58,55,68,40,36,320,76,396,19.19191919191919
2352,330070405000033,4,11,6,14,11,11,7,6,57,13,70,18.571428571428573
2353,330070405000034,47,86,98,87,88,79,55,52,485,107,592,18.074324324324323
2354,330070405000035,36,67,89,57,77,81,44,52,407,96,503,19.08548707753479
2355,330070405000036,13,29,22,32,33,42,35,33,171,68,239,28.451882845188283
2356,330070405000037,54,77,102,63,79,91,49,53,466,102,568,17.95774647887324
2357,330070405000038,16,18,17,17,19,16,7,6,103,13,116,11.206896551724139
2358,330070405000039,13,20,13,13,20,11,4,12,90,16,106,15.09433962264151
2359,330070405000040,26,22,33,26,28,27,18,16,162,34,196,17.346938775510203
2360,330070405000041,21,24,34,34,29,42,19,17,184,36,220,16.363636363636363
2361,330070405000042,15,15,11,25,18,11,17,8,95,25,120,20.833333333333332
2362,330070405000043,14,9,22,12,16,28,18,7,101,25,126,19.841269841269842
2363,330070405000044,29,45,64,42,48,58,31,35,286,66,352,18.75
2364,330070405000045,34,63,60,57,59,65,43,30,338,73,411,17.761557177615572
2365,330070405000046,42,41,57,48,48,49,37,45,285,82,367,22.3433242506812
2366,330070405000047,19,18,16,21,32,17,11,11,123,22,145,15.172413793103448
2367,330070405000048,25,47,33,42,38,37,24,11,222,35,257,13.618677042801556
2368,330070405000049,19,24,25,32,37,33,26,16,170,42,212,19.81132075471698
2369,330070405000050,16,40,27,36,25,27,18,7,171,25,196,12.755102040816327
2370,330070405000051,24,40,39,34,37,50,18,11,224,29,253,11.462450592885375
2371,330070405000052,30,54,42,41,46,52,26,18,265,44,309,14.239482200647249
2372,330070405000053,20,31,31,36,40,31,36,27,189,63,252,25.0
2373,330070405000054,15,7,14,11,4,2,4,8,53,12,65,18.46153846153846
2374,330070405000055,76,93,82,63,73,57,27,22,444,49,493,9.939148073022313
2375,330070405000056,17,17,14,27,27,20,17,11,122,28,150,18.666666666666668
2376,330070405000057,33,58,61,47,55,51,30,22,305,52,357,14.565826330532213
2377,330070405000058,38,32,59,44,40,41,24,15,254,39,293,13.310580204778157
2378,330070405000059,44,56,66,41,77,40,23,34,324,57,381,14.960629921259843
2379,330070405000060,8,25,26,18,28,29,19,20,134,39,173,22.54335260115607
2380,330070405000061,48,55,85,74,70,89,46,41,421,87,508,17.125984251968504
2381,330070405000062,20,40,37,36,41,32,18,26,206,44,250,17.6
2382,330070405000063,57,78,92,99,82,77,53,48,485,101,586,17.235494880546074
2383,330070405000064,55,84,91,77,88,81,41,30,476,71,547,12.979890310786105
2384,330070405000065,82,102,116,96,110,82,55,35,588,90,678,13.274336283185841
2385,330070405000066,96,131,141,123,102,94,50,24,687,74,761,9.724047306176084
2386,330070405000067,71,100,102,111,75,73,49,32,532,81,613,13.213703099510603
2387,330070405000068,72,80,103,78,76,56,36,21,465,57,522,10.919540229885058
2388,330070405000069,60,67,84,63,78,39,33,12,391,45,436,10.321100917431192
2389,330070405000070,80,97,96,106,61,68,34,24,508,58,566,10.247349823321555
2390,330070405000071,69,92,85,107,77,69,30,25,499,55,554,9.927797833935019
2391,330070405000072,95,111,157,146,115,87,49,40,711,89,800,11.125
2392,330070405000073,112,118,139,100,108,88,52,45,665,97,762,12.729658792650918
2393,330070405000074,65,92,115,74,93,67,33,23,506,56,562,9.9644128113879
2394,330070405000075,44,58,72,57,50,56,31,30,337,61,398,15.326633165829145
2395,330070405000076,107,118,114,116,120,88,57,39,663,96,759,12.648221343873518
2396,330070405000077,60,71,78,65,76,40,22,18,390,40,430,9.30232558139535
2397,330070405000078,30,42,42,39,47,31,23,27,231,50,281,17.793594306049823
2398,330070405000079,40,26,52,44,45,37,16,15,244,31,275,11.272727272727273
2399,330070405000080,41,48,61,68,57,46,44,40,321,84,405,20.74074074074074
2400,330070405000081,20,26,31,36,28,25,32,23,166,55,221,24.8868778280543
2401,330070405000082,8,13,10,9,17,21,14,23,78,37,115,32.17391304347826
2402,330070405000083,26,16,20,25,27,29,20,11,143,31,174,17.816091954022987
2403,330070405000084,38,53,64,59,60,48,42,20,322,62,384,16.145833333333332
2404,330070405000085,36,46,36,40,48,41,31,25,247,56,303,18.48184818481848
2405,330070405000086,50,76,73,69,86,62,44,25,416,69,485,14.22680412371134
2406,330070405000087,41,64,58,61,59,60,28,14,343,42,385,10.909090909090908
2407,330070405000088,18,42,32,32,45,22,20,15,191,35,226,15.486725663716815
2408,330070405000089,48,54,63,68,54,30,28,9,317,37,354,10.451977401129943
2409,330070405000090,24,31,27,34,48,25,17,13,189,30,219,13.698630136986301
2410,330070405000091,24,38,32,39,41,33,16,8,207,24,231,10.38961038961039
2411,330070405000092,147,173,120,88,73,53,17,14,654,31,685,4.525547445255475
2412,330070405000093,71,87,83,101,81,58,31,17,481,48,529,9.073724007561436
2413,330070405000094,63,98,89,86,80,57,39,25,473,64,537,11.91806331471136
2414,330070405000095,140,139,108,76,61,41,16,5,565,21,586,3.583617747440273
2415,330070405000096,150,193,131,110,92,57,28,16,733,44,777,5.662805662805662
2416,330070405000097,69,101,96,141,127,57,24,13,591,37,628,5.89171974522293
2417,330070405000098,77,78,111,67,47,48,19,16,428,35,463,7.559395248380129
2418,330070405000099,76,100,79,115,90,61,31,18,521,49,570,8.596491228070175
2419,330070405000100,60,78,76,87,56,61,32,15,418,47,465,10.10752688172043
2420,330070405000101,86,90,98,102,95,77,58,36,548,94,642,14.641744548286605
2421,330070405000102,88,102,90,100,83,71,44,32,534,76,610,12.459016393442623
2422,330070405000103,59,87,61,82,73,47,28,26,409,54,463,11.663066954643629
2423,330070405000104,78,89,89,109,64,56,57,24,485,81,566,14.31095406360424
2424,330070405000105,53,57,71,64,77,40,30,39,362,69,431,16.009280742459396
2425,330070405000106,46,64,73,56,79,59,44,33,377,77,454,16.96035242290749
2426,330070405000107,28,54,69,57,72,75,49,37,355,86,441,19.501133786848072
2427,330070405000108,50,75,58,68,63,67,33,22,381,55,436,12.614678899082568
2428,330070405000109,75,113,107,91,108,87,61,60,581,121,702,17.236467236467238
2429,330070405000110,65,81,75,71,84,49,37,15,425,52,477,10.90146750524109
2430,330070405000111,117,136,121,116,115,88,61,33,693,94,787,11.944091486658195
2431,330070405000112,78,119,102,109,117,75,60,55,600,115,715,16.083916083916083
2432,330070405000113,110,155,131,126,115,87,43,28,724,71,795,8.930817610062894
2433,330070405000114,84,126,118,109,144,70,56,48,651,104,755,13.774834437086092
2434,330070405000115,77,102,99,80,95,64,29,29,517,58,575,10.08695652173913
2435,330070405000116,48,78,72,57,72,42,21,22,369,43,412,10.436893203883495
2436,330070405000117,63,96,85,70,73,66,40,42,453,82,535,15.327102803738319
2437,330070405000118,36,70,62,47,69,42,41,18,326,59,385,15.324675324675324
2438,330070405000119,74,101,107,72,80,46,26,23,480,49,529,9.262759924385634
2439,330070405000120,77,121,112,103,101,84,56,44,598,100,698,14.326647564469914
2440,330070405000121,55,86,90,74,95,68,38,39,468,77,545,14.128440366972477
2441,330070405000122,23,25,45,25,27,27,12,7,172,19,191,9.947643979057592
2442,330070405000123,76,94,135,116,110,91,43,36,622,79,701,11.269614835948644
2443,330070405000124,64,80,83,83,62,47,36,16,419,52,471,11.040339702760084
2444,330070405000125,128,171,158,186,142,112,52,43,897,95,992,9.576612903225806
2445,330070405000126,75,93,76,94,102,55,25,20,495,45,540,8.333333333333334
2446,330070405000127,70,88,71,92,59,46,24,13,426,37,463,7.991360691144709
2447,330070405000128,77,84,77,93,70,41,23,16,442,39,481,8.108108108108109
2448,330070405000129,91,104,92,117,63,63,34,21,530,55,585,9.401709401709402
2449,330070405000130,74,108,99,115,95,95,56,23,586,79,665,11.8796992481203
2450,330070405000131,66,118,109,93,115,87,67,43,588,110,698,15.759312320916905
2451,330070405000132,21,29,10,19,42,13,18,10,134,28,162,17.28395061728395
2452,330070405000133,82,122,120,88,94,81,35,33,587,68,655,10.381679389312977
2453,330070405000134,97,122,115,96,88,56,39,17,574,56,630,8.88888888888889
2454,330070405000135,49,63,51,60,68,53,47,38,344,85,429,19.813519813519815
2455,330070405000136,86,85,89,100,94,56,37,18,510,55,565,9.734513274336283
2456,330070405000137,25,37,33,42,39,27,22,12,203,34,237,14.345991561181435
2457,330070405000138,30,45,28,54,40,24,18,21,221,39,260,15.0
2458,330070405000139,50,64,60,74,70,61,35,22,379,57,436,13.073394495412844
2459,330070405000140,48,61,67,60,80,63,33,14,379,47,426,11.032863849765258
2460,330070405000141,47,86,65,61,80,52,12,18,391,30,421,7.1258907363420425
2461,330070405000142,35,69,75,63,77,53,27,14,372,41,413,9.927360774818402
2462,330070405000143,68,78,89,86,97,75,54,46,493,100,593,16.863406408094434
2463,330070405000144,63,78,126,79,111,117,66,28,574,94,668,14.071856287425149
2464,330070405000145,40,52,60,38,59,63,26,24,312,50,362,13.812154696132596
2465,330070405000146,19,37,51,40,57,45,43,35,249,78,327,23.853211009174313
2466,330070405000147,26,54,53,47,52,67,37,41,299,78,377,20.689655172413794
2467,330070405000148,18,35,33,30,37,38,25,22,191,47,238,19.747899159663866
2468,330070405000149,49,61,56,68,76,65,56,42,375,98,473,20.718816067653275
2469,330070405000150,31,27,44,27,36,37,31,29,202,60,262,22.900763358778626
2470,330070405000151,77,91,75,62,55,42,25,13,402,38,440,8.636363636363637
2471,330070405000152,34,45,39,41,56,58,30,42,273,72,345,20.869565217391305
2472,330070405000153,12,17,18,18,21,23,20,24,109,44,153,28.758169934640524
2473,330070405000154,34,60,59,83,66,67,39,30,369,69,438,15.753424657534246
2474,330070405000155,61,73,75,80,79,55,45,33,423,78,501,15.568862275449101
2475,330070405000156,8,14,16,18,28,16,10,3,100,13,113,11.504424778761061
2476,330070405000157,0,7,9,6,12,10,6,4,44,10,54,18.51851851851852
2477,330070405000158,65,78,45,57,78,38,24,12,361,36,397,9.06801007556675
2478,330070405000159,57,48,60,46,37,34,17,11,282,28,310,9.03225806451613
2479,330070405000160,127,131,121,105,102,53,29,14,639,43,682,6.3049853372434015
2480,330070405000161,109,117,122,96,78,67,26,25,589,51,640,7.96875
2481,330070405000162,107,110,117,86,89,45,27,22,554,49,603,8.12603648424544
2482,330070405000163,92,107,100,70,96,39,15,12,504,27,531,5.084745762711864
2483,330070405000164,95,78,63,83,36,21,11,8,376,19,395,4.810126582278481
2484,330070405000165,57,60,49,49,37,29,9,9,281,18,299,6.0200668896321075
2485,330070405000166,117,115,85,65,61,39,33,14,482,47,529,8.88468809073724
2486,330070405000167,144,158,116,96,92,67,29,11,673,40,713,5.610098176718092
2487,330070405000168,66,91,73,71,52,37,18,5,390,23,413,5.5690072639225185
2488,330070405000169,138,167,96,138,120,71,39,30,730,69,799,8.635794743429287
2489,330070405000170,94,132,102,99,76,57,30,19,560,49,609,8.045977011494253
2490,330070405000171,121,140,126,110,97,52,26,19,646,45,691,6.512301013024602
2491,330070405000172,90,80,79,82,46,31,23,7,408,30,438,6.8493150684931505
2492,330070405000173,103,127,127,95,90,57,29,22,599,51,650,7.846153846153846
2493,330070405000174,70,91,89,63,66,48,11,10,427,21,448,4.6875
2494,330070405000175,143,144,153,148,101,95,32,16,784,48,832,5.769230769230769
2495,330070405000176,123,173,108,128,95,54,33,17,681,50,731,6.839945280437757
2496,330070405000177,1,10,2,3,3,2,1,2,21,3,24,12.5
2497,330070405000178,79,97,94,59,71,44,17,13,444,30,474,6.329113924050633
2498,330070405000179,150,174,154,135,116,69,45,26,798,71,869,8.170310701956272
2499,330070405000180,112,130,155,100,92,68,40,17,657,57,714,7.983193277310924
2500,330070405000181,132,142,165,135,99,84,46,25,757,71,828,8.57487922705314
2501,330070405000182,58,67,75,71,65,52,18,21,388,39,427,9.133489461358314
2502,330070405000183,160,170,120,122,93,55,16,19,720,35,755,4.635761589403973
2503,330070405000184,138,112,132,93,72,44,19,14,591,33,624,5.288461538461538
2504,330070405000185,54,65,46,52,44,26,16,5,287,21,308,6.818181818181818
2505,330070405000186,43,71,82,64,57,47,37,12,364,49,413,11.864406779661017
2506,330070405000187,60,79,89,62,64,39,35,19,393,54,447,12.080536912751677
2507,330070405000188,77,79,78,74,51,41,36,7,400,43,443,9.706546275395034
2508,330070405000189,76,112,75,87,75,40,20,12,465,32,497,6.438631790744467
2509,330070405000190,118,129,105,112,76,57,33,23,597,56,653,8.575803981623277
2510,330070405000191,123,176,123,111,112,67,24,17,712,41,753,5.444887118193891
2511,330070405000192,150,151,133,142,83,48,20,4,707,24,731,3.283173734610123
2512,330070405000193,55,86,70,79,67,45,26,13,402,39,441,8.843537414965986
2513,330070405000194,111,133,132,96,84,70,24,16,626,40,666,6.006006006006006
2514,330070405000195,67,84,62,73,63,33,18,11,382,29,411,7.0559610705596105
2515,330070405000196,138,209,150,141,139,69,29,35,846,64,910,7.032967032967033
2516,330070405000197,151,155,143,130,108,44,35,19,731,54,785,6.8789808917197455
2517,330070405000198,72,89,66,76,52,33,7,9,388,16,404,3.9603960396039604
2518,330070405000199,32,48,33,44,31,25,12,5,213,17,230,7.391304347826087
2519,330070405000200,92,96,98,64,55,45,16,9,450,25,475,5.2631578947368425
2520,330070405000201,185,181,175,130,106,67,32,14,844,46,890,5.168539325842697
2521,330070405000202,86,114,103,88,76,40,22,20,507,42,549,7.6502732240437155
2522,330070405000203,176,226,157,134,111,78,31,18,882,49,931,5.2631578947368425
2523,330070405000204,125,118,100,81,67,48,15,12,539,27,566,4.770318021201414
2524,330070405000205,147,154,144,128,92,62,36,9,727,45,772,5.829015544041451
2525,330070405000206,17,39,28,29,48,38,24,15,199,39,238,16.386554621848738
2526,330070405000207,86,108,67,68,81,40,15,8,450,23,473,4.862579281183932
2527,330070405000208,162,155,134,120,100,54,33,13,725,46,771,5.966277561608301
2528,330070405000209,131,150,133,99,86,64,28,21,663,49,712,6.882022471910112
2529,330070405000210,112,212,113,123,98,47,19,17,705,36,741,4.8582995951417
2530,330070405000211,89,121,95,78,80,46,19,17,509,36,545,6.605504587155964
2531,330070405000212,69,79,71,77,59,73,32,23,428,55,483,11.387163561076605
2532,330070405000213,27,27,41,32,15,30,27,8,172,35,207,16.908212560386474
2533,330070405000214,26,42,38,39,27,41,26,18,213,44,257,17.120622568093385
2534,330070405000215,9,1,6,5,3,2,0,0,26,0,26,0.0
2535,330070405000216,54,55,84,62,55,64,55,34,374,89,463,19.22246220302376
2536,330070405000217,98,125,89,107,104,70,67,36,593,103,696,14.798850574712644
2537,330070405000218,9,11,19,13,19,19,11,5,90,16,106,15.09433962264151
2538,330070405000219,47,72,53,71,70,67,42,33,380,75,455,16.483516483516482
2539,330070405000220,6,14,4,13,9,3,4,2,49,6,55,10.909090909090908
2540,330070405000221,21,15,34,31,16,30,9,7,147,16,163,9.815950920245399
2541,330070405000222,10,17,19,20,15,21,11,3,102,14,116,12.068965517241379
2542,330070405000223,17,37,29,26,42,19,20,12,170,32,202,15.841584158415841
2543,330070405000224,14,27,19,20,25,21,16,8,126,24,150,16.0
2544,330070405000225,1,5,5,6,3,10,3,2,30,5,35,14.285714285714286
2545,330070405000226,1,9,7,10,11,12,3,2,50,5,55,9.090909090909092
2546,330070405000227,18,20,13,16,22,12,13,7,101,20,121,16.52892561983471
2547,330070405000228,61,78,62,68,70,50,34,18,389,52,441,11.791383219954648
2548,330070405000229,50,66,56,64,63,36,25,16,335,41,376,10.904255319148936
2549,330070405000230,98,147,105,134,102,76,52,23,662,75,737,10.176390773405698
2550,330070405000231,19,14,21,22,12,7,4,2,95,6,101,5.9405940594059405
2551,330070405000232,5,9,8,7,8,11,10,1,48,11,59,18.64406779661017
2552,330070405000233,24,33,40,37,34,31,20,11,199,31,230,13.478260869565217
2553,330070405000234,24,33,32,41,26,40,9,16,196,25,221,11.312217194570136
2554,330070405000235,24,38,19,37,50,45,18,8,213,26,239,10.878661087866108
2555,330070405000236,35,47,33,38,47,34,25,15,234,40,274,14.598540145985401
2556,330070405000237,76,117,130,85,134,86,55,37,628,92,720,12.777777777777779
2557,330070405000238,62,66,63,65,71,51,15,15,378,30,408,7.352941176470588
2558,330070405000239,88,120,121,62,74,38,24,9,503,33,536,6.156716417910448
2559,330070405000240,72,106,108,60,62,39,18,8,447,26,473,5.496828752642706
2560,330070405000241,76,94,117,65,85,74,25,31,511,56,567,9.876543209876543
2561,330070405000242,79,84,87,74,63,49,22,19,436,41,477,8.59538784067086
2562,330070405000243,88,98,109,105,106,76,44,25,582,69,651,10.599078341013826
2563,330070405000244,87,141,103,91,88,43,18,9,553,27,580,4.655172413793103
2564,330070405000245,114,159,125,98,105,61,30,22,662,52,714,7.282913165266106
2565,330070405000246,149,129,95,77,67,48,19,4,565,23,588,3.9115646258503403
2566,330070405000247,88,93,62,78,45,22,9,3,388,12,400,3.0
2567,330070405000248,127,149,113,140,106,64,27,21,699,48,747,6.42570281124498
2568,330070405000249,179,164,125,139,96,45,27,12,748,39,787,4.955527318932655
2569,330070405000250,129,150,95,98,88,41,23,13,601,36,637,5.65149136577708
2570,330070405000251,96,121,77,87,61,31,17,7,473,24,497,4.82897384305835
2571,330070405000252,96,97,100,80,70,55,21,12,498,33,531,6.214689265536723
2572,330070405000253,119,150,171,139,141,102,59,54,822,113,935,12.085561497326204
2573,330070405000254,39,33,28,25,31,15,4,2,171,6,177,3.389830508474576
2574,330070405000255,38,36,51,54,39,46,35,21,264,56,320,17.5
2575,330070405000256,35,55,68,58,69,59,34,28,344,62,406,15.270935960591133
2576,330070405000257,69,71,104,124,62,53,34,19,483,53,536,9.888059701492537
2577,330070405000258,49,74,69,82,63,46,36,17,383,53,436,12.155963302752294
2578,330070405000259,53,54,69,98,52,49,23,28,375,51,426,11.971830985915492
2579,330070405000260,12,19,20,14,21,7,20,7,93,27,120,22.5
2580,330070405000261,32,47,45,42,55,47,35,27,268,62,330,18.78787878787879
2581,330070405000262,80,95,81,85,93,62,28,11,496,39,535,7.289719626168225
2582,330070405000263,60,63,87,83,73,41,19,13,407,32,439,7.289293849658314
2583,330070405000264,87,114,113,100,75,49,27,20,538,47,585,8.034188034188034
2584,330070405000265,18,26,33,35,32,29,20,21,173,41,214,19.1588785046729
2585,330070405000266,40,51,34,27,22,20,7,6,194,13,207,6.280193236714976
2586,330070405000267,25,26,31,28,39,24,26,10,173,36,209,17.22488038277512
2587,330070405000268,29,41,41,49,45,37,34,20,242,54,296,18.243243243243242
2588,330070405000269,85,84,77,90,59,60,34,20,455,54,509,10.609037328094303
2589,330070405000270,97,112,92,68,58,28,13,6,455,19,474,4.008438818565401
2590,330070405000271,70,86,78,54,37,41,19,13,366,32,398,8.040201005025125
2591,330070405000272,44,74,58,67,60,48,33,27,351,60,411,14.598540145985401
2592,330070405000273,25,33,25,31,47,24,23,16,185,39,224,17.410714285714285
2593,330070405000274,34,43,36,37,36,41,27,17,227,44,271,16.236162361623617
2594,330070405000275,74,88,63,69,67,50,17,7,411,24,435,5.517241379310345
2595,330070405000276,47,58,45,55,50,33,15,9,288,24,312,7.6923076923076925
2596,330070405000277,79,84,68,60,41,28,8,5,360,13,373,3.485254691689008
2597,330070405000278,16,11,18,24,13,11,4,1,93,5,98,5.1020408163265305
2598,330070405000279,117,109,89,69,67,40,15,13,491,28,519,5.394990366088632
2599,330070405000280,77,84,62,60,56,52,26,11,391,37,428,8.644859813084112
2601,330070405000282,24,28,29,16,21,12,6,1,130,7,137,5.109489051094891
2602,330070405000283,81,107,86,90,62,40,21,13,466,34,500,6.8
2603,330070405000284,118,117,116,93,62,44,26,14,550,40,590,6.779661016949152
2604,330070405000285,102,107,92,92,69,37,18,11,499,29,528,5.492424242424242
2605,330070405000286,85,101,66,73,69,20,19,8,414,27,441,6.122448979591836
2606,330070405000287,91,115,98,78,54,55,14,7,491,21,512,4.1015625
2607,330070405000288,82,97,110,78,55,60,30,17,482,47,529,8.88468809073724
2608,330070405000289,77,117,92,69,75,58,27,13,488,40,528,7.575757575757576
2609,330070405000290,103,135,99,100,71,60,17,17,568,34,602,5.647840531561462
2610,330070405000291,129,113,112,101,49,22,11,6,526,17,543,3.130755064456722
2611,330070405000292,106,93,88,50,53,31,8,4,421,12,433,2.771362586605081
2612,330070405000293,113,114,95,79,76,47,20,18,524,38,562,6.761565836298932
2613,330070405000294,93,94,72,86,50,41,15,6,436,21,457,4.595185995623632
2614,330070405000295,25,26,30,25,16,16,7,5,138,12,150,8.0
2615,330070405000296,1,9,9,5,6,5,3,2,35,5,40,12.5
2616,330070405000297,143,133,149,106,111,73,33,22,715,55,770,7.142857142857143
2617,330070405000298,39,23,33,21,18,15,9,5,149,14,163,8.588957055214724
2618,330070405000299,138,140,113,104,79,32,11,16,606,27,633,4.265402843601896
2619,330070405000300,37,38,40,45,33,38,17,8,231,25,256,9.765625
2620,330070405000301,84,91,42,54,41,28,10,8,340,18,358,5.027932960893855
2621,330070405000302,19,27,37,45,24,32,10,2,184,12,196,6.122448979591836
2622,330070405000303,22,25,29,22,26,29,12,4,153,16,169,9.467455621301776
2623,330070405000304,28,39,19,34,35,24,14,10,179,24,203,11.822660098522167
2624,330070405000305,57,90,71,83,91,59,35,25,451,60,511,11.741682974559687
2625,330070405000306,28,51,75,47,57,60,15,21,318,36,354,10.169491525423728
2626,330070405000307,31,44,59,52,37,38,23,17,261,40,301,13.289036544850498
2627,330070405000308,69,83,84,69,77,61,22,15,443,37,480,7.708333333333333
2628,330070405000309,55,57,58,70,70,41,21,15,351,36,387,9.30232558139535
2629,330070405000310,79,78,105,78,70,71,27,7,481,34,515,6.601941747572815
2630,330070405000311,88,110,99,90,56,41,31,5,484,36,520,6.923076923076923
2631,330070405000312,61,62,62,54,46,31,14,2,316,16,332,4.819277108433735
2632,330070405000313,70,82,75,82,65,44,23,21,418,44,462,9.523809523809524
2633,330070405000314,65,84,69,85,100,69,34,22,472,56,528,10.606060606060606
2634,330070405000315,42,65,67,47,66,47,20,8,334,28,362,7.734806629834254
2635,330070405000316,56,58,63,81,57,53,35,16,368,51,419,12.171837708830548
2636,330070405000317,52,64,64,72,68,61,21,24,381,45,426,10.56338028169014
2637,330070405000318,52,71,56,67,78,43,30,16,367,46,413,11.138014527845037
2638,330070405000319,52,83,77,64,91,78,30,24,445,54,499,10.821643286573146
2639,330070405000320,32,75,52,53,63,74,36,21,349,57,406,14.039408866995075
2640,330070405000321,82,88,109,76,65,67,26,19,487,45,532,8.458646616541353
2641,330070405000322,143,155,158,136,79,61,38,18,732,56,788,7.106598984771574
2642,330070405000323,84,90,98,66,53,39,9,6,430,15,445,3.3707865168539324
2643,330070405000324,83,65,58,70,49,28,16,7,353,23,376,6.117021276595745
2644,330070405000325,170,192,146,107,95,49,30,19,759,49,808,6.064356435643564
2645,330070405000326,19,25,24,24,31,26,14,9,149,23,172,13.372093023255815
2646,330070405000327,29,30,30,49,32,27,17,14,197,31,228,13.596491228070175
2647,330070405000328,22,22,21,40,38,23,20,6,166,26,192,13.541666666666666
2648,330070405000329,99,131,78,119,87,47,38,19,561,57,618,9.223300970873787
2649,330070405000330,3,6,13,10,16,17,5,6,65,11,76,14.473684210526315
2650,330070405000331,29,36,24,24,40,21,17,3,174,20,194,10.309278350515465
2651,330070405000332,118,134,133,131,104,82,25,25,702,50,752,6.648936170212766
2652,330070405000333,40,36,39,48,52,38,13,11,253,24,277,8.664259927797834
2653,330070405000334,7,10,7,11,17,9,11,3,61,14,75,18.666666666666668
2654,330070405000335,7,3,4,3,6,4,5,6,27,11,38,28.94736842105263
2655,330070405000336,3,13,9,9,15,11,16,10,60,26,86,30.232558139534884
2657,330070420000001,35,45,40,35,24,17,12,9,196,21,217,9.67741935483871
2658,330070420000002,46,71,38,76,44,41,23,13,316,36,352,10.227272727272727
2659,330070420000003,25,55,21,48,32,29,16,4,210,20,230,8.695652173913043
2660,330070420000004,25,22,14,15,18,19,9,5,113,14,127,11.023622047244094
2661,330070420000005,55,51,34,45,25,16,14,4,226,18,244,7.377049180327869
2662,330070420000006,45,57,55,51,55,46,28,14,309,42,351,11.965811965811966
2663,330070420000007,22,21,26,12,17,16,13,9,114,22,136,16.176470588235293
2664,330070420000008,18,26,18,16,24,22,13,7,124,20,144,13.88888888888889
2665,330070420000009,16,18,18,17,15,15,15,6,99,21,120,17.5
2666,330070420000010,25,24,19,25,24,27,12,4,144,16,160,10.0
2667,330070420000011,12,22,16,18,21,15,8,3,104,11,115,9.565217391304348
2668,330070420000012,9,9,8,15,8,11,8,0,60,8,68,11.764705882352942
2669,330070420000013,18,18,15,21,18,15,14,7,105,21,126,16.666666666666668
2670,330070420000014,22,33,14,20,26,32,18,8,147,26,173,15.028901734104046
2671,330070420000015,28,54,32,33,52,36,17,9,235,26,261,9.96168582375479
2672,330070420000016,61,95,57,68,47,30,30,6,358,36,394,9.137055837563452
2673,330070420000017,67,94,68,69,67,34,33,14,399,47,446,10.538116591928251
2674,330070420000018,98,134,100,119,86,87,44,30,624,74,698,10.601719197707736
2675,330070420000019,114,162,124,111,82,66,41,25,659,66,725,9.10344827586207
2676,330070420000020,89,126,93,89,82,56,35,26,535,61,596,10.234899328859061
2677,330070420000021,57,54,77,58,44,45,32,15,335,47,382,12.303664921465968
2678,330070420000022,75,84,86,78,74,57,43,25,454,68,522,13.026819923371647
2679,330070420000023,148,155,136,100,113,84,49,28,736,77,813,9.47109471094711
2680,330070420000024,45,59,67,54,67,47,43,38,339,81,420,19.285714285714285
2681,330070420000025,52,73,48,77,52,72,54,42,374,96,470,20.425531914893618
2682,330070420000026,66,73,72,52,60,44,30,16,367,46,413,11.138014527845037
2683,330070420000027,43,51,43,65,38,51,42,33,291,75,366,20.491803278688526
2684,330070420000028,38,48,44,41,35,34,21,13,240,34,274,12.408759124087592
2685,330070420000029,44,49,77,55,53,67,34,12,345,46,391,11.764705882352942
2686,330070420000030,36,65,38,37,40,41,22,18,257,40,297,13.468013468013469
2687,330070420000031,30,43,32,32,38,42,27,34,217,61,278,21.942446043165468
2688,330070420000032,74,92,85,66,50,61,46,28,428,74,502,14.741035856573705
2689,330070420000033,60,67,57,50,36,30,23,10,300,33,333,9.90990990990991
2690,330070420000034,22,38,24,16,37,32,13,9,169,22,191,11.518324607329843
2691,330070420000035,82,90,84,83,60,72,39,36,471,75,546,13.736263736263735
2692,330070420000036,36,58,49,51,46,44,26,15,284,41,325,12.615384615384615
2693,330070420000037,66,94,87,54,79,36,28,18,416,46,462,9.956709956709958
2694,330070420000038,77,102,100,69,85,54,40,18,487,58,545,10.642201834862385
2695,330070420000039,93,107,114,85,70,61,31,32,530,63,593,10.623946037099493
2696,330070420000040,37,56,58,59,58,51,26,26,319,52,371,14.016172506738544
2697,330070420000041,55,75,67,61,44,32,32,11,334,43,377,11.405835543766578
2698,330070420000042,65,67,60,70,49,41,32,21,352,53,405,13.08641975308642
2699,330070420000043,46,42,51,39,40,35,27,19,253,46,299,15.384615384615385
2700,330070420000044,47,64,53,65,54,56,36,33,339,69,408,16.91176470588235
2701,330070420000045,55,57,72,74,62,63,42,28,383,70,453,15.45253863134658
2702,330070420000046,38,56,38,60,59,43,51,30,294,81,375,21.6
2703,330070420000047,40,63,40,46,67,37,24,14,293,38,331,11.48036253776435
2704,330070420000048,37,47,41,32,44,44,23,17,245,40,285,14.035087719298245
2705,330070420000049,68,62,45,49,24,31,13,8,279,21,300,7.0
2706,330070420000050,43,55,45,48,31,31,19,9,253,28,281,9.9644128113879
2707,330070420000051,42,27,42,33,25,16,21,12,185,33,218,15.137614678899082
2708,330070420000052,31,31,30,26,14,28,14,7,160,21,181,11.602209944751381
2709,330070420000053,120,134,79,109,71,61,36,17,574,53,627,8.452950558213717
2710,330070420000054,37,48,47,26,43,49,34,10,250,44,294,14.965986394557824
2711,330070420000055,21,24,26,26,30,22,17,12,149,29,178,16.292134831460675
2712,330070420000056,43,49,53,36,56,30,19,17,267,36,303,11.881188118811881
2713,330070420000057,10,17,13,24,25,33,23,24,122,47,169,27.810650887573964
2714,330070420000058,11,17,19,8,12,16,5,2,83,7,90,7.777777777777778
2715,330070420000059,10,11,8,13,9,14,12,6,65,18,83,21.686746987951807
2716,330070420000060,175,167,172,152,131,77,52,30,874,82,956,8.577405857740585
2717,330070420000061,120,116,112,112,79,64,33,9,603,42,645,6.511627906976744
2718,330070420000062,94,112,77,86,51,21,18,9,441,27,468,5.769230769230769
2719,330070420000063,160,192,148,176,99,64,33,27,839,60,899,6.674082313681868
2720,330070420000064,208,229,210,187,138,92,39,34,1064,73,1137,6.420404573438875
2721,330070420000065,106,152,101,94,71,44,21,17,568,38,606,6.270627062706271
2722,330070420000066,166,207,124,110,81,63,30,22,751,52,803,6.475716064757161
2723,330070420000067,142,163,123,115,89,49,21,26,681,47,728,6.456043956043956
2724,330070420000068,116,158,116,91,66,48,30,13,595,43,638,6.739811912225705
2725,330070420000069,39,53,35,45,27,32,22,11,231,33,264,12.5
2726,330070420000070,89,126,236,156,126,64,15,9,797,24,821,2.92326431181486
2727,330070420000071,89,96,82,84,65,60,35,19,476,54,530,10.18867924528302
2728,330070420000072,80,106,86,74,61,51,30,25,458,55,513,10.721247563352826
2729,330070420000073,79,71,85,77,65,53,31,31,430,62,492,12.601626016260163
2730,330070420000074,51,47,46,33,31,26,8,11,234,19,253,7.509881422924901
2731,330070420000075,80,98,86,59,62,60,30,20,445,50,495,10.1010101010101
2732,330070420000076,58,76,55,64,46,48,23,10,347,33,380,8.68421052631579
2733,330070420000077,34,38,25,31,18,17,12,9,163,21,184,11.41304347826087
2734,330070420000078,42,68,56,57,49,45,40,13,317,53,370,14.324324324324325
2735,330070420000079,21,37,22,30,28,24,13,8,162,21,183,11.475409836065573
2736,330070420000080,39,57,39,39,37,33,38,18,244,56,300,18.666666666666668
2737,330070420000081,54,74,52,61,44,40,24,17,325,41,366,11.202185792349727
2738,330070420000082,24,42,36,29,33,30,20,17,194,37,231,16.017316017316016
2739,330070420000083,39,49,54,40,35,41,26,15,258,41,299,13.7123745819398
2740,330070420000084,52,58,52,51,40,37,20,11,290,31,321,9.657320872274143
2741,330070420000085,75,73,72,61,53,45,26,7,379,33,412,8.009708737864077
2742,330070420000086,65,56,74,60,44,52,44,14,351,58,409,14.180929095354523
2743,330070420000087,63,62,66,71,35,55,26,17,352,43,395,10.886075949367088
2744,330070420000088,56,64,62,62,62,39,24,14,345,38,383,9.921671018276763
2745,330070420000089,40,49,39,67,36,36,40,24,267,64,331,19.335347432024168
2746,330070420000090,84,117,84,98,99,61,37,33,543,70,613,11.419249592169658
2747,330070420000091,106,106,84,84,66,32,24,17,478,41,519,7.89980732177264
2748,330070420000092,91,123,88,89,70,32,27,24,493,51,544,9.375
2749,330070420000093,76,112,84,85,76,34,31,22,467,53,520,10.192307692307692
2750,330070420000094,76,86,90,78,43,29,22,18,402,40,442,9.049773755656108
2751,330070420000095,102,112,85,110,73,61,36,18,543,54,597,9.045226130653266
2752,330070420000096,76,77,94,83,59,61,39,28,450,67,517,12.959381044487428
2753,330070420000097,80,92,80,83,64,78,49,27,477,76,553,13.743218806509946
2754,330070420000098,33,36,26,44,28,39,22,19,206,41,247,16.59919028340081
2755,330070420000099,20,30,34,32,19,14,6,9,149,15,164,9.146341463414634
2756,330070420000100,143,167,142,141,130,70,46,28,793,74,867,8.53517877739331
2757,330070420000101,50,43,35,49,27,21,17,9,225,26,251,10.358565737051793
2758,330070420000102,34,54,31,27,22,15,14,3,183,17,200,8.5
2759,330070420000103,59,58,56,40,47,31,12,3,291,15,306,4.901960784313726
2760,330070420000104,35,37,30,27,23,15,7,8,167,15,182,8.241758241758241
2761,330070420000105,15,18,3,17,7,1,1,0,61,1,62,1.6129032258064515
2762,330070420000106,11,8,12,11,9,11,19,21,62,40,102,39.21568627450981
2763,330070420000107,6,15,10,11,11,13,9,4,66,13,79,16.455696202531644
2764,330070420000108,8,8,7,15,7,8,10,5,53,15,68,22.058823529411764
2765,330070420000109,51,42,53,49,38,24,14,3,257,17,274,6.204379562043796
2766,330070420000110,226,255,189,190,152,92,36,34,1104,70,1174,5.9625212947189095
2767,330070420000111,100,89,91,98,54,31,15,14,463,29,492,5.894308943089431
2768,330070420000112,106,134,90,89,77,49,29,19,545,48,593,8.094435075885329
2769,330070420000113,54,91,69,54,44,39,14,12,351,26,377,6.896551724137931
2770,330070420000114,69,74,66,87,38,48,35,16,382,51,433,11.778290993071593
2771,330070420000115,147,149,111,102,82,62,43,21,653,64,717,8.92608089260809
2772,330070420000116,16,19,15,15,24,26,31,22,115,53,168,31.547619047619047
2773,330070420000117,15,11,7,19,15,14,4,14,81,18,99,18.181818181818183
2774,330070420000118,9,11,6,11,14,8,4,1,59,5,64,7.8125
2775,330070420000119,7,10,10,9,10,18,12,7,64,19,83,22.89156626506024
2776,330080305000001,48,66,65,48,75,49,34,26,351,60,411,14.598540145985401
2777,330080305000002,108,140,172,149,136,107,72,56,812,128,940,13.617021276595745
2778,330080305000003,57,94,83,94,75,69,23,45,472,68,540,12.592592592592593
2779,330080305000004,97,128,125,112,95,62,35,36,619,71,690,10.289855072463768
2780,330080305000005,52,78,103,85,70,106,43,65,494,108,602,17.940199335548172
2781,330080305000006,94,98,109,96,90,84,50,36,571,86,657,13.089802130898022
2782,330080305000007,100,98,111,116,101,85,72,49,611,121,732,16.530054644808743
2783,330080305000008,30,40,39,27,34,20,12,13,190,25,215,11.627906976744185
2784,330080305000009,33,36,28,41,23,40,23,23,201,46,247,18.62348178137652
2785,330080305000010,40,51,57,49,73,66,30,35,336,65,401,16.209476309226932
2786,330080305000011,117,124,139,150,128,101,53,42,759,95,854,11.124121779859484
2787,330080305000012,136,181,139,159,154,95,57,48,864,105,969,10.8359133126935
2788,330080305000013,91,126,132,102,111,106,81,60,668,141,809,17.428924598269468
2789,330080305000014,206,234,215,220,147,108,79,45,1130,124,1254,9.88835725677831
2790,330080305000015,143,166,155,162,132,85,56,23,843,79,922,8.568329718004339
2791,330080305000016,70,100,98,82,85,78,28,29,513,57,570,10.0
2792,330080305000017,52,83,74,55,73,61,38,34,398,72,470,15.319148936170214
2793,330080305000018,103,161,158,149,123,102,74,46,796,120,916,13.100436681222707
2794,330080305000019,66,70,108,93,83,53,49,44,473,93,566,16.431095406360424
2795,330080305000020,80,139,128,128,107,84,48,51,666,99,765,12.941176470588236
2796,330080305000021,50,75,78,98,84,106,50,41,491,91,582,15.63573883161512
2797,330080305000022,87,95,107,124,135,66,46,40,614,86,700,12.285714285714286
2798,330080305000023,28,37,52,50,47,45,27,35,259,62,321,19.314641744548286
2799,330080305000024,5,6,4,2,3,4,1,2,24,3,27,11.11111111111111
2800,330080305000025,44,62,45,42,34,22,19,16,249,35,284,12.32394366197183
2801,330080305000026,4,1,3,3,4,4,4,0,19,4,23,17.391304347826086
2802,330080305000027,21,22,31,21,13,19,11,15,127,26,153,16.99346405228758
2803,330080305000028,1,3,3,6,4,0,2,1,17,3,20,15.0
2804,330080305000029,1,0,2,3,3,6,1,0,15,1,16,6.25
2805,330080305000030,36,53,34,67,47,49,25,6,286,31,317,9.779179810725552
2806,330080305000031,17,8,18,12,11,6,6,4,72,10,82,12.195121951219512
2807,330080305000032,60,71,76,69,66,64,31,18,406,49,455,10.76923076923077
2808,330080305000033,65,80,87,86,78,65,49,41,461,90,551,16.33393829401089
2809,330080305000034,70,119,100,103,90,73,43,31,555,74,629,11.764705882352942
2810,330080305000035,110,111,125,97,85,69,32,43,597,75,672,11.160714285714286
2811,330080305000036,26,44,36,52,57,60,46,30,275,76,351,21.65242165242165
2812,330080305000037,69,82,91,79,54,37,26,10,412,36,448,8.035714285714286
2813,330080305000038,31,38,53,48,40,46,28,26,256,54,310,17.419354838709676
2814,330080305000039,15,20,22,15,26,10,7,10,108,17,125,13.6
2815,330080305000040,81,113,88,113,94,49,42,18,538,60,598,10.033444816053512
2816,330080305000041,94,117,99,109,93,57,34,19,569,53,622,8.520900321543408
2817,330080305000042,58,75,76,69,71,57,40,25,406,65,471,13.800424628450106
2818,330080310000001,62,115,80,100,74,61,59,27,492,86,578,14.878892733564014
2819,330080310000002,113,139,106,129,141,82,49,43,710,92,802,11.471321695760599
2820,330080310000003,47,46,54,43,32,35,13,23,257,36,293,12.286689419795222
2821,330080310000004,11,6,5,11,8,6,5,3,47,8,55,14.545454545454545
2822,330080310000005,93,102,103,99,86,72,50,53,555,103,658,15.653495440729483
2823,330080310000006,9,16,21,1,21,6,1,1,74,2,76,2.6315789473684212
2824,330080310000007,64,105,84,89,53,54,34,22,449,56,505,11.089108910891088
2825,330080310000008,52,67,62,58,49,48,33,26,336,59,395,14.936708860759493
2826,330080310000009,45,99,50,97,75,51,32,18,417,50,467,10.70663811563169
2827,330080310000010,144,181,148,152,114,93,44,33,832,77,909,8.47084708470847
2828,330080310000011,82,95,94,91,80,46,37,24,488,61,549,11.11111111111111
2829,330080310000012,122,126,128,111,112,106,59,46,705,105,810,12.962962962962964
2830,330080310000013,95,109,135,118,96,92,63,53,645,116,761,15.243101182654403
2831,330080310000014,85,87,90,96,80,48,29,18,486,47,533,8.818011257035648
2832,330080310000015,93,131,119,139,91,61,44,22,634,66,700,9.428571428571429
2833,330080310000016,134,190,175,145,138,94,46,49,876,95,971,9.783728115345005
2834,330080310000017,102,104,93,86,73,54,27,17,512,44,556,7.913669064748201
2835,330080310000018,108,132,124,137,118,70,56,50,689,106,795,13.333333333333334
2836,330080310000019,55,53,73,65,66,39,23,16,351,39,390,10.0
2837,330080310000020,103,128,101,107,97,56,27,30,592,57,649,8.782742681047766
2838,330080310000021,66,62,49,51,43,38,26,20,309,46,355,12.95774647887324
2839,330080310000022,64,54,45,40,30,28,14,15,261,29,290,10.0
2840,330080310000023,11,13,9,5,13,3,7,7,54,14,68,20.58823529411765
2841,330080310000024,101,138,138,119,111,91,59,29,698,88,786,11.195928753180661
2842,330080310000025,150,180,175,167,135,91,60,66,898,126,1024,12.3046875
2843,330080310000026,134,193,187,150,151,87,44,39,902,83,985,8.426395939086294
2844,330080310000027,7,7,25,7,10,14,7,10,70,17,87,19.54022988505747
2845,330080310000028,2,5,2,2,3,2,1,4,16,5,21,23.80952380952381
2846,330080310000029,22,41,24,22,21,6,18,13,136,31,167,18.562874251497007
2847,330080310000030,14,24,17,21,24,10,17,13,110,30,140,21.428571428571427
2848,330080310000031,116,142,112,138,79,68,34,24,655,58,713,8.134642356241235
2849,330080310000032,53,81,67,68,72,27,21,16,368,37,405,9.135802469135802
2850,330080310000033,50,68,54,47,46,34,15,8,299,23,322,7.142857142857143
2851,330080310000034,36,45,32,30,31,19,6,4,193,10,203,4.926108374384237
2852,330080310000035,4,2,5,6,1,0,2,0,18,2,20,10.0
2853,330080310000036,54,66,67,56,39,49,27,23,331,50,381,13.123359580052494
2854,330080310000037,16,20,20,24,16,9,12,8,105,20,125,16.0
2855,330080310000038,20,27,18,23,21,11,9,4,120,13,133,9.774436090225564
2856,330080310000039,73,82,76,104,51,58,37,19,444,56,500,11.2
2857,330080310000040,89,118,117,87,114,98,48,51,623,99,722,13.71191135734072
2858,330080310000041,130,169,164,189,145,108,67,56,905,123,1028,11.964980544747082
2859,330080310000042,55,97,73,90,95,67,37,42,477,79,556,14.20863309352518
2860,330080310000043,91,107,91,93,78,67,48,31,527,79,606,13.036303630363037
2861,330080310000044,102,122,117,92,94,67,35,34,594,69,663,10.407239819004525
2862,330080310000045,87,140,110,101,96,57,42,31,591,73,664,10.993975903614459
2863,330080310000046,96,135,141,119,106,77,31,27,674,58,732,7.923497267759563
2864,330080310000047,63,91,67,79,74,33,16,23,407,39,446,8.74439461883408
2865,330080310000048,82,105,118,87,85,66,40,26,543,66,609,10.83743842364532
2866,330080310000049,302,359,335,259,225,155,104,77,1635,181,1816,9.966960352422907
2867,330080310000050,141,192,139,143,116,85,51,34,816,85,901,9.433962264150944
2868,330080315000001,40,51,57,43,51,42,17,29,284,46,330,13.93939393939394
2869,330080315000002,35,45,36,31,24,15,9,13,186,22,208,10.576923076923077
2870,330080315000003,172,230,187,177,155,87,60,44,1008,104,1112,9.352517985611511
2871,330080315000004,85,113,89,99,81,73,36,20,540,56,596,9.395973154362416
2872,330080315000005,13,23,18,16,13,11,3,6,94,9,103,8.737864077669903
2873,330080315000006,111,137,112,127,93,74,57,27,654,84,738,11.382113821138212
2874,330080315000007,52,62,72,53,62,45,25,16,346,41,387,10.594315245478036
2875,330080315000008,35,31,54,40,21,24,12,8,205,20,225,8.88888888888889
2876,330080315000009,17,28,34,20,12,13,10,13,124,23,147,15.646258503401361
2877,330080315000010,11,19,9,14,12,8,4,5,73,9,82,10.975609756097562
2878,330080315000011,20,51,28,40,32,34,19,7,205,26,231,11.255411255411255
2879,330080315000012,90,113,78,97,78,61,62,33,517,95,612,15.522875816993464
2880,330080315000013,15,14,17,13,16,13,8,4,88,12,100,12.0
2881,330080315000014,43,49,52,25,49,27,17,16,245,33,278,11.870503597122303
2882,330080315000015,73,65,71,96,52,37,29,23,394,52,446,11.659192825112108
2883,330080315000016,70,93,68,66,61,59,30,24,417,54,471,11.464968152866241
2884,330090205000001,85,110,121,114,137,99,103,79,666,182,848,21.462264150943398
2885,330090205000002,124,128,137,148,139,110,69,51,786,120,906,13.245033112582782
2886,330090205000003,24,42,28,50,55,37,44,53,236,97,333,29.12912912912913
2887,330090205000004,89,95,112,86,95,74,51,43,551,94,645,14.573643410852712
2888,330090205000005,111,161,162,156,131,77,68,47,798,115,913,12.595837897042717
2889,330090205000006,64,86,100,91,81,70,43,42,492,85,577,14.731369150779896
2890,330090205000007,87,110,113,111,92,103,69,52,616,121,737,16.417910447761194
2891,330090205000008,39,50,53,49,59,53,23,26,303,49,352,13.920454545454545
2892,330090205000009,39,37,44,38,51,48,21,20,257,41,298,13.758389261744966
2893,330090205000010,22,49,25,30,43,19,23,15,188,38,226,16.8141592920354
2894,330090205000011,59,79,73,74,53,38,22,23,376,45,421,10.688836104513063
2895,330090205000012,48,91,75,99,85,65,38,40,463,78,541,14.417744916820702
2896,330090207000001,41,43,42,45,45,42,24,18,258,42,300,14.0
2897,330090207000002,49,55,52,42,52,47,30,34,297,64,361,17.72853185595568
2898,330090210000001,65,77,95,79,90,75,55,51,481,106,587,18.05792163543441
2899,330090210000002,70,83,93,95,84,88,33,50,513,83,596,13.926174496644295
2900,330090210000003,82,80,82,90,86,85,50,48,505,98,603,16.25207296849088
2901,330090215000001,31,56,48,43,61,68,46,56,307,102,409,24.938875305623473
2902,330090215000002,17,14,16,13,20,9,3,7,89,10,99,10.1010101010101
2903,330090215000003,7,12,10,11,16,5,0,7,61,7,68,10.294117647058824
2904,330090220000001,50,67,62,49,79,66,42,55,373,97,470,20.638297872340427
2905,330090220000002,61,84,68,91,61,64,38,39,429,77,506,15.217391304347826
2906,330090220000003,107,137,125,153,139,100,96,83,761,179,940,19.04255319148936
2907,330090220000004,153,168,168,160,127,101,76,83,877,159,1036,15.347490347490348
2908,330090220000005,90,95,96,126,125,109,73,68,641,141,782,18.0306905370844
2909,330090220000006,16,13,17,21,17,13,14,14,97,28,125,22.4
2910,330090220000007,17,17,21,16,15,22,8,14,108,22,130,16.923076923076923
2911,330090230000001,61,69,73,61,81,71,59,52,416,111,527,21.062618595825427
2912,330090230000002,57,76,46,68,67,68,57,52,382,109,491,22.19959266802444
2914,330093605010001,137,156,199,156,153,112,57,43,913,100,1013,9.871668311944719
2915,330093605010002,75,144,135,145,112,71,52,44,682,96,778,12.339331619537274
2916,330093605010003,56,68,70,78,51,32,39,8,355,47,402,11.691542288557214
2917,330093605010004,62,63,79,59,53,54,32,21,370,53,423,12.529550827423169
2918,330093605010005,95,127,196,147,143,98,56,37,806,93,899,10.344827586206897
2919,330093605010006,129,150,174,171,126,95,46,33,845,79,924,8.54978354978355
2920,330093605010007,130,110,103,97,81,55,23,22,576,45,621,7.246376811594203
2921,330093605010008,92,131,121,114,82,64,53,37,604,90,694,12.968299711815561
2922,330093605010009,79,100,84,84,77,61,38,37,485,75,560,13.392857142857142
2924,330093605010011,7,10,13,11,9,12,7,3,62,10,72,13.88888888888889
2925,330093605010012,9,9,7,14,16,13,7,9,68,16,84,19.047619047619047
2926,330093605010013,12,14,28,16,24,19,7,7,113,14,127,11.023622047244094
2927,330093605010014,3,11,4,10,4,2,3,3,34,6,40,15.0
2928,330093605010015,46,35,32,36,21,16,12,3,186,15,201,7.462686567164179
2930,330093605010017,72,89,101,86,80,59,41,33,487,74,561,13.190730837789662
2931,330093605010018,116,141,103,133,107,63,50,40,663,90,753,11.952191235059761
2932,330093605020001,93,113,128,101,106,52,39,35,593,74,667,11.094452773613193
2933,330093605020002,197,192,197,203,168,111,56,33,1068,89,1157,7.6923076923076925
2934,330093605020003,92,154,136,123,110,79,51,42,694,93,787,11.81702668360864
2935,330093605020004,28,32,12,23,19,12,8,9,126,17,143,11.888111888111888
2936,330093605020005,22,35,24,30,26,20,17,9,157,26,183,14.207650273224044
2937,330093605020006,36,29,23,18,29,29,18,7,164,25,189,13.227513227513228
2938,330093605020007,8,4,2,8,4,4,3,3,30,6,36,16.666666666666668
2939,330093605020008,31,28,25,25,21,13,9,6,143,15,158,9.49367088607595
2940,330093605030001,35,48,45,39,37,27,11,20,231,31,262,11.83206106870229
2941,330093605030002,86,130,83,94,77,77,46,26,547,72,619,11.631663974151857
2942,330093605030003,38,39,43,26,35,46,33,23,227,56,283,19.78798586572438
2943,330093605030004,82,104,86,72,99,61,44,36,504,80,584,13.698630136986301
2945,330093605040002,4,10,10,10,12,12,5,3,58,8,66,12.121212121212121
2947,330095105000001,81,87,106,91,104,72,54,46,541,100,641,15.600624024960998
2948,330095105000002,49,103,136,95,104,119,78,74,606,152,758,20.052770448548813
2949,330095105000003,61,62,65,70,66,51,33,23,375,56,431,12.993039443155453
2950,330095105000004,127,132,130,118,104,62,54,29,673,83,756,10.97883597883598
2951,330095105000005,71,101,125,97,95,109,57,36,598,93,691,13.458755426917511
2952,330095105000006,117,118,109,126,100,63,73,45,633,118,751,15.712383488681757
2953,330095105000007,127,148,155,125,116,114,75,42,785,117,902,12.971175166297117
2954,330095105000008,80,80,74,75,63,78,35,18,450,53,503,10.536779324055667
2955,330095105000009,9,11,11,8,6,5,2,3,50,5,55,9.090909090909092
2956,330095105000010,11,16,10,17,12,4,7,10,70,17,87,19.54022988505747
2957,330095105000011,147,193,134,125,125,58,26,30,782,56,838,6.682577565632458
2958,330095105000012,55,81,42,64,70,41,26,21,353,47,400,11.75
2959,330095110000001,82,99,82,91,107,62,49,48,523,97,620,15.64516129032258
2960,330095110000002,81,84,84,87,85,68,43,39,489,82,571,14.360770577933451
2961,330095110000003,20,28,15,40,20,17,23,13,140,36,176,20.454545454545453
2962,330100905060001,70,105,135,107,107,130,75,84,654,159,813,19.55719557195572
2963,330100905060002,98,112,108,118,125,103,85,93,664,178,842,21.140142517814727
2964,330100905060003,76,122,93,87,122,89,68,65,589,133,722,18.42105263157895
2965,330100905060004,70,133,155,113,157,135,94,111,763,205,968,21.177685950413224
2966,330100905060005,102,165,160,170,196,175,112,89,968,201,1169,17.194183062446534
2967,330100905060006,100,135,160,136,164,156,88,103,851,191,1042,18.330134357005758
2968,330100905060007,64,101,130,97,160,108,81,121,660,202,862,23.4338747099768
2969,330100905060008,27,57,82,53,52,53,49,36,324,85,409,20.78239608801956
2970,330100905060009,38,48,148,59,67,75,41,33,435,74,509,14.538310412573674
2971,330100905060010,127,142,185,207,161,166,104,89,988,193,1181,16.342082980524978
2972,330100905060011,76,125,159,117,119,100,83,60,696,143,839,17.044100119189512
2973,330100905060012,63,73,92,113,83,69,50,57,493,107,600,17.833333333333332
2974,330100905060013,58,71,107,71,87,62,55,25,456,80,536,14.925373134328359
2975,330100905060014,24,38,52,46,57,48,39,40,265,79,344,22.96511627906977
2976,330100905060015,109,152,157,194,164,111,78,92,887,170,1057,16.08325449385052
2977,330100905060016,71,120,127,89,123,115,63,69,645,132,777,16.98841698841699
2978,330100905060017,44,67,81,60,76,69,49,52,397,101,498,20.281124497991968
2980,330100905060019,35,49,75,52,62,63,44,36,336,80,416,19.23076923076923
2981,330100905060020,62,85,192,133,99,92,71,68,663,139,802,17.331670822942645
2982,330100905060021,13,57,77,33,47,70,51,60,297,111,408,27.205882352941178
2983,330100905060022,16,43,82,40,61,58,50,59,300,109,409,26.65036674816626
2984,330100905060023,45,135,120,103,135,96,51,78,634,129,763,16.90694626474443
2985,330100905060024,68,105,135,103,103,112,64,70,626,134,760,17.63157894736842
2986,330100905060025,34,53,115,70,46,35,18,5,353,23,376,6.117021276595745
2987,330100905060026,29,47,52,56,45,42,31,29,271,60,331,18.12688821752266
2988,330100905060027,52,80,90,64,80,86,48,56,452,104,556,18.705035971223023
2989,330100905060028,72,115,128,127,109,124,70,63,675,133,808,16.46039603960396
2990,330100905060029,125,159,185,133,98,99,63,74,799,137,936,14.636752136752136
2991,330100905060030,74,90,108,72,53,26,25,20,423,45,468,9.615384615384615
2992,330100905060031,80,88,172,87,83,83,62,51,593,113,706,16.005665722379604
2993,330100905060032,98,84,68,54,33,23,16,16,360,32,392,8.16326530612245
2994,330100905060033,52,48,41,29,24,19,4,9,213,13,226,5.752212389380531
2995,330100905060034,88,109,113,85,89,77,26,45,561,71,632,11.234177215189874
2996,330100905060035,77,102,109,107,84,100,62,53,579,115,694,16.570605187319885
2997,330100905060036,86,158,156,130,152,138,95,101,820,196,1016,19.291338582677167
2998,330100905060037,46,77,74,76,67,65,31,25,405,56,461,12.147505422993492
2999,330100905060038,79,108,95,96,92,84,42,48,554,90,644,13.975155279503106
3000,330100905060039,70,102,130,87,108,128,83,73,625,156,781,19.97439180537772
3001,330100905060040,73,72,103,80,84,61,39,24,473,63,536,11.753731343283581
3002,330100905060041,339,320,333,396,344,183,84,51,1915,135,2050,6.585365853658536
3003,330100905060042,110,111,152,136,127,112,71,80,748,151,899,16.796440489432705
3004,330100905060043,110,157,166,125,154,114,93,79,826,172,998,17.23446893787575
3005,330100905060044,83,132,133,109,106,83,53,66,646,119,765,15.555555555555555
3006,330100905060045,81,100,142,145,94,107,81,44,669,125,794,15.743073047858942
3007,330100905060046,116,150,121,146,99,81,64,33,713,97,810,11.975308641975309
3008,330100905060047,90,80,128,104,71,85,61,55,558,116,674,17.2106824925816
3009,330100905060048,40,55,43,35,16,18,13,3,207,16,223,7.174887892376682
3010,330100905060049,23,27,24,32,16,11,11,3,133,14,147,9.523809523809524
3011,330100905060050,91,85,86,90,67,71,36,31,490,67,557,12.028725314183124
3012,330100905060051,82,138,169,112,140,114,69,68,755,137,892,15.358744394618833
3013,330100905060052,99,133,128,134,127,92,70,60,713,130,843,15.421115065243178
3014,330100905060053,80,102,106,100,95,62,74,51,545,125,670,18.65671641791045
3015,330100905060054,117,232,153,168,119,83,74,26,872,100,972,10.2880658436214
3016,330100905060055,95,125,124,111,131,121,91,92,707,183,890,20.56179775280899
3017,330100905060056,145,173,197,146,179,123,83,75,963,158,1121,14.094558429973238
3018,330100905060057,95,108,155,97,104,126,62,32,685,94,779,12.066752246469832
3019,330100905060058,140,168,193,168,158,120,79,76,947,155,1102,14.065335753176043
3020,330100905060059,60,125,185,140,97,109,80,70,716,150,866,17.321016166281755
3021,330100905060060,254,271,220,235,244,126,44,25,1350,69,1419,4.862579281183932
3022,330100905060061,252,258,169,122,88,55,39,20,944,59,1003,5.882352941176471
3023,330100905060062,107,118,99,105,93,62,39,19,584,58,642,9.034267912772586
3024,330100905060063,249,269,180,239,186,77,48,19,1200,67,1267,5.288082083662194
3025,330100905060064,175,237,188,218,176,106,72,65,1100,137,1237,11.075181891673404
3026,330100905060065,65,113,129,96,126,94,74,66,623,140,763,18.34862385321101
3027,330100905060066,108,164,136,123,149,111,60,65,791,125,916,13.646288209606986
3028,330100905060067,90,99,91,78,92,70,43,54,520,97,617,15.721231766612641
3029,330100905060068,127,119,137,120,116,78,65,53,697,118,815,14.478527607361963
3030,330100905060069,159,152,174,152,114,105,73,40,856,113,969,11.661506707946337
3031,330100905060070,254,278,223,174,124,67,47,26,1120,73,1193,6.119027661357921
3032,330100905060071,128,150,83,89,54,23,23,12,527,35,562,6.227758007117438
3033,330100905060072,136,154,191,135,104,140,67,29,860,96,956,10.0418410041841
3034,330100905060073,118,133,172,131,118,103,62,28,775,90,865,10.404624277456648
3035,330100905060074,106,140,156,125,114,96,51,37,737,88,825,10.666666666666666
3036,330100905060075,54,65,60,48,58,25,27,15,310,42,352,11.931818181818182
3037,330100905060076,258,243,256,210,182,131,75,49,1280,124,1404,8.831908831908832
3038,330100905060077,85,133,108,97,83,56,35,21,562,56,618,9.06148867313916
3039,330100905060078,178,190,158,120,104,82,40,20,832,60,892,6.726457399103139
3040,330100905060079,281,291,258,265,216,133,74,56,1444,130,1574,8.259212198221093
3041,330100905060080,198,237,201,159,160,94,35,23,1049,58,1107,5.239385727190605
3042,330100905060081,50,83,80,62,79,74,47,49,428,96,524,18.3206106870229
3043,330100905060082,47,76,214,131,114,83,36,31,665,67,732,9.153005464480874
3044,330100905060083,121,124,175,167,132,91,49,27,810,76,886,8.577878103837472
3045,330100905060084,117,101,160,202,112,69,22,19,761,41,802,5.112219451371571
3046,330100905060085,123,124,234,163,132,82,26,19,858,45,903,4.983388704318937
3047,330100905060086,308,329,389,323,329,252,104,41,1930,145,2075,6.9879518072289155
3048,330100905060087,165,193,199,183,163,160,86,53,1063,139,1202,11.56405990016639
3050,330100905060089,120,144,109,81,70,45,43,20,569,63,632,9.968354430379748
3051,330100905060090,70,78,54,44,48,37,30,16,331,46,377,12.20159151193634
3052,330100905060091,73,49,65,38,40,12,11,6,277,17,294,5.782312925170068
3053,330100905060092,41,65,111,69,83,58,19,16,427,35,462,7.575757575757576
3054,330100905060093,195,238,185,136,99,58,31,15,911,46,957,4.806687565308255
3055,330100905060094,26,32,20,32,20,8,10,10,138,20,158,12.658227848101266
3056,330100905060095,277,312,222,259,146,88,33,10,1304,43,1347,3.192279138827023
3057,330100905070001,34,66,71,76,80,69,42,42,396,84,480,17.5
3058,330100905070002,5,19,17,10,16,22,13,11,89,24,113,21.238938053097346
3059,330100905070003,36,63,176,83,73,66,43,46,497,89,586,15.187713310580206
3060,330100905070004,15,23,27,33,44,32,27,42,174,69,243,28.395061728395063
3061,330100905070005,53,94,97,95,73,87,61,106,499,167,666,25.075075075075077
3062,330100905070006,28,51,87,56,79,83,64,74,384,138,522,26.436781609195403
3063,330100905070007,104,98,134,137,129,85,51,77,687,128,815,15.705521472392638
3064,330100905070008,34,42,49,49,56,52,36,42,282,78,360,21.666666666666668
3065,330100905070009,90,136,176,128,186,141,107,136,857,243,1100,22.09090909090909
3066,330100905070010,71,115,135,117,121,110,51,62,669,113,782,14.450127877237852
3068,330100905070012,65,109,98,106,104,85,62,62,567,124,691,17.945007235890014
3069,330100905070013,51,69,94,86,88,90,55,49,478,104,582,17.869415807560138
3070,330100905070014,59,102,112,105,107,107,86,126,592,212,804,26.3681592039801
3071,330100905070015,26,46,56,51,67,67,56,58,313,114,427,26.697892271662763
3072,330100905070016,41,44,94,75,53,89,63,60,396,123,519,23.69942196531792
3073,330100905070017,27,33,67,43,48,33,35,39,251,74,325,22.76923076923077
3074,330100905070018,49,68,66,48,66,62,40,27,359,67,426,15.727699530516432
3075,330100905070019,46,77,75,66,71,73,51,56,408,107,515,20.776699029126213
3076,330100905070020,28,52,77,44,77,82,37,50,360,87,447,19.463087248322147
3077,330100905070021,97,121,164,181,167,142,94,107,872,201,1073,18.732525629077355
3078,330100905070022,63,101,117,99,107,123,84,108,610,192,802,23.940149625935163
3079,330100905070023,57,102,130,114,106,111,92,93,620,185,805,22.981366459627328
3080,330100905070024,68,93,155,101,124,117,79,111,658,190,848,22.40566037735849
3081,330100905070025,46,72,101,81,66,98,75,70,464,145,609,23.80952380952381
3082,330100905070026,77,97,123,107,113,122,70,70,639,140,779,17.971758664955072
3084,330100905070028,44,72,80,73,94,84,57,46,447,103,550,18.727272727272727
3085,330100905070029,63,77,79,83,57,49,34,21,408,55,463,11.879049676025918
3086,330100905070030,61,87,130,129,106,130,95,111,643,206,849,24.26383981154299
3087,330100905070031,38,59,76,53,85,72,54,71,383,125,508,24.606299212598426
3088,330100905070032,95,81,99,84,93,85,53,51,537,104,641,16.224648985959437
3089,330100905070033,36,48,49,48,62,56,40,43,299,83,382,21.727748691099478
3090,330100905070034,65,74,100,98,82,77,74,67,496,141,637,22.135007849293565
3091,330100905070035,119,125,135,111,87,78,77,72,655,149,804,18.53233830845771
3092,330100905070036,37,60,48,48,49,36,47,23,278,70,348,20.114942528735632
3093,330100905070037,97,148,142,109,150,142,91,80,788,171,959,17.831074035453597
3094,330100905070038,60,99,99,89,96,87,76,51,530,127,657,19.330289193302892
3095,330100905070039,55,78,87,69,91,56,62,51,436,113,549,20.58287795992714
3096,330100905070040,76,138,127,133,132,124,104,74,730,178,908,19.60352422907489
3097,330100905070041,93,105,141,132,130,116,74,61,717,135,852,15.845070422535212
3098,330100905070042,93,134,145,128,133,128,93,59,761,152,913,16.64841182913472
3099,330100905070043,22,34,30,33,29,27,18,16,175,34,209,16.267942583732058
3100,330100905070044,120,121,101,70,43,40,20,6,495,26,521,4.990403071017274
3101,330100905070045,32,34,23,17,11,8,9,1,125,10,135,7.407407407407407
3102,330100905070046,40,25,46,22,15,18,7,8,166,15,181,8.287292817679559
3103,330100905070047,83,107,110,77,104,82,54,51,563,105,668,15.718562874251496
3104,330100905070048,72,94,118,92,86,101,62,56,563,118,681,17.32745961820852
3105,330100905070049,38,58,84,55,70,72,48,32,377,80,457,17.505470459518598
3106,330100905070050,94,92,116,103,86,73,49,32,564,81,645,12.55813953488372
3107,330100905070051,61,99,89,75,90,78,59,35,492,94,586,16.040955631399317
3108,330100905070052,109,115,127,101,98,109,61,58,659,119,778,15.295629820051413
3109,330100905070053,114,134,123,134,116,100,78,82,721,160,881,18.161180476730987
3110,330100905070054,41,87,69,68,79,83,73,73,427,146,573,25.479930191972077
3111,330100905070055,78,98,137,109,114,102,72,59,638,131,769,17.035110533159948
3112,330100905070056,57,73,72,76,80,55,49,40,413,89,502,17.729083665338646
3113,330100905070057,119,134,160,183,165,133,92,81,894,173,1067,16.2136832239925
3114,330100905070058,64,93,93,89,92,100,45,49,531,94,625,15.04
3115,330100905070059,96,139,161,140,142,120,74,74,798,148,946,15.644820295983086
3116,330100905070060,68,93,95,63,94,72,49,34,485,83,568,14.612676056338028
3117,330100905070061,61,107,141,130,120,115,70,112,674,182,856,21.261682242990656
3118,330100905070062,75,128,115,112,126,105,65,72,661,137,798,17.167919799498748
3119,330100905070063,40,37,50,51,43,57,22,47,278,69,347,19.88472622478386
3120,330100905070064,79,110,102,110,102,110,60,51,613,111,724,15.331491712707182
3121,330100905070065,106,156,193,124,190,139,85,86,908,171,1079,15.848007414272475
3122,330100905070066,75,73,55,62,42,35,22,10,342,32,374,8.556149732620321
3123,330100905070067,69,96,113,89,82,70,46,42,519,88,607,14.497528830313016
3124,330100905070068,34,37,31,35,35,21,13,6,193,19,212,8.962264150943396
3125,330100905070069,124,146,129,144,121,108,85,63,772,148,920,16.08695652173913
3126,330100905070070,52,81,107,74,69,65,42,20,448,62,510,12.156862745098039
3127,330100905070071,66,88,81,80,80,81,48,47,476,95,571,16.637478108581437
3128,330100905070072,42,63,76,51,79,70,47,47,381,94,475,19.789473684210527
3129,330100905070073,79,115,173,108,123,139,57,62,737,119,856,13.901869158878505
3130,330100905070074,49,63,78,61,68,68,54,73,387,127,514,24.708171206225682
3131,330100905070075,65,83,107,73,78,98,56,58,504,114,618,18.446601941747574
3132,330100905070076,111,119,153,135,123,109,69,56,750,125,875,14.285714285714286
3133,330100905070077,53,59,69,83,64,69,55,27,397,82,479,17.11899791231733
3134,330100905070078,45,62,90,64,52,66,40,38,379,78,457,17.067833698030636
3135,330100905070079,0,0,0,0,0,2,11,51,2,62,64,96.875
3136,330100905070080,230,303,246,271,297,158,72,48,1505,120,1625,7.384615384615385
3137,330100905070081,97,57,75,135,77,30,12,5,471,17,488,3.4836065573770494
3138,330100905070082,159,190,173,168,180,91,52,42,961,94,1055,8.909952606635072
3139,330100905070083,99,125,101,96,117,92,53,58,630,111,741,14.979757085020243
3140,330100905070084,71,86,106,74,86,69,39,43,492,82,574,14.285714285714286
3141,330100905070085,118,142,169,117,130,109,75,51,785,126,911,13.830954994511526
3142,330100905070086,150,170,131,102,107,66,32,34,726,66,792,8.333333333333334
3143,330100905070087,299,298,274,173,182,137,46,37,1363,83,1446,5.739972337482711
3144,330100905070088,96,154,161,125,179,125,94,46,840,140,980,14.285714285714286
3145,330100905070089,54,97,104,86,88,72,35,16,501,51,552,9.23913043478261
3146,330100905070090,239,228,284,314,246,142,78,50,1453,128,1581,8.096141682479443
3147,330100905070091,86,95,131,89,109,83,55,62,593,117,710,16.47887323943662
3148,330100905070092,56,76,77,81,75,71,51,37,436,88,524,16.793893129770993
3149,330100905070093,94,130,101,82,119,85,71,74,611,145,756,19.17989417989418
3150,330100905070094,138,198,173,173,150,106,61,46,938,107,1045,10.239234449760765
3151,330100905070095,111,108,128,116,113,81,53,37,657,90,747,12.048192771084338
3152,330100905070096,110,115,164,134,94,89,84,56,706,140,846,16.548463356973997
3153,330100905070097,139,213,195,130,156,101,67,45,934,112,1046,10.707456978967496
3154,330100905070098,140,150,147,111,122,76,53,22,746,75,821,9.135200974421437
3155,330100905070099,148,187,222,141,155,126,50,39,979,89,1068,8.333333333333334
3156,330100905070100,131,147,157,109,119,116,57,48,779,105,884,11.877828054298643
3157,330100905070101,244,268,286,271,221,153,85,52,1443,137,1580,8.670886075949367
3158,330100905070102,151,179,170,154,140,97,67,58,891,125,1016,12.303149606299213
3159,330100905070103,8,7,14,11,4,7,0,0,51,0,51,0.0
3160,330100905070104,26,59,62,29,54,55,10,16,285,26,311,8.360128617363344
3161,330100905070105,70,81,79,73,68,52,29,34,423,63,486,12.962962962962964
3162,330100905070106,170,173,177,195,175,121,35,28,1011,63,1074,5.865921787709497
3163,330100905070107,42,50,56,48,57,39,27,22,292,49,341,14.36950146627566
3164,330100905070108,115,153,165,135,149,132,82,54,849,136,985,13.807106598984772
3165,330100905070109,66,84,100,102,116,85,52,51,553,103,656,15.701219512195122
3166,330100905070110,92,109,155,93,133,127,65,62,709,127,836,15.191387559808613
3167,330100905070111,84,98,115,134,124,100,74,54,655,128,783,16.347381864623244
3168,330100905070112,158,159,164,142,138,93,75,50,854,125,979,12.768130745658835
3169,330100905070113,62,94,93,82,69,73,51,27,473,78,551,14.156079854809438
3170,330100905070114,91,93,130,84,86,80,32,44,564,76,640,11.875
3171,330100905070115,86,109,105,104,92,65,59,36,561,95,656,14.481707317073171
3172,330100905070116,80,124,182,139,131,126,79,50,782,129,911,14.1602634467618
3173,330100905070117,85,86,115,116,114,94,55,76,610,131,741,17.67881241565452
3174,330100905070118,142,135,149,153,137,100,57,50,816,107,923,11.592632719393283
3175,330100905070119,30,37,25,40,39,24,12,12,195,24,219,10.95890410958904
3177,330100905070121,114,111,120,140,101,55,32,7,641,39,680,5.735294117647059
3178,330100905070122,167,207,144,185,138,66,30,27,907,57,964,5.912863070539419
3179,330100905070123,299,301,329,312,267,175,79,46,1683,125,1808,6.913716814159292
3180,330100905070124,38,38,28,33,23,16,14,7,176,21,197,10.65989847715736
3181,330100905070125,178,208,212,225,163,132,64,60,1118,124,1242,9.98389694041868
3182,330100905070126,173,194,156,233,162,98,40,17,1016,57,1073,5.312208760484623
3183,330100905070127,93,129,135,105,113,81,38,33,656,71,727,9.766162310866575
3184,330100905070128,271,300,211,227,191,125,68,42,1325,110,1435,7.665505226480836
3185,330100905070129,115,154,107,100,103,44,23,11,623,34,657,5.175038051750381
3186,330100905070130,244,265,228,247,250,135,78,44,1369,122,1491,8.18242790073776
3187,330100905070131,57,50,49,44,46,46,30,15,292,45,337,13.353115727002967
3188,330100905070132,116,133,127,107,118,86,54,41,687,95,782,12.148337595907929
3189,330100905070133,44,51,57,43,63,53,32,44,311,76,387,19.638242894056848
3191,330100905070135,46,48,45,61,37,48,32,20,285,52,337,15.43026706231454
3192,330100905070136,24,48,42,35,62,33,42,34,244,76,320,23.75
3193,330100905070137,65,55,109,93,62,75,49,46,459,95,554,17.14801444043321
3194,330100905070138,54,69,95,82,82,90,55,58,472,113,585,19.316239316239315
3195,330100905070139,41,69,83,81,70,78,38,48,422,86,508,16.929133858267715
3196,330100905070140,35,81,64,64,57,62,40,32,363,72,435,16.551724137931036
3197,330100905070141,38,37,70,54,47,45,39,33,291,72,363,19.834710743801654
3198,330100905070142,148,139,194,186,135,96,46,36,898,82,980,8.36734693877551
3199,330100905070143,35,75,81,55,60,48,46,30,354,76,430,17.674418604651162
3200,330100905070144,82,83,129,122,89,64,42,25,569,67,636,10.534591194968554
3201,330100905070145,44,52,71,57,57,71,37,47,352,84,436,19.26605504587156
3202,330100905070146,47,62,73,53,77,49,46,32,361,78,439,17.767653758542142
3203,330100905070147,64,66,79,67,66,60,49,50,402,99,501,19.760479041916167
3204,330100905070148,120,92,173,164,131,123,91,60,803,151,954,15.828092243186584
3205,330100905070149,65,95,116,123,128,54,57,22,581,79,660,11.969696969696969
3206,330100905070150,107,117,120,96,113,87,44,36,640,80,720,11.11111111111111
3207,330100905070151,61,79,100,101,82,71,37,20,494,57,551,10.344827586206897
3208,330100905070152,67,95,69,52,75,50,13,28,408,41,449,9.131403118040089
3209,330100905070153,43,63,67,46,37,28,28,14,284,42,326,12.883435582822086
3210,330100905070154,70,64,89,125,72,51,16,13,471,29,500,5.8
3211,330100905070155,40,40,27,78,49,28,18,18,262,36,298,12.080536912751677
3212,330100905070156,55,74,74,95,68,34,20,25,400,45,445,10.112359550561798
3213,330100905070157,105,107,100,104,77,59,27,15,552,42,594,7.070707070707071
3214,330100905070158,70,79,74,89,67,39,20,9,418,29,447,6.487695749440716
3215,330100905070159,120,162,168,135,149,107,56,46,841,102,943,10.816542948038176
3216,330100905070160,20,12,31,28,10,8,5,1,109,6,115,5.217391304347826
3217,330100905070161,178,182,142,166,139,68,38,24,875,62,937,6.616862326574173
3218,330100905070162,127,115,118,112,84,58,28,18,614,46,660,6.96969696969697
3219,330100905070163,116,91,97,80,68,42,23,6,494,29,523,5.544933078393881
3220,330100905070165,158,219,165,120,126,77,27,21,865,48,913,5.257393209200438
3221,330100905070166,119,124,87,92,82,51,24,17,555,41,596,6.879194630872483
3222,330100905080001,140,150,172,146,161,160,65,64,929,129,1058,12.19281663516068
3223,330100905080002,47,76,80,52,64,80,51,38,399,89,488,18.237704918032787
3224,330100905080003,56,61,49,38,31,19,3,10,254,13,267,4.868913857677903
3225,330100905080004,112,140,178,154,148,136,102,78,868,180,1048,17.17557251908397
3226,330100905080005,101,118,113,98,118,83,57,64,631,121,752,16.090425531914892
3227,330100905080006,136,185,187,153,157,152,65,59,970,124,1094,11.3345521023766
3228,330100905080007,82,103,90,89,110,98,70,60,572,130,702,18.51851851851852
3229,330100905080008,31,75,54,65,50,33,18,9,308,27,335,8.059701492537313
3230,330100905080009,115,111,139,83,75,74,45,23,597,68,665,10.225563909774436
3231,330100905080010,92,88,103,102,67,88,44,22,540,66,606,10.891089108910892
3232,330100905080011,109,97,152,115,127,105,53,31,705,84,789,10.64638783269962
3233,330100905080012,67,91,111,75,98,78,42,39,520,81,601,13.477537437603994
3234,330100905080013,58,102,119,78,83,92,56,62,532,118,650,18.153846153846153
3235,330100905080014,113,143,131,142,139,105,70,68,773,138,911,15.148188803512623
3236,330100905080015,126,140,177,150,148,134,105,74,875,179,1054,16.98292220113852
3237,330100905080016,51,77,80,69,75,68,38,44,420,82,502,16.334661354581673
3238,330100905080017,58,62,66,51,54,40,19,20,331,39,370,10.54054054054054
3239,330100905080018,58,63,75,53,37,30,23,13,316,36,352,10.227272727272727
3240,330100905080019,91,97,98,93,68,74,33,27,521,60,581,10.327022375215146
3241,330100905080020,55,73,74,60,52,40,26,15,354,41,395,10.379746835443038
3242,330100905080021,129,142,102,146,105,52,33,29,676,62,738,8.401084010840108
3243,330100905080022,102,109,90,73,57,40,37,23,471,60,531,11.299435028248588
3244,330100905080023,35,45,35,32,40,39,6,15,226,21,247,8.502024291497976
3245,330100905080024,12,25,23,7,8,10,4,3,85,7,92,7.608695652173913
3246,330100905080025,84,107,73,93,81,50,29,22,488,51,539,9.461966604823747
3247,330100905080026,118,138,105,95,103,46,39,40,605,79,684,11.549707602339181
3248,330100905080027,109,130,121,104,111,78,58,35,653,93,746,12.466487935656836
3249,330100905080028,121,129,130,129,107,91,41,26,707,67,774,8.656330749354005
3250,330100905080029,188,222,202,222,189,131,82,73,1154,155,1309,11.841100076394195
3251,330100905080030,90,130,126,117,115,89,65,33,667,98,765,12.81045751633987
3252,330100905080031,130,192,189,152,152,139,91,60,954,151,1105,13.665158371040723
3253,330100905080032,130,101,155,235,121,104,85,72,846,157,1003,15.653040877367896
3254,330100905080033,97,118,119,109,82,74,32,28,599,60,659,9.104704097116844
3255,330100905080034,131,110,123,122,74,53,37,30,613,67,680,9.852941176470589
3256,330100905080035,7,14,8,9,7,6,3,3,51,6,57,10.526315789473685
3257,330100905080036,98,125,113,95,69,58,46,30,558,76,634,11.987381703470032
3258,330100905080037,137,192,152,154,112,73,50,22,820,72,892,8.071748878923767
3259,330100905080038,176,206,145,131,117,60,37,29,835,66,901,7.32519422863485
3260,330100905080039,119,136,143,105,110,66,41,23,679,64,743,8.613728129205922
3261,330100905080040,118,129,117,130,70,49,44,16,613,60,673,8.915304606240714
3262,330100905080041,124,150,137,102,126,64,52,36,703,88,791,11.125158027812896
3263,330100905080042,185,268,187,186,159,94,49,44,1079,93,1172,7.935153583617748
3264,330100905080043,406,427,438,392,313,203,90,74,2179,164,2343,6.9995731967562955
3265,330100905080044,169,191,161,144,117,88,62,37,870,99,969,10.21671826625387
3266,330100905080045,141,164,157,157,128,133,80,60,880,140,1020,13.72549019607843
3267,330100905080046,169,158,220,149,131,132,57,51,959,108,1067,10.121836925960638
3268,330100905080047,143,100,105,72,73,70,22,24,563,46,609,7.553366174055829
3269,330100905080048,34,33,28,19,16,10,5,7,140,12,152,7.894736842105263
3270,330100905080049,129,144,159,115,104,66,54,36,717,90,807,11.152416356877323
3271,330100905080050,169,170,192,163,161,117,78,53,972,131,1103,11.876699909338168
3272,330100905080051,353,367,311,272,266,144,78,60,1713,138,1851,7.455429497568882
3273,330100905080052,114,125,131,104,102,95,51,30,671,81,752,10.77127659574468
3274,330100905080053,138,188,184,150,176,121,82,58,957,140,1097,12.76207839562443
3275,330100905080054,115,130,143,126,80,68,37,25,662,62,724,8.56353591160221
3276,330100905080055,100,124,104,90,99,60,27,17,577,44,621,7.085346215780999
3277,330100905080056,210,253,223,207,178,121,51,41,1192,92,1284,7.165109034267913
3278,330100905080057,119,132,120,101,88,55,26,21,615,47,662,7.099697885196375
3279,330100905080058,126,151,140,147,123,100,57,41,787,98,885,11.073446327683616
3280,330100905080059,97,135,103,109,111,77,38,38,632,76,708,10.734463276836157
3281,330100905080060,103,117,122,117,88,71,51,50,618,101,719,14.047287899860917
3282,330100905080061,140,146,162,128,124,74,46,34,774,80,854,9.36768149882904
3283,330100905080062,79,118,110,81,115,74,39,38,577,77,654,11.773700305810397
3284,330100905080063,91,106,130,88,105,82,39,41,602,80,682,11.730205278592376
3285,330100905080064,59,98,93,115,81,69,26,25,515,51,566,9.010600706713781
3286,330100905080065,101,129,155,112,120,132,41,48,749,89,838,10.620525059665871
3287,330100905080066,154,157,160,130,117,69,33,42,787,75,862,8.700696055684455
3288,330100905080067,86,106,90,87,84,47,30,28,500,58,558,10.394265232974911
3289,330100905080068,555,542,439,320,276,179,80,53,2311,133,2444,5.44189852700491
3290,330100905080069,96,87,84,81,63,37,35,19,448,54,502,10.756972111553784
3291,330100905080070,30,27,18,22,4,10,6,3,111,9,120,7.5
3292,330100905080071,165,163,126,152,88,70,43,29,764,72,836,8.61244019138756
3293,330100905080072,109,136,130,115,117,69,34,29,676,63,739,8.525033829499323
3294,330100905080073,129,117,133,109,72,50,40,21,610,61,671,9.090909090909092
3295,330100905080074,123,112,110,118,74,47,33,17,584,50,634,7.886435331230284
3296,330100905080075,129,158,104,87,94,61,30,29,633,59,692,8.526011560693641
3297,330100905080076,251,254,212,145,128,71,47,24,1061,71,1132,6.27208480565371
3298,330100905080077,6,2,4,2,3,3,0,2,20,2,22,9.090909090909092
3299,330100905080078,113,147,167,132,118,77,52,31,754,83,837,9.91636798088411
3300,330100905080079,124,132,144,111,108,66,44,42,685,86,771,11.154345006485084
3301,330100905080080,175,194,142,157,112,66,60,20,846,80,926,8.639308855291576
3302,330100905080081,132,155,135,137,102,69,49,27,730,76,806,9.429280397022332
3303,330100905080082,7,8,7,5,2,3,0,0,32,0,32,0.0
3304,330100905080083,107,119,131,97,110,74,37,33,638,70,708,9.887005649717514
3305,330100905080084,49,96,85,66,86,61,35,26,443,61,504,12.103174603174603
3306,330100905080085,58,78,87,66,72,50,29,29,411,58,469,12.366737739872068
3307,330100905080086,149,178,175,172,144,106,60,42,924,102,1026,9.941520467836257
3308,330100905080087,122,184,149,129,147,82,48,24,813,72,885,8.135593220338983
3309,330100905080088,2,5,3,3,9,2,1,1,24,2,26,7.6923076923076925
3310,330100905080089,97,111,114,92,114,63,40,46,591,86,677,12.703101920236337
3311,330100905080090,59,125,74,86,119,46,43,44,509,87,596,14.59731543624161
3312,330100905080091,62,66,75,81,72,45,45,38,401,83,484,17.14876033057851
3313,330100905080092,88,102,125,95,108,78,41,50,596,91,687,13.24599708879185
3314,330100905080093,204,220,210,192,176,125,54,58,1127,112,1239,9.03954802259887
3315,330100905080094,124,178,136,123,124,85,35,46,770,81,851,9.518213866039954
3316,330100905080095,74,130,96,86,88,71,27,33,545,60,605,9.917355371900827
3317,330100905080096,184,171,205,158,129,91,53,48,938,101,1039,9.720885466794995
3318,330100905080097,54,69,50,44,50,37,35,31,304,66,370,17.83783783783784
3319,330100905080098,126,121,130,100,98,68,46,31,643,77,720,10.694444444444445
3320,330100905080099,142,180,150,157,147,88,90,43,864,133,997,13.340020060180542
3321,330100905080100,71,60,75,58,36,29,15,10,329,25,354,7.062146892655368
3322,330100905080101,139,176,128,117,108,75,59,27,743,86,829,10.37394451145959
3323,330100905080102,153,173,134,135,64,65,33,27,724,60,784,7.653061224489796
3324,330100905080103,144,177,169,149,119,101,48,24,859,72,931,7.733619763694952
3325,330100905080104,129,128,128,136,98,40,32,17,659,49,708,6.9209039548022595
3326,330100905080105,180,233,168,130,130,84,47,43,925,90,1015,8.866995073891626
3327,330100905080106,101,114,114,88,58,40,33,15,515,48,563,8.52575488454707
3328,330100905080107,147,154,148,129,98,105,42,26,781,68,849,8.00942285041225
3329,330100905080108,132,155,127,128,96,41,24,11,679,35,714,4.901960784313726
3330,330100905080109,150,204,140,121,127,79,32,28,821,60,881,6.810442678774121
3331,330100905080110,190,157,116,107,77,31,20,14,678,34,712,4.775280898876405
3332,330100905080111,324,337,238,205,157,89,34,32,1350,66,1416,4.661016949152542
3333,330100905080112,173,214,189,139,119,76,41,21,910,62,972,6.378600823045267
3334,330100905080113,121,132,107,95,63,45,41,24,563,65,628,10.35031847133758
3335,330100905080114,94,96,90,65,57,46,25,18,448,43,491,8.75763747454175
3336,330100905080115,16,13,13,16,16,7,4,7,81,11,92,11.956521739130435
3337,330100905080116,378,385,340,335,237,153,77,48,1828,125,1953,6.400409626216078
3338,330100905080117,96,105,97,69,66,37,37,25,470,62,532,11.654135338345865
3339,330100905080118,45,69,57,40,37,28,19,10,276,29,305,9.508196721311476
3340,330100905080119,458,542,414,330,213,124,85,67,2081,152,2233,6.806986117330945
3341,330100905080120,122,184,156,128,115,92,36,27,797,63,860,7.325581395348837
3342,330100905080121,287,317,287,240,208,115,62,43,1454,105,1559,6.735086593970494
3343,330100905080122,68,79,58,58,41,21,19,13,325,32,357,8.96358543417367
3344,330100905080123,104,118,94,68,45,33,18,9,462,27,489,5.521472392638037
3345,330100905080124,200,210,176,153,97,76,51,35,912,86,998,8.617234468937875
3346,330100905080125,390,432,364,337,274,197,119,79,1994,198,2192,9.032846715328468
3347,330100905080126,350,345,275,168,119,82,37,19,1339,56,1395,4.014336917562724
3348,330100905080127,155,202,173,182,191,124,81,63,1027,144,1171,12.297181895815543
3349,330100905080128,87,129,112,101,98,82,35,29,609,64,673,9.50965824665676
3350,330100905080129,123,117,122,88,81,68,31,21,599,52,651,7.987711213517665
3351,330100905080130,112,106,119,86,87,86,32,25,596,57,653,8.728943338437979
3352,330100905080131,140,138,97,112,92,53,23,32,632,55,687,8.005822416302765
3353,330100905080132,136,154,168,127,91,81,38,24,757,62,819,7.57020757020757
3354,330100905080133,101,117,119,90,98,44,33,21,569,54,623,8.667736757624398
3355,330100905080134,151,173,157,128,134,63,34,39,806,73,879,8.304891922639364
3356,330100905080135,93,112,103,77,63,51,29,29,499,58,557,10.412926391382406
3357,330100905080136,207,212,208,164,130,69,27,16,990,43,1033,4.162633107454018
3358,330100905080137,420,427,349,256,228,129,63,30,1809,93,1902,4.889589905362776
3359,330100905080138,227,243,179,197,103,87,67,32,1036,99,1135,8.722466960352422
3360,330100905080139,153,206,145,145,103,88,36,19,840,55,895,6.145251396648045
3361,330100905080140,74,100,90,77,68,35,16,11,444,27,471,5.732484076433121
3362,330100905080141,59,87,81,48,53,51,28,16,379,44,423,10.401891252955084
3363,330100905080142,31,45,36,25,35,41,13,9,213,22,235,9.361702127659575
3364,330100905080143,53,71,70,67,49,64,36,28,374,64,438,14.61187214611872
3365,330100905080144,113,102,113,106,99,85,45,44,618,89,707,12.58840169731259
3366,330100905080145,84,97,94,72,84,62,25,37,493,62,555,11.17117117117117
3367,330100905080146,123,107,119,139,76,90,47,32,654,79,733,10.77762619372442
3368,330100905080147,121,140,116,97,117,58,37,30,649,67,716,9.35754189944134
3369,330100905080148,101,103,90,87,84,51,29,20,516,49,565,8.672566371681416
3370,330100905080149,106,98,109,91,99,55,34,30,558,64,622,10.289389067524116
3371,330100905080150,179,207,164,152,116,80,43,21,898,64,962,6.652806652806653
3372,330100905080151,92,131,93,104,95,61,26,43,576,69,645,10.69767441860465
3373,330100905080152,67,110,88,85,83,49,52,45,482,97,579,16.753022452504318
3374,330100905080153,107,90,102,91,77,58,32,22,525,54,579,9.32642487046632
3375,330100905080154,63,78,82,57,54,46,24,24,380,48,428,11.214953271028037
3376,330100905080155,65,83,81,66,51,36,20,19,382,39,421,9.263657957244655
3377,330100905080156,521,499,525,521,386,235,85,101,2687,186,2873,6.474068917507831
3378,330100905080157,38,36,35,29,23,23,12,6,184,18,202,8.910891089108912
3379,330100905080158,57,92,107,74,79,75,36,24,484,60,544,11.029411764705882
3380,330100905080159,135,168,119,137,88,78,52,38,725,90,815,11.042944785276074
3381,330100905080160,153,220,178,142,131,67,42,15,891,57,948,6.012658227848101
3382,330100905080161,131,142,130,108,78,63,35,27,652,62,714,8.683473389355742
3383,330100905080162,298,333,341,272,235,200,95,58,1679,153,1832,8.351528384279476
3384,330100905080163,303,274,233,205,139,105,44,24,1259,68,1327,5.124340617935192
3385,330100905080164,2,27,361,144,37,11,1,1,582,2,584,0.3424657534246575
3386,330100905080165,0,15,269,127,57,27,9,1,495,10,505,1.9801980198019802
3387,330100905080166,0,12,111,30,11,1,0,0,165,0,165,0.0
3388,330100905090001,167,211,178,154,162,88,34,23,960,57,1017,5.6047197640118
3389,330100905090002,159,220,178,148,170,103,52,31,978,83,1061,7.822808671065033
3390,330100905090003,85,101,106,105,85,92,59,52,574,111,685,16.204379562043794
3391,330100905090004,198,240,239,241,200,187,73,78,1305,151,1456,10.37087912087912
3392,330100905090005,45,35,51,23,21,21,7,3,196,10,206,4.854368932038835
3393,330100905090006,179,205,187,189,190,155,76,55,1105,131,1236,10.598705501618124
3394,330100905090007,121,133,115,114,108,88,31,43,679,74,753,9.827357237715804
3395,330100905090008,96,138,178,118,117,108,65,25,755,90,845,10.650887573964496
3396,330100905090009,97,91,153,89,68,115,51,40,613,91,704,12.926136363636363
3397,330100905090010,163,162,191,158,138,139,79,59,951,138,1089,12.672176308539944
3398,330100905090011,183,220,170,172,159,109,75,53,1013,128,1141,11.2182296231376
3399,330100905090012,202,237,199,180,138,103,61,41,1059,102,1161,8.785529715762275
3400,330100905090013,122,117,122,84,77,73,41,28,595,69,664,10.391566265060241
3401,330100905090014,138,167,172,149,124,100,45,40,850,85,935,9.090909090909092
3402,330100905090015,52,86,59,49,72,49,42,38,367,80,447,17.89709172259508
3403,330100905090016,112,143,128,140,102,86,66,55,711,121,832,14.54326923076923
3404,330100905090017,127,176,150,157,134,97,62,49,841,111,952,11.659663865546218
3405,330100905090018,113,154,145,139,166,133,66,54,850,120,970,12.371134020618557
3406,330100905090019,158,213,205,163,184,162,99,75,1085,174,1259,13.820492454328832
3407,330100905090020,127,191,143,125,163,96,43,34,845,77,922,8.351409978308027
3408,330100905090021,109,152,144,137,113,97,61,65,752,126,878,14.350797266514807
3409,330100905090022,87,127,125,90,109,90,32,23,628,55,683,8.052708638360176
3410,330100905090023,258,305,207,204,217,126,78,36,1317,114,1431,7.966457023060797
3411,330100905090024,55,74,57,74,49,53,44,36,362,80,442,18.099547511312217
3412,330100905090025,123,142,136,121,140,103,53,48,765,101,866,11.662817551963048
3413,330100905090026,171,203,140,127,102,93,57,34,836,91,927,9.81661272923409
3414,330100905090027,284,265,258,206,209,135,100,82,1357,182,1539,11.825860948667966
3415,330100905090028,35,45,39,33,18,37,12,8,207,20,227,8.810572687224669
3416,330100905090029,102,109,129,131,119,98,63,44,688,107,795,13.459119496855346
3417,330100905090030,186,210,238,218,198,148,67,42,1198,109,1307,8.339709257842387
3418,330100905090031,176,191,267,265,237,138,68,37,1274,105,1379,7.614213197969543
3419,330100905090033,98,144,140,114,143,117,74,60,756,134,890,15.0561797752809
3420,330100905090034,113,172,119,94,120,83,80,40,701,120,821,14.616321559074299
3421,330100905090035,94,134,100,103,119,63,54,30,613,84,697,12.051649928263988
3422,330100905090037,90,122,98,98,95,65,49,29,568,78,646,12.074303405572756
3423,330100905090038,62,58,60,78,47,42,18,25,347,43,390,11.025641025641026
3424,330100905090039,177,246,232,228,196,134,80,56,1213,136,1349,10.081541882876204
3425,330100905090040,147,152,181,142,114,80,46,44,816,90,906,9.933774834437086
3426,330100905090041,109,151,132,141,106,120,59,67,759,126,885,14.23728813559322
3427,330100905090042,192,186,197,201,172,98,66,34,1046,100,1146,8.726003490401396
3428,330100905090043,256,276,276,307,288,177,70,37,1580,107,1687,6.342620035566093
3429,330100905090044,226,240,246,270,211,131,50,47,1324,97,1421,6.826178747361014
3430,330100905090045,183,171,161,141,99,81,25,12,836,37,873,4.238258877434135
3431,330100905090046,102,143,152,105,140,79,51,56,721,107,828,12.922705314009661
3432,330100905090047,8,6,9,6,9,5,3,2,43,5,48,10.416666666666666
3433,330100905090048,23,26,21,13,22,16,20,5,121,25,146,17.123287671232877
3434,330100905090049,52,50,59,42,32,19,16,8,254,24,278,8.633093525179856
3435,330100905090050,37,50,56,53,40,42,29,22,278,51,329,15.501519756838906
3436,330100905090051,41,66,50,57,40,31,23,16,285,39,324,12.037037037037036
3437,330100905090052,108,169,121,113,128,102,39,24,741,63,804,7.835820895522388
3438,330100905090053,26,18,34,29,23,22,17,10,152,27,179,15.083798882681565
3439,330100905090054,82,74,81,57,36,27,5,10,357,15,372,4.032258064516129
3440,330100905090055,155,185,161,121,117,82,33,24,821,57,878,6.492027334851937
3441,330100905090056,90,115,68,84,85,42,21,11,484,32,516,6.2015503875969
3442,330100905090057,193,190,168,157,128,75,48,17,911,65,976,6.659836065573771
3443,330100915000001,67,98,79,81,93,61,47,51,479,98,577,16.984402079722702
3444,330100915000002,74,96,106,95,91,79,63,41,541,104,645,16.124031007751938
3445,330100915000003,277,296,233,229,144,126,65,37,1305,102,1407,7.249466950959488
3446,330100915000004,189,189,169,164,89,68,39,24,868,63,931,6.7669172932330826
3447,330100915000005,143,204,147,135,112,106,71,56,847,127,974,13.039014373716633
3448,330100915000006,23,22,24,18,14,25,8,7,126,15,141,10.638297872340425
3449,330100915000007,93,96,82,76,48,68,38,43,463,81,544,14.889705882352942
3450,330100915000008,70,99,58,53,33,55,27,14,368,41,409,10.02444987775061
3451,330100915000009,30,36,17,26,16,9,5,13,134,18,152,11.842105263157896
3452,330100915000010,44,71,47,38,43,32,11,11,275,22,297,7.407407407407407
3453,330100915000011,45,53,33,38,24,21,9,13,214,22,236,9.322033898305085
3454,330100915000012,127,144,139,116,74,79,39,26,679,65,744,8.736559139784946
3455,330100915000013,80,90,75,69,67,53,27,15,434,42,476,8.823529411764707
3456,330100915000014,181,203,200,174,111,93,58,26,962,84,1046,8.030592734225621
3457,330100920000001,156,197,213,155,117,58,40,30,896,70,966,7.246376811594203
3458,330100920000002,4,9,5,3,2,6,2,4,29,6,35,17.142857142857142
3459,330100920000003,115,144,92,91,92,49,31,22,583,53,636,8.333333333333334
3460,330100920000004,104,110,91,69,70,66,23,20,510,43,553,7.775768535262206
3461,330100920000005,49,52,35,39,36,38,20,18,249,38,287,13.240418118466899
3462,330100920000006,40,46,27,17,22,19,6,1,171,7,178,3.932584269662921
3463,330100920000007,65,92,46,59,34,19,23,9,315,32,347,9.221902017291066
3464,330100930000001,237,340,240,229,194,129,85,62,1369,147,1516,9.696569920844327
3465,330100930000002,132,130,145,93,66,76,44,36,642,80,722,11.0803324099723
3466,330100930000003,36,41,34,26,15,14,16,11,166,27,193,13.989637305699482
3467,330100930000004,54,84,63,65,53,50,43,39,369,82,451,18.181818181818183
3468,330100930000005,83,86,79,55,44,47,29,9,394,38,432,8.796296296296296
3469,330100930000006,85,78,49,54,42,27,16,8,335,24,359,6.685236768802229
3471,330100930000008,18,21,14,14,5,11,7,3,83,10,93,10.75268817204301
3473,330100935000001,154,218,158,166,164,93,71,67,953,138,1091,12.648945921173235
3474,330100935000002,132,181,142,128,146,84,55,65,813,120,933,12.861736334405144
3475,330100935000003,90,136,120,110,85,81,54,42,622,96,718,13.370473537604457
3476,330100935000004,110,161,137,128,112,83,77,50,731,127,858,14.801864801864802
3477,330100935000005,27,35,38,31,39,27,39,14,197,53,250,21.2
3478,330100935000006,64,86,76,76,72,64,53,52,438,105,543,19.337016574585636
3479,330100935000007,52,69,33,38,58,21,8,11,271,19,290,6.551724137931035
3480,330100940000001,37,44,48,31,29,29,23,25,218,48,266,18.045112781954888
3481,330100940000002,89,121,112,101,122,77,41,64,622,105,727,14.442916093535075
3482,330100940000003,58,62,73,57,56,41,19,12,347,31,378,8.201058201058201
3483,330100940000004,43,60,46,49,69,61,45,47,328,92,420,21.904761904761905
3484,330100940000005,147,174,173,113,140,87,51,43,834,94,928,10.129310344827585
3485,330100940000006,47,53,71,70,58,53,40,47,352,87,439,19.81776765375854
3486,330100940000007,11,13,11,9,15,11,9,10,70,19,89,21.348314606741575
3487,330100940000008,3,5,7,8,17,11,21,9,51,30,81,37.03703703703704
3488,330100940000009,63,64,68,53,57,46,34,21,351,55,406,13.54679802955665
3489,330100940000010,68,115,76,70,96,75,60,46,500,106,606,17.49174917491749
3490,330100940000011,113,141,166,121,150,134,61,55,825,116,941,12.32731137088204
3491,330100940000012,32,44,38,59,26,38,15,10,237,25,262,9.541984732824428
3492,330100940000013,22,33,30,25,29,18,18,14,157,32,189,16.93121693121693
3493,330100940000014,64,77,73,62,73,64,33,32,413,65,478,13.598326359832637
3494,330100940000015,37,36,43,54,36,29,24,11,235,35,270,12.962962962962964
3495,330100940000016,7,20,10,13,8,19,10,11,77,21,98,21.428571428571427
3496,330100940000017,45,56,56,53,64,44,33,26,318,59,377,15.649867374005305
3497,330100940000018,39,63,51,38,41,41,26,16,273,42,315,13.333333333333334
3498,330100940000019,71,74,54,80,37,36,24,15,352,39,391,9.974424552429667
3499,330100940000020,92,139,91,99,72,58,35,33,551,68,619,10.985460420032311
3500,330100940000021,134,188,158,135,105,70,36,18,790,54,844,6.398104265402844
3501,330100940000022,74,74,93,74,77,61,61,42,453,103,556,18.52517985611511
3502,330100940000023,133,163,152,142,153,102,63,53,845,116,961,12.070759625390219
3503,330100940000024,94,130,125,131,119,87,74,65,686,139,825,16.848484848484848
3504,330100940000025,19,42,24,22,37,22,25,18,166,43,209,20.574162679425836
3505,330100940000026,22,18,21,23,15,15,15,10,114,25,139,17.985611510791365
3506,330100940000027,14,16,14,12,12,36,8,11,104,19,123,15.447154471544716
3507,330100945000001,74,113,92,92,90,81,47,50,542,97,639,15.179968701095461
3508,330100945000002,57,126,101,78,96,74,57,72,532,129,661,19.51588502269289
3509,330100945000003,130,173,159,175,134,97,79,69,868,148,1016,14.566929133858268
3510,330100945000004,16,24,26,18,13,13,11,15,110,26,136,19.11764705882353
3511,330100945000005,12,32,27,13,27,30,19,15,141,34,175,19.428571428571427
3512,330100945000006,28,26,37,24,26,32,12,9,173,21,194,10.824742268041238
3513,330100945000007,40,59,51,54,57,39,23,24,300,47,347,13.544668587896254
3514,330100945000008,56,66,60,61,68,60,36,47,371,83,454,18.281938325991188
3515,330100945000009,34,58,61,52,60,54,30,38,319,68,387,17.57105943152455
3516,330100950000001,103,127,133,93,137,107,54,65,700,119,819,14.52991452991453
3517,330100950000002,95,118,112,83,89,53,38,38,550,76,626,12.140575079872205
3518,330100950000003,115,123,119,103,106,68,53,38,634,91,725,12.551724137931034
3519,330100950000004,79,109,99,94,85,86,45,29,552,74,626,11.821086261980831
3520,330100950000005,85,103,87,108,80,48,57,28,511,85,596,14.261744966442953
3521,330100950000006,40,57,59,37,53,52,31,22,298,53,351,15.0997150997151
3522,330100950000007,16,25,30,35,25,29,27,26,160,53,213,24.88262910798122
3523,330100950000008,28,29,38,35,32,28,23,16,190,39,229,17.03056768558952
3524,330100950000009,7,13,17,6,18,19,13,21,80,34,114,29.82456140350877
3525,330100950000010,18,24,25,29,39,17,34,18,152,52,204,25.49019607843137
3526,330100950000011,7,15,16,10,19,10,11,7,77,18,95,18.94736842105263
3527,330100950000012,8,21,42,51,23,33,12,11,178,23,201,11.442786069651742
3528,330100950000013,81,118,94,112,102,68,57,33,575,90,665,13.533834586466165
3529,330100950000014,62,83,100,99,96,103,62,47,543,109,652,16.717791411042946
3530,330100950000015,46,61,44,50,62,52,41,29,315,70,385,18.181818181818183
3531,330100950000016,21,27,23,26,22,19,8,4,138,12,150,8.0
3532,330100950000017,43,49,39,22,22,25,17,13,200,30,230,13.043478260869565
3533,330100950000018,36,44,44,32,26,44,42,29,226,71,297,23.905723905723907
3534,330100950000019,26,50,35,34,63,45,44,28,253,72,325,22.153846153846153
3535,330100950000020,50,79,60,60,69,65,41,26,383,67,450,14.88888888888889
3536,330100955000001,56,93,68,89,85,78,66,60,469,126,595,21.176470588235293
3537,330100955000002,46,63,62,54,66,72,47,51,363,98,461,21.25813449023861
3538,330100955000003,141,207,129,143,153,103,78,82,876,160,1036,15.444015444015443
3539,330100955000004,87,98,96,62,94,78,41,47,515,88,603,14.593698175787727
3540,330100955000005,21,65,43,53,54,38,26,18,274,44,318,13.836477987421384
3541,330100955000006,34,65,48,45,57,40,34,25,289,59,348,16.95402298850575
3542,330100955000007,35,42,49,32,45,45,26,31,248,57,305,18.688524590163933
3543,330100955000008,31,52,34,35,41,30,22,22,223,44,267,16.47940074906367
3544,330100955000009,62,65,74,74,57,66,52,53,398,105,503,20.87475149105368
3545,330100955000010,37,56,60,49,44,47,54,37,293,91,384,23.697916666666668
3546,330100965000001,215,228,215,217,158,171,97,62,1204,159,1363,11.665443873807776
3547,330100965000002,37,57,59,31,49,44,31,29,277,60,337,17.80415430267062
3548,330100965000003,91,100,75,88,72,39,31,30,465,61,526,11.596958174904943
3549,330100965000004,97,107,107,75,95,59,39,40,540,79,619,12.762520193861066
3550,330100965000005,176,210,192,150,150,117,51,48,995,99,1094,9.049360146252285
3551,330100965000006,103,140,163,108,111,83,67,61,708,128,836,15.311004784688995
3552,330100965000007,41,53,56,43,52,38,34,19,283,53,336,15.773809523809524
3553,330100965000008,198,235,203,166,133,112,74,41,1047,115,1162,9.896729776247849
3554,330100965000009,127,174,150,127,145,82,56,62,805,118,923,12.784398699891657
3555,330100965000010,45,36,59,45,55,38,22,25,278,47,325,14.461538461538462
3556,330100965000011,55,50,69,53,54,47,32,39,328,71,399,17.794486215538846
3557,330100965000012,109,131,103,92,87,56,36,27,578,63,641,9.82839313572543
3558,330100965000013,109,168,120,155,97,65,30,25,714,55,769,7.152145643693108
3559,330100965000014,88,140,130,132,117,93,78,49,700,127,827,15.35671100362757
3560,330100965000015,67,89,64,100,93,69,42,34,482,76,558,13.620071684587813
3561,330100965000016,168,231,254,178,209,136,94,71,1176,165,1341,12.304250559284116
3562,330100965000017,145,185,186,152,145,104,73,76,917,149,1066,13.977485928705441
3563,330100965000018,40,66,49,54,54,54,31,27,317,58,375,15.466666666666667
3564,330100965000019,28,50,33,39,27,22,26,22,199,48,247,19.4331983805668
3565,330100965000020,15,23,15,16,16,24,15,14,109,29,138,21.014492753623188
3566,330100965000021,15,18,15,19,15,16,9,1,98,10,108,9.25925925925926
3567,330100965000022,83,104,90,85,97,52,46,30,511,76,587,12.947189097103918
3568,330100970000001,92,88,81,73,81,57,43,40,472,83,555,14.954954954954955
3569,330100970000002,84,99,75,66,50,35,22,18,409,40,449,8.908685968819599
3570,330100970000003,38,31,27,31,29,25,6,2,181,8,189,4.232804232804233
3571,330100975000001,96,93,98,90,87,66,38,40,530,78,608,12.828947368421053
3572,330100975000002,81,96,126,95,83,76,55,49,557,104,661,15.733736762481088
3573,330100975000003,78,116,110,63,98,62,30,30,527,60,587,10.221465076660989
3574,330100975000004,145,165,183,151,180,116,90,56,940,146,1086,13.443830570902394
3575,330100975000005,144,189,154,149,150,117,75,47,903,122,1025,11.902439024390244
3576,330100975000006,24,53,23,42,48,36,26,51,226,77,303,25.41254125412541
3577,330100975000007,1,4,1,6,5,7,5,5,24,10,34,29.41176470588235
3578,330100975000008,65,95,60,78,76,38,30,32,412,62,474,13.080168776371307
3579,330100975000009,125,143,158,102,97,112,48,44,737,92,829,11.097708082026537
3580,330100975000010,26,63,40,43,52,22,32,27,246,59,305,19.34426229508197
3581,330100975000011,70,80,79,42,47,55,33,26,373,59,432,13.657407407407407
3582,330100975000012,109,140,99,81,117,77,43,46,623,89,712,12.5
3583,330100975000013,79,103,110,118,73,70,79,46,553,125,678,18.436578171091444
3584,330100975000014,52,62,55,61,63,47,41,49,340,90,430,20.930232558139537
3585,330100980000001,234,254,262,271,138,117,68,54,1276,122,1398,8.726752503576538
3586,330100980000002,209,265,224,204,166,126,48,38,1194,86,1280,6.71875
3587,330100980000003,127,161,149,115,119,111,63,43,782,106,888,11.936936936936936
3588,330100980000004,102,108,115,81,63,39,27,17,508,44,552,7.971014492753623
3590,330100980000006,123,120,135,131,86,73,49,33,668,82,750,10.933333333333334
3591,330100980000007,87,98,102,82,65,58,35,40,492,75,567,13.227513227513228
3592,330100980000008,134,196,177,117,149,88,53,42,861,95,956,9.93723849372385
3593,330100980000009,167,124,278,170,108,167,74,11,1014,85,1099,7.734303912647862
3594,330100980000010,178,198,146,175,119,99,62,53,915,115,1030,11.16504854368932
3595,330100980000011,218,287,243,197,155,117,66,62,1217,128,1345,9.516728624535316
3596,330100980000012,58,67,85,71,47,41,18,31,369,49,418,11.722488038277511
3597,330100980000013,117,153,132,102,73,69,27,30,646,57,703,8.108108108108109
3598,330100980000014,138,151,221,133,138,166,89,31,947,120,1067,11.246485473289598
3599,330100980000015,76,75,83,62,59,26,43,21,381,64,445,14.382022471910112
3600,330100980000016,171,156,146,123,84,62,27,9,742,36,778,4.627249357326479
3601,330100980000017,278,434,345,306,248,125,107,73,1736,180,1916,9.394572025052192
3602,330100980000018,90,134,101,91,87,48,24,23,551,47,598,7.8595317725752505
3603,330100980000019,100,145,116,123,87,62,52,36,633,88,721,12.205270457697642
3604,330100980000020,84,119,88,95,89,42,25,12,517,37,554,6.67870036101083
3605,330100980000021,134,141,131,109,80,73,59,40,668,99,767,12.907431551499348
3606,330100980000022,80,79,64,62,72,59,37,19,416,56,472,11.864406779661017
3607,330100980000023,232,266,198,185,158,99,67,61,1138,128,1266,10.110584518167457
3609,330100980000025,289,269,225,189,129,109,54,39,1210,93,1303,7.137375287797391
3610,330100980000026,239,216,223,151,142,88,44,26,1059,70,1129,6.200177147918512
3611,330100980000027,231,261,228,196,166,105,45,29,1187,74,1261,5.868358445678033
3612,330100980000028,60,69,65,68,39,51,28,30,352,58,410,14.146341463414634
3613,330100985000001,189,180,181,159,152,100,95,77,961,172,1133,15.180935569285085
3614,330100985000002,68,90,83,55,64,53,45,37,413,82,495,16.565656565656564
3615,330100985000003,16,39,24,22,39,43,14,21,183,35,218,16.05504587155963
3616,330100985000004,72,81,61,49,51,30,26,25,344,51,395,12.91139240506329
3617,330100985000005,107,129,95,92,74,72,33,18,569,51,620,8.225806451612904
3618,330100985000006,66,108,58,60,77,49,26,17,418,43,461,9.327548806941431
3619,330100985000007,110,164,127,94,92,73,45,30,660,75,735,10.204081632653061
3620,330100985000008,73,81,76,87,50,56,49,42,423,91,514,17.704280155642024
3621,330100985000009,153,192,160,173,113,106,52,55,897,107,1004,10.657370517928287
3622,330100985000010,82,117,134,100,101,76,48,64,610,112,722,15.512465373961218
3623,330110805000001,113,131,140,149,127,97,77,79,757,156,913,17.086527929901425
3624,330110805000002,100,98,118,122,108,86,95,58,632,153,785,19.49044585987261
3625,330110805000003,36,43,46,45,53,35,12,20,258,32,290,11.03448275862069
3626,330110805000004,87,123,129,104,107,87,51,55,637,106,743,14.266487213997308
3627,330110805000005,85,102,122,116,115,118,100,70,658,170,828,20.531400966183575
3628,330110805000006,93,103,123,111,140,118,94,109,688,203,891,22.783389450056116
3629,330110805000007,70,93,104,99,134,108,95,117,608,212,820,25.853658536585368
3630,330110805000008,120,141,136,133,110,48,34,42,688,76,764,9.947643979057592
3631,330110805000009,168,183,187,142,142,81,67,53,903,120,1023,11.730205278592376
3632,330110805000010,93,120,134,90,102,41,27,27,580,54,634,8.517350157728707
3633,330110805000011,60,82,63,60,44,47,29,17,356,46,402,11.442786069651742
3634,330110805000012,113,116,99,118,99,76,45,32,621,77,698,11.031518624641834
3635,330110805000013,147,181,108,88,85,46,31,34,655,65,720,9.027777777777779
3636,330110805000014,34,40,32,33,37,32,17,11,208,28,236,11.864406779661017
3637,330110805000015,170,187,212,188,149,119,59,30,1025,89,1114,7.989228007181328
3638,330110805000016,68,87,98,95,90,59,49,30,497,79,576,13.715277777777779
3639,330110805000017,129,149,120,124,103,58,43,18,683,61,744,8.198924731182796
3640,330110810000001,130,155,172,142,162,122,85,91,883,176,1059,16.619452313503306
3641,330110810000002,21,20,13,13,13,5,0,3,85,3,88,3.409090909090909
3642,330110810000003,28,35,32,24,27,32,13,16,178,29,207,14.009661835748792
3643,330110810000004,92,110,82,67,83,66,39,35,500,74,574,12.89198606271777
3644,330110815000001,73,103,94,101,91,57,32,30,519,62,581,10.671256454388985
3646,330110815000003,113,149,147,135,119,93,77,53,756,130,886,14.672686230248306
3647,330110815000004,54,44,59,46,42,33,14,11,278,25,303,8.250825082508252
3648,330110815000005,20,30,24,23,36,27,28,22,160,50,210,23.80952380952381
3650,330110815000007,38,50,45,39,41,30,28,24,243,52,295,17.627118644067796
3651,330110815000008,138,197,159,161,140,134,64,42,929,106,1035,10.241545893719806
3652,330110820000001,102,109,119,111,91,68,79,77,600,156,756,20.634920634920636
3653,330110820000002,63,79,47,72,77,51,36,30,389,66,455,14.505494505494505
3654,330110825000001,17,36,18,22,38,29,36,15,160,51,211,24.170616113744074
3655,330110825000002,31,29,32,21,29,28,12,15,170,27,197,13.705583756345177
3656,330110825000003,28,51,25,42,33,31,22,19,210,41,251,16.334661354581673
3657,330110825000004,11,28,7,13,26,13,16,10,98,26,124,20.967741935483872
3658,330110825000005,35,43,35,35,39,44,36,22,231,58,289,20.069204152249135
3659,330115705000001,131,121,141,137,109,94,47,60,733,107,840,12.738095238095237
3660,330115705000002,136,169,168,138,151,81,58,57,843,115,958,12.004175365344468
3661,330115705000003,61,93,82,87,87,74,50,68,484,118,602,19.601328903654483
3662,330115705000004,65,40,52,56,50,38,38,45,301,83,384,21.614583333333332
3663,330115705000005,60,65,73,65,53,45,32,47,361,79,440,17.954545454545453
3664,330115705000006,60,59,76,69,67,51,46,38,382,84,466,18.025751072961373
3665,330115705000007,141,165,135,139,104,104,50,67,788,117,905,12.92817679558011
3666,330115705000008,76,90,103,93,93,82,58,50,537,108,645,16.74418604651163
3667,330115705000009,89,79,107,86,84,90,81,57,535,138,673,20.505200594353642
3668,330115705000010,57,99,93,83,81,58,54,60,471,114,585,19.487179487179485
3669,330115705000011,98,100,131,115,83,79,53,43,606,96,702,13.675213675213675
3670,330115705000012,15,25,20,23,23,20,13,18,126,31,157,19.745222929936304
3671,330115705000013,18,35,35,38,23,24,21,20,173,41,214,19.1588785046729
3672,330115705000014,27,44,40,49,65,44,24,31,269,55,324,16.97530864197531
3673,330115705000015,10,13,6,14,11,2,1,1,56,2,58,3.4482758620689653
3674,330115705000016,93,126,82,76,68,47,35,12,492,47,539,8.719851576994435
3675,330115705000017,10,21,14,17,23,18,19,16,103,35,138,25.36231884057971
3676,330115705000018,12,17,20,16,21,24,11,10,110,21,131,16.03053435114504
3677,330115705000019,66,85,77,86,69,48,37,29,431,66,497,13.279678068410464
3678,330115710000001,33,46,44,38,25,23,34,29,209,63,272,23.16176470588235
3679,330115710000002,39,29,32,29,17,24,20,4,170,24,194,12.371134020618557
3680,330115710000003,23,51,33,36,55,43,30,36,241,66,307,21.498371335504885
3681,330115710000004,19,32,20,26,31,34,23,32,162,55,217,25.34562211981567
3682,330115710000005,35,29,53,46,42,48,26,49,253,75,328,22.865853658536587
3683,330115710000006,29,36,45,28,30,33,36,25,201,61,262,23.282442748091604
3684,330115710000007,52,85,58,52,48,27,20,14,322,34,356,9.55056179775281
3685,330115710000008,106,152,142,111,113,57,50,44,681,94,775,12.129032258064516
3686,330115710000009,84,84,87,89,94,73,57,63,511,120,631,19.01743264659271
3687,330120705000001,99,133,130,123,139,130,76,96,754,172,926,18.574514038876888
3688,330120705000002,68,109,112,122,116,115,78,83,642,161,803,20.049813200498132
3689,330120705000003,72,114,106,95,98,91,65,56,576,121,697,17.360114777618364
3690,330120705000004,67,67,101,83,86,101,57,93,505,150,655,22.900763358778626
3691,330120705000005,130,158,132,119,111,86,42,32,736,74,810,9.135802469135802
3692,330120705000006,70,69,85,89,82,82,46,41,477,87,564,15.425531914893616
3693,330120705000007,158,160,148,137,116,81,60,59,800,119,919,12.94885745375408
3694,330120705000008,98,108,119,126,104,97,58,37,652,95,747,12.717536813922356
3695,330120705000009,63,81,70,74,63,45,20,27,396,47,443,10.609480812641083
3696,330120705000010,157,168,141,148,134,77,53,48,825,101,926,10.907127429805616
3697,330120705000011,88,87,106,97,64,54,34,20,496,54,550,9.818181818181818
3698,330120705000012,213,202,207,190,154,110,47,42,1076,89,1165,7.639484978540772
3699,330120705000013,78,97,82,101,118,101,49,44,577,93,670,13.880597014925373
3700,330120705000014,161,198,177,178,174,125,51,37,1013,88,1101,7.992733878292461
3701,330120705000015,94,109,66,126,86,51,30,30,532,60,592,10.135135135135135
3702,330120705000016,17,25,21,15,23,16,5,7,117,12,129,9.30232558139535
3703,330120705000017,16,28,17,16,15,21,10,13,113,23,136,16.91176470588235
3704,330120705000018,48,67,43,46,38,33,19,16,275,35,310,11.290322580645162
3705,330120705000019,58,77,66,64,81,50,20,22,396,42,438,9.58904109589041
3706,330120705000020,65,57,46,62,43,48,32,15,321,47,368,12.771739130434783
3707,330120705000021,85,118,108,110,100,97,53,44,618,97,715,13.566433566433567
3708,330120705000022,48,38,56,63,61,53,56,52,319,108,427,25.292740046838407
3709,330120705000023,83,112,99,97,99,68,34,29,558,63,621,10.144927536231885
3710,330120705000024,130,121,125,128,93,72,32,43,669,75,744,10.080645161290322
3711,330120710000001,36,49,51,38,54,47,45,40,275,85,360,23.61111111111111
3712,330120710000002,19,21,25,15,27,21,8,18,128,26,154,16.883116883116884
3713,330120710000003,31,41,35,28,32,15,19,17,182,36,218,16.513761467889907
3714,330120715000001,89,100,117,102,114,80,70,56,602,126,728,17.307692307692307
3715,330120715000002,22,37,33,40,34,46,30,11,212,41,253,16.205533596837945
3716,330120715000003,28,41,35,33,27,39,33,29,203,62,265,23.39622641509434
3717,330130605000001,96,84,119,88,75,90,54,41,552,95,647,14.683153013910356
3718,330130605000002,61,58,83,66,57,49,46,35,374,81,455,17.802197802197803
3719,330130605000003,50,80,84,60,55,74,29,37,403,66,469,14.072494669509595
3720,330130605000004,74,126,104,105,109,72,43,27,590,70,660,10.606060606060606
3721,330130605000005,70,99,114,85,84,70,42,54,522,96,618,15.533980582524272
3722,330130605000006,110,125,154,121,126,98,53,50,734,103,837,12.305854241338112
3723,330130605000007,30,48,41,35,32,29,18,24,215,42,257,16.342412451361866
3724,330130605000008,88,116,106,98,109,77,34,25,594,59,653,9.03522205206738
3725,330130605000009,97,127,115,111,88,62,41,42,600,83,683,12.152269399707174
3726,330130605000010,99,96,137,115,78,60,39,34,585,73,658,11.094224924012158
3727,330130605000011,168,258,213,221,188,113,63,41,1161,104,1265,8.221343873517787
3728,330130605000012,158,132,153,145,94,95,56,50,777,106,883,12.004530011325029
3729,330130605000013,77,88,115,69,77,50,33,31,476,64,540,11.851851851851851
3730,330130605000014,122,135,134,124,129,78,45,37,722,82,804,10.199004975124378
3731,330130605000015,149,171,174,161,110,81,37,30,846,67,913,7.338444687842278
3732,330130605000016,177,230,160,170,102,68,27,21,907,48,955,5.026178010471204
3733,330130605000017,200,182,192,193,138,97,48,25,1002,73,1075,6.790697674418604
3734,330130605000018,68,73,68,63,71,47,30,17,390,47,437,10.755148741418765
3735,330130605000019,90,82,82,128,93,50,28,16,525,44,569,7.73286467486819
3736,330130605000020,11,4,18,9,4,4,2,0,50,2,52,3.8461538461538463
3737,330130605000021,0,0,0,0,0,0,11,56,0,67,67,100.0
3738,330130605000022,70,101,86,88,65,60,33,26,470,59,529,11.1531190926276
3739,330130605000023,97,120,139,92,105,51,15,23,604,38,642,5.919003115264798
3740,330130605000024,78,111,99,90,85,34,21,18,497,39,536,7.276119402985074
3741,330130605000025,44,47,52,42,36,12,9,4,233,13,246,5.284552845528455
3742,330130605000026,152,168,148,178,97,63,29,20,806,49,855,5.730994152046784
3743,330130605000028,36,48,41,56,27,18,20,3,226,23,249,9.236947791164658
3744,330130605000029,34,35,34,35,33,37,10,14,208,24,232,10.344827586206897
3745,330130605000030,36,30,51,32,49,49,27,28,247,55,302,18.211920529801326
3746,330130605000031,19,17,21,21,13,12,10,9,103,19,122,15.573770491803279
3747,330130605000032,38,49,36,30,50,38,28,15,241,43,284,15.140845070422536
3748,330130605000033,20,15,22,21,14,12,5,1,104,6,110,5.454545454545454
3749,330130605000034,78,99,87,93,80,38,16,20,475,36,511,7.045009784735812
3750,330130610000001,53,84,73,69,72,70,48,41,421,89,510,17.45098039215686
3751,330130610000002,43,58,48,53,60,56,28,38,318,66,384,17.1875
3752,330130610000003,39,59,49,44,55,55,36,26,301,62,363,17.079889807162534
3753,330130610000004,35,50,49,47,55,63,43,43,299,86,385,22.337662337662337
3754,330130610000005,57,64,75,77,86,74,44,32,433,76,509,14.931237721021612
3755,330130610000006,60,84,84,86,95,77,47,25,486,72,558,12.903225806451612
3756,330130610000007,54,68,76,68,69,60,49,43,395,92,487,18.8911704312115
3757,330130610000008,81,105,106,96,91,78,51,33,557,84,641,13.104524180967239
3758,330130610000009,111,130,115,124,138,102,51,47,720,98,818,11.98044009779951
3759,330130610000010,88,103,103,108,87,79,48,41,568,89,657,13.54642313546423
3760,330130610000011,71,64,109,88,81,78,46,28,491,74,565,13.097345132743364
3761,330130610000012,48,78,68,62,77,65,31,25,398,56,454,12.334801762114537
3762,330130610000013,109,145,149,136,125,130,71,41,794,112,906,12.362030905077262
3763,330130610000014,95,99,108,103,75,71,39,11,551,50,601,8.319467554076539
3764,330130610000015,72,56,72,93,69,63,32,19,425,51,476,10.714285714285714
3765,330130610000016,136,121,171,134,99,82,49,29,743,78,821,9.500609013398295
3766,330130610000017,133,138,147,109,88,77,21,19,692,40,732,5.46448087431694
3767,330130610000018,230,255,213,206,149,82,41,37,1135,78,1213,6.430338004946414
3768,330130610000019,253,238,244,300,233,161,55,43,1429,98,1527,6.41781270464964
3769,330130610000020,54,46,44,44,40,26,15,5,254,20,274,7.299270072992701
3770,330130610000021,40,35,42,46,52,32,15,6,247,21,268,7.835820895522388
3771,330130610000022,21,30,25,23,20,8,7,1,127,8,135,5.925925925925926
3772,330130618000001,127,124,131,99,67,64,40,22,612,62,674,9.198813056379821
3773,330130618000002,172,176,180,134,81,72,50,27,815,77,892,8.632286995515695
3774,330130618000003,55,56,50,45,45,45,20,27,296,47,343,13.70262390670554
3775,330130618000004,21,28,29,19,22,4,5,3,123,8,131,6.106870229007634
3776,330130618000005,36,38,32,28,20,21,4,3,175,7,182,3.8461538461538463
3777,330130620000001,56,62,63,40,58,33,29,15,312,44,356,12.359550561797754
3778,330130620000002,104,79,127,83,77,60,39,35,530,74,604,12.251655629139073
3779,330130620000003,55,63,59,47,38,19,14,11,281,25,306,8.169934640522875
3781,330130620000005,69,94,71,68,58,45,19,15,405,34,439,7.744874715261959
3783,330140505000001,39,97,76,66,106,71,45,49,455,94,549,17.122040072859743
3784,330140505000002,45,60,74,56,56,51,30,40,342,70,412,16.990291262135923
3785,330140505000003,61,101,72,79,98,49,41,33,460,74,534,13.857677902621722
3786,330140505000004,79,105,90,96,92,59,46,28,521,74,595,12.436974789915967
3787,330140505000005,146,193,155,160,156,88,55,55,898,110,1008,10.912698412698413
3788,330140505000006,101,114,105,91,84,48,31,29,543,60,603,9.950248756218905
3789,330140505000007,60,94,84,77,62,48,30,13,425,43,468,9.188034188034187
3790,330140505000008,94,90,91,81,69,51,22,16,476,38,514,7.392996108949417
3791,330140505000009,104,119,116,114,93,81,49,54,627,103,730,14.10958904109589
3792,330140505000010,100,141,86,126,72,53,39,17,578,56,634,8.832807570977918
3793,330140505000011,127,125,131,129,100,64,39,26,676,65,741,8.771929824561404
3794,330140505000012,66,125,93,97,111,73,46,52,565,98,663,14.781297134238311
3795,330140505000013,35,94,78,54,86,63,50,50,410,100,510,19.607843137254903
3796,330140505000014,156,151,173,155,154,131,58,76,920,134,1054,12.7134724857685
3797,330140505000015,116,115,148,104,96,66,26,18,645,44,689,6.386066763425254
3798,330140505000016,47,57,57,45,30,31,29,8,267,37,304,12.171052631578947
3799,330140505000017,115,153,127,119,130,78,51,20,722,71,793,8.953341740226985
3800,330140505000018,46,53,45,51,59,41,26,26,295,52,347,14.985590778097983
3801,330140505000019,61,75,85,64,84,74,66,75,443,141,584,24.143835616438356
3802,330140505000020,129,156,148,124,129,106,46,63,792,109,901,12.097669256381797
3803,330140505000021,134,164,149,140,161,86,68,57,834,125,959,13.034410844629823
3804,330140505000022,140,171,148,129,117,76,47,43,781,90,871,10.332950631458095
3805,330140505000023,8,8,10,10,7,3,1,4,46,5,51,9.803921568627452
3806,330140505000024,48,73,71,53,68,53,28,29,366,57,423,13.47517730496454
3807,330140505000025,136,168,114,116,103,73,41,25,710,66,776,8.505154639175258
3808,330140505000026,46,50,57,47,39,30,21,7,269,28,297,9.427609427609427
3809,330140505000027,132,163,124,117,110,75,50,40,721,90,811,11.097410604192355
3810,330140505000028,77,84,66,75,54,32,21,7,388,28,416,6.730769230769231
3811,330140505000029,33,53,49,45,52,42,27,25,274,52,326,15.950920245398773
3812,330140505000030,17,56,28,33,33,15,12,7,182,19,201,9.45273631840796
3813,330140505000031,17,20,21,15,11,6,0,0,90,0,90,0.0
3814,330140505000032,40,41,47,41,56,52,28,15,277,43,320,13.4375
3815,330140505000033,6,15,19,62,31,10,5,4,143,9,152,5.921052631578948
3816,330140505000034,19,31,16,24,25,17,13,9,132,22,154,14.285714285714286
3817,330140505000035,17,27,19,18,25,10,8,9,116,17,133,12.781954887218046
3818,330140505000036,7,11,7,5,13,2,6,1,45,7,52,13.461538461538462
3819,330140505000037,128,134,104,128,73,53,36,19,620,55,675,8.148148148148149
3820,330140505000038,75,83,67,49,54,46,16,14,374,30,404,7.425742574257426
3821,330140505000039,58,81,62,73,48,42,20,27,364,47,411,11.435523114355231
3822,330140510000001,25,20,26,21,19,22,18,11,133,29,162,17.901234567901234
3823,330140510000002,125,172,127,86,115,115,73,29,740,102,842,12.114014251781473
3824,330140510000003,10,10,11,5,7,6,2,1,49,3,52,5.769230769230769
3825,330150405000001,29,58,48,56,44,49,42,43,284,85,369,23.035230352303522
3826,330150405000002,20,42,46,38,51,41,42,48,238,90,328,27.4390243902439
3827,330150405000003,78,118,150,138,165,134,122,104,783,226,1009,22.398414271555996
3828,330150405000004,161,198,136,143,109,57,46,27,804,73,877,8.323831242873432
3829,330150405000005,42,68,56,50,61,45,33,33,322,66,388,17.010309278350515
3830,330150405000006,111,116,145,119,109,131,68,59,731,127,858,14.801864801864802
3831,330150405000007,67,71,67,86,67,62,40,30,420,70,490,14.285714285714286
3832,330150405000008,55,112,96,100,85,67,39,40,515,79,594,13.2996632996633
3833,330150405000009,162,181,199,184,158,117,78,58,1001,136,1137,11.961301671064204
3834,330150405000010,122,136,145,129,130,94,70,49,756,119,875,13.6
3835,330150405000011,31,56,71,54,55,62,54,58,329,112,441,25.396825396825395
3836,330150405000012,103,134,147,112,122,92,63,66,710,129,839,15.37544696066746
3837,330150405000013,117,147,132,160,133,96,44,33,785,77,862,8.932714617169374
3838,330150405000014,222,268,272,190,222,166,77,53,1340,130,1470,8.843537414965986
3839,330150405000015,74,104,119,123,96,101,50,50,617,100,717,13.94700139470014
3840,330150405000016,46,59,51,50,45,47,17,20,298,37,335,11.044776119402986
3841,330150405000017,67,101,92,94,94,66,45,47,514,92,606,15.181518151815181
3842,330150405000018,77,123,113,103,115,122,65,92,653,157,810,19.382716049382715
3843,330150405000019,120,147,131,99,117,81,32,36,695,68,763,8.91218872870249
3844,330150405000020,92,104,104,104,90,54,44,26,548,70,618,11.326860841423947
3845,330150405000021,129,176,136,122,144,73,55,45,780,100,880,11.363636363636363
3846,330150405000022,31,38,24,26,34,23,15,7,176,22,198,11.11111111111111
3847,330150405000023,36,63,27,41,44,31,28,24,242,52,294,17.687074829931973
3848,330150405000024,87,85,105,93,91,69,51,27,530,78,608,12.828947368421053
3849,330150405000025,76,92,74,99,61,67,53,28,469,81,550,14.727272727272727
3850,330150405000026,137,144,138,111,133,61,39,32,724,71,795,8.930817610062894
3851,330150405000027,85,132,121,114,118,74,61,45,644,106,750,14.133333333333333
3852,330150405000028,74,97,100,85,97,59,41,36,512,77,589,13.073005093378608
3853,330150405000029,47,60,70,44,79,43,36,22,343,58,401,14.463840399002494
3854,330150405000030,126,116,99,110,110,67,38,32,628,70,698,10.02865329512894
3855,330150405000031,14,41,27,34,25,34,16,14,175,30,205,14.634146341463415
3856,330150405000032,16,10,15,11,8,7,3,6,67,9,76,11.842105263157896
3857,330160305000001,73,85,87,83,73,70,28,45,471,73,544,13.419117647058824
3858,330160305000002,137,157,189,140,137,106,44,43,866,87,953,9.12906610703043
3859,330160305000003,49,57,78,67,69,57,41,48,377,89,466,19.098712446351932
3860,330160305000004,128,174,188,135,168,103,59,60,896,119,1015,11.724137931034482
3861,330160305000005,19,15,18,15,10,6,13,5,83,18,101,17.821782178217823
3862,330160305000006,146,174,179,159,122,100,57,34,880,91,971,9.371781668383111
3863,330160305000007,1,5,4,2,7,3,2,1,22,3,25,12.0
3864,330160305000008,14,9,4,19,8,8,5,2,62,7,69,10.144927536231885
3865,330160305000009,32,38,43,32,47,20,9,20,212,29,241,12.033195020746888
3866,330160305000010,30,26,19,34,40,21,14,16,170,30,200,15.0
3867,330160305000011,24,41,19,31,32,14,10,5,161,15,176,8.522727272727273
3868,330160305000012,17,20,17,19,8,9,7,5,90,12,102,11.764705882352942
3869,330160305000013,39,45,29,44,18,25,9,10,200,19,219,8.67579908675799
3870,330160305000014,25,37,23,24,23,17,9,5,149,14,163,8.588957055214724
3871,330160310000001,39,34,42,24,55,28,27,22,222,49,271,18.081180811808117
3872,330160310000002,95,117,98,106,94,58,27,21,568,48,616,7.792207792207792
3873,330160310000003,87,91,99,96,79,48,40,31,500,71,571,12.43432574430823
3874,330160310000004,102,118,132,109,100,74,53,33,635,86,721,11.927877947295423
3875,330160310000005,3,8,5,9,6,9,1,4,40,5,45,11.11111111111111
3876,330160310000006,69,65,47,56,56,37,28,20,330,48,378,12.698412698412698
3877,330160310000007,46,66,58,60,57,45,28,21,332,49,381,12.860892388451443
3878,330160310000008,79,71,80,56,70,47,27,33,403,60,463,12.958963282937365
3879,330160310000009,124,156,125,125,96,62,42,26,688,68,756,8.994708994708995
3880,330160315000001,17,31,19,14,15,16,6,2,112,8,120,6.666666666666667
3881,330160315000002,9,20,15,9,18,12,7,4,83,11,94,11.702127659574469
3882,330160315000003,14,25,11,20,16,17,11,14,103,25,128,19.53125
3883,330160315000004,22,32,33,23,31,22,15,16,163,31,194,15.97938144329897
3884,330160315000006,24,44,27,49,39,33,15,20,216,35,251,13.944223107569721
3885,330160335000001,16,19,14,18,20,25,9,6,112,15,127,11.811023622047244
3886,330160335000002,9,7,9,8,3,5,3,4,41,7,48,14.583333333333334
3887,330160335000003,25,16,33,19,23,15,9,7,131,16,147,10.884353741496598
3888,330160335000004,29,47,37,39,50,32,10,12,234,22,256,8.59375
3889,330160335000006,19,17,29,13,8,16,12,4,102,16,118,13.559322033898304
3890,330170205000001,51,64,79,79,97,74,44,42,444,86,530,16.22641509433962
3891,330170205000002,85,128,129,103,87,115,48,51,647,99,746,13.270777479892761
3892,330170205000003,84,102,99,87,132,97,68,86,601,154,755,20.397350993377483
3893,330170205000004,31,47,75,85,67,57,41,23,362,64,426,15.023474178403756
3894,330170205000005,45,67,73,75,61,66,53,56,387,109,496,21.975806451612904
3895,330170205000006,45,61,90,53,67,83,52,40,399,92,491,18.73727087576375
3896,330170205000007,31,49,85,73,80,73,44,33,391,77,468,16.45299145299145
3897,330170205000008,34,73,98,36,80,143,28,34,464,62,526,11.787072243346008
3898,330170205000009,47,70,116,69,103,92,52,48,497,100,597,16.75041876046901
3899,330170205000010,30,50,59,66,56,59,44,41,320,85,405,20.987654320987655
3900,330170205000011,39,67,70,72,75,75,57,32,398,89,487,18.275154004106778
3901,330170205000012,82,94,97,106,93,108,37,41,580,78,658,11.854103343465045
3902,330170205000013,60,89,72,77,59,67,30,38,424,68,492,13.821138211382113
3903,330170205000014,59,86,101,76,82,85,46,31,489,77,566,13.604240282685513
3904,330170205000015,48,80,86,75,72,67,25,39,428,64,492,13.008130081300813
3905,330170205000016,61,94,118,98,105,94,62,54,570,116,686,16.909620991253643
3906,330170205000017,66,84,86,104,83,80,76,61,503,137,640,21.40625
3907,330170205000018,49,63,71,80,95,75,42,47,433,89,522,17.049808429118773
3908,330170205000019,96,133,122,116,99,124,53,53,690,106,796,13.316582914572864
3909,330170205000020,61,76,94,103,93,89,34,54,516,88,604,14.56953642384106
3910,330170205000021,33,72,111,72,82,81,41,33,451,74,525,14.095238095238095
3911,330170205000022,16,23,108,37,29,33,22,13,246,35,281,12.455516014234876
3912,330170205000023,33,47,30,51,38,37,11,12,236,23,259,8.88030888030888
3913,330170205000024,81,125,126,99,134,112,66,60,677,126,803,15.691158156911582
3914,330170205000025,44,89,106,120,118,91,66,51,568,117,685,17.080291970802918
3915,330170205000026,66,105,153,124,152,131,74,95,731,169,900,18.77777777777778
3916,330170205000027,42,52,75,55,55,67,39,22,346,61,407,14.987714987714988
3917,330170205000028,28,60,79,75,61,55,61,36,358,97,455,21.318681318681318
3918,330170205000029,29,65,74,63,78,83,50,40,392,90,482,18.672199170124482
3919,330170205000030,48,89,94,75,100,89,33,35,495,68,563,12.078152753108348
3920,330170205000031,113,139,149,157,100,114,59,74,772,133,905,14.696132596685082
3921,330170205000032,14,34,35,42,32,33,16,13,190,29,219,13.242009132420092
3922,330170205000033,150,211,186,168,104,77,28,21,896,49,945,5.185185185185185
3923,330170205000034,81,80,69,57,35,41,13,12,363,25,388,6.443298969072165
3924,330170205000035,74,97,62,60,54,47,25,15,394,40,434,9.216589861751151
3925,330170205000036,128,121,100,84,53,41,29,9,527,38,565,6.725663716814159
3926,330170205000037,59,68,50,60,33,15,15,6,285,21,306,6.862745098039215
3927,330170205000038,91,109,81,89,30,50,30,8,450,38,488,7.786885245901639
3928,330170205000039,113,114,86,95,56,47,25,13,511,38,549,6.9216757741347905
3929,330170205000040,122,173,137,114,114,73,33,18,733,51,784,6.505102040816326
3930,330170205000041,68,74,127,137,132,104,58,47,642,105,747,14.056224899598394
3931,330170205000042,37,76,85,77,70,60,43,37,405,80,485,16.49484536082474
3932,330170205000043,31,44,129,100,55,71,50,46,430,96,526,18.250950570342205
3933,330170205000044,87,139,176,147,151,139,92,50,839,142,981,14.475025484199795
3934,330170205000045,87,87,151,134,125,75,63,37,659,100,759,13.175230566534914
3935,330170205000046,39,73,69,91,71,73,44,31,416,75,491,15.274949083503055
3936,330170205000047,52,46,80,74,38,73,32,43,363,75,438,17.123287671232877
3937,330170205000048,85,124,150,135,126,104,54,50,724,104,828,12.560386473429952
3938,330170205000049,103,109,245,138,122,133,67,80,850,147,997,14.744232698094283
3939,330170205000050,58,69,98,95,72,79,33,19,471,52,523,9.94263862332696
3940,330170205000051,69,112,174,127,116,115,73,84,713,157,870,18.04597701149425
3941,330170205000052,19,28,55,47,54,47,34,33,250,67,317,21.13564668769716
3942,330170205000053,55,68,160,91,53,66,32,51,493,83,576,14.409722222222221
3943,330170205000054,23,40,47,42,27,48,22,33,227,55,282,19.50354609929078
3944,330170205000055,85,141,171,140,146,127,89,70,810,159,969,16.408668730650156
3945,330170205000056,58,47,74,95,68,54,33,30,396,63,459,13.72549019607843
3946,330170205000057,48,60,107,57,77,70,40,44,419,84,503,16.69980119284294
3947,330170205000058,28,62,91,96,72,76,51,25,425,76,501,15.169660678642714
3948,330170205000059,36,72,85,76,90,60,50,38,419,88,507,17.357001972386588
3949,330170205000060,91,134,147,124,95,92,58,39,683,97,780,12.435897435897436
3950,330170205000061,28,50,50,33,65,59,22,22,285,44,329,13.373860182370821
3951,330170205000062,60,112,148,136,76,85,55,49,617,104,721,14.424410540915396
3952,330170205000063,107,119,101,95,112,78,47,44,612,91,703,12.944523470839261
3953,330170205000064,61,75,83,79,92,74,34,41,464,75,539,13.91465677179963
3954,330170205000065,86,121,99,89,92,83,54,39,570,93,663,14.027149321266968
3955,330170205000066,83,119,91,97,92,83,47,29,565,76,641,11.856474258970358
3956,330170205000067,63,80,85,107,76,67,43,35,478,78,556,14.028776978417266
3957,330170205000068,99,107,99,99,94,53,27,25,551,52,603,8.623548922056385
3958,330170205000069,120,149,142,103,90,92,41,28,696,69,765,9.019607843137255
3959,330170205000070,32,34,52,31,36,25,11,17,210,28,238,11.764705882352942
3960,330170205000071,121,106,120,102,86,53,35,21,588,56,644,8.695652173913043
3961,330170205000072,79,117,100,91,100,68,31,32,555,63,618,10.194174757281553
3962,330170205000073,120,140,137,122,109,85,37,35,713,72,785,9.171974522292993
3963,330170205000074,97,109,119,96,81,55,44,27,557,71,628,11.305732484076433
3964,330170205000075,116,166,129,110,139,95,58,46,755,104,859,12.107101280558789
3965,330170205000076,63,82,77,72,72,47,39,22,413,61,474,12.869198312236287
3966,330170205000077,127,151,138,133,132,102,62,49,783,111,894,12.416107382550335
3967,330170205000078,71,99,104,89,100,78,47,42,541,89,630,14.126984126984127
3968,330170205000079,70,87,91,82,74,64,40,26,468,66,534,12.359550561797754
3969,330170205000080,52,71,76,61,77,53,35,36,390,71,461,15.401301518438178
3970,330170205000081,92,106,111,105,102,95,44,51,611,95,706,13.456090651558073
3971,330170205000082,37,35,37,37,37,22,11,10,205,21,226,9.29203539823009
3972,330170205000083,91,161,134,122,133,100,58,40,741,98,839,11.680572109654351
3973,330170205000084,33,77,100,81,97,83,42,40,471,82,553,14.828209764918626
3974,330170205000085,46,77,110,73,101,84,49,47,491,96,587,16.35434412265758
3975,330170205000086,79,105,121,100,114,115,48,41,634,89,723,12.309820193637622
3976,330170205000087,61,118,87,84,94,66,46,30,510,76,586,12.969283276450511
3977,330170205000088,147,218,189,167,187,142,82,55,1050,137,1187,11.541701769165964
3978,330170205000089,85,146,159,132,155,147,61,54,824,115,939,12.247071352502662
3979,330170205000090,92,154,144,149,112,88,62,49,739,111,850,13.058823529411764
3980,330170205000091,47,61,71,66,53,56,34,26,354,60,414,14.492753623188406
3981,330170205000092,34,52,64,63,46,49,42,28,308,70,378,18.51851851851852
3982,330170205000093,95,136,161,108,134,90,49,43,724,92,816,11.27450980392157
3983,330170205000094,67,103,124,107,87,60,42,22,548,64,612,10.457516339869281
3984,330170205000095,41,59,61,55,60,43,30,22,319,52,371,14.016172506738544
3985,330170205000096,109,129,153,141,105,110,52,70,747,122,869,14.039125431530495
3986,330170205000097,80,100,94,105,96,82,48,45,557,93,650,14.307692307692308
3987,330170205000098,64,106,124,84,100,108,61,56,586,117,703,16.642958748221908
3988,330170205000099,68,93,105,89,86,66,50,48,507,98,605,16.198347107438018
3989,330170205000100,75,75,101,87,76,59,30,30,473,60,533,11.25703564727955
3990,330170205000101,112,116,226,148,108,117,43,37,827,80,907,8.820286659316428
3991,330170205000102,49,68,80,58,74,53,43,33,382,76,458,16.593886462882097
3992,330170205000103,163,185,193,196,130,105,67,34,972,101,1073,9.412861136999068
3993,330170205000104,39,80,99,75,88,66,34,32,447,66,513,12.865497076023392
3994,330170205000105,62,75,100,94,71,62,47,22,464,69,533,12.945590994371482
3995,330170205000106,57,92,89,62,80,52,38,11,432,49,481,10.187110187110187
3996,330170205000107,32,38,47,31,24,29,27,7,201,34,235,14.46808510638298
3997,330170205000108,156,140,170,170,90,69,42,25,795,67,862,7.77262180974478
3998,330170205000109,299,179,397,261,109,120,71,24,1365,95,1460,6.506849315068493
3999,330170205000110,138,178,135,140,122,86,42,28,799,70,869,8.055235903337168
4000,330170205000111,159,162,166,132,134,87,42,30,840,72,912,7.894736842105263
4001,330170205000112,194,265,168,170,138,94,45,33,1029,78,1107,7.046070460704607
4002,330170205000113,174,211,158,171,132,104,54,27,950,81,1031,7.8564500484966056
4003,330170205000114,84,104,85,64,63,34,15,5,434,20,454,4.405286343612334
4004,330170205000115,81,101,61,62,38,28,14,4,371,18,389,4.627249357326479
4005,330170205000116,100,119,106,80,53,60,28,14,518,42,560,7.5
4006,330170205000117,93,98,106,110,63,57,38,35,527,73,600,12.166666666666666
4007,330170205000118,147,135,140,105,85,47,27,21,659,48,707,6.789250353606789
4008,330170205000119,70,88,98,67,69,33,23,24,425,47,472,9.957627118644067
4009,330170205000120,62,99,90,73,62,61,25,25,447,50,497,10.060362173038229
4010,330170205000121,68,63,94,64,55,45,24,20,389,44,433,10.161662817551964
4011,330170205000122,55,58,60,63,38,30,26,6,304,32,336,9.523809523809524
4012,330170205000123,73,98,100,105,90,80,44,25,546,69,615,11.21951219512195
4013,330170205000124,70,107,94,103,97,66,44,45,537,89,626,14.217252396166135
4014,330170205000125,53,73,82,83,77,69,47,35,437,82,519,15.79961464354528
4015,330170205000126,81,84,97,114,87,83,49,44,546,93,639,14.553990610328638
4016,330170205000127,48,67,78,55,56,59,30,24,363,54,417,12.949640287769784
4017,330170205000128,60,118,80,91,109,85,50,29,543,79,622,12.70096463022508
4018,330170205000129,69,102,107,110,98,109,59,52,595,111,706,15.722379603399434
4019,330170205000130,96,140,152,140,120,129,61,61,777,122,899,13.570634037819799
4020,330170205000131,33,48,61,56,42,48,28,21,288,49,337,14.540059347181009
4021,330170205000132,87,111,104,116,111,83,41,47,612,88,700,12.571428571428571
4022,330170205000133,60,82,63,84,56,55,29,30,400,59,459,12.854030501089325
4023,330170205000134,105,151,169,221,155,130,73,48,931,121,1052,11.50190114068441
4024,330170205000135,133,168,145,132,130,89,63,29,797,92,889,10.348706411698538
4025,330170205000136,72,83,88,75,81,74,42,30,473,72,545,13.211009174311927
4026,330170205000137,48,55,71,60,80,62,41,23,376,64,440,14.545454545454545
4027,330170205000138,52,55,81,69,80,69,18,29,406,47,453,10.375275938189846
4028,330170205000139,39,86,80,93,72,70,53,43,440,96,536,17.91044776119403
4029,330170205000140,74,105,97,102,86,76,33,39,540,72,612,11.764705882352942
4030,330170205000141,62,84,96,88,103,77,59,36,510,95,605,15.702479338842975
4031,330170205000142,69,107,102,111,110,103,64,62,602,126,728,17.307692307692307
4032,330170205000143,75,84,138,109,130,122,66,73,658,139,797,17.44040150564617
4033,330170205000144,82,99,76,99,97,79,43,34,532,77,609,12.64367816091954
4034,330170205000145,55,75,87,88,66,55,38,34,426,72,498,14.457831325301205
4035,330170205000146,57,81,70,88,63,81,41,36,440,77,517,14.893617021276595
4036,330170205000147,64,103,114,101,89,100,53,55,571,108,679,15.905743740795288
4037,330170205000148,71,88,121,121,106,96,70,35,603,105,708,14.830508474576272
4038,330170205000149,75,100,107,113,97,94,65,38,586,103,689,14.949201741654571
4039,330170205000150,88,128,113,134,138,109,65,73,710,138,848,16.27358490566038
4040,330170205000151,76,125,100,113,109,81,73,67,604,140,744,18.817204301075268
4041,330170205000152,118,168,141,137,136,100,60,48,800,108,908,11.894273127753303
4042,330170205000153,172,191,204,194,182,119,54,47,1062,101,1163,8.684436801375753
4043,330170205000154,74,82,107,128,85,71,50,18,547,68,615,11.05691056910569
4044,330170205000155,56,72,75,78,62,49,32,38,392,70,462,15.151515151515152
4045,330170205000156,88,105,141,103,95,92,58,40,624,98,722,13.573407202216066
4046,330170205000157,41,68,79,69,74,47,47,40,378,87,465,18.70967741935484
4047,330170205000158,86,84,97,91,79,76,39,30,513,69,582,11.855670103092784
4048,330170205000159,113,117,149,141,107,120,66,56,747,122,869,14.039125431530495
4049,330170205000160,83,108,138,117,102,111,63,53,659,116,775,14.96774193548387
4050,330170205000161,66,87,89,110,105,69,51,55,526,106,632,16.772151898734176
4051,330170205000162,79,119,122,107,109,99,54,60,635,114,749,15.220293724966622
4052,330170205000163,57,61,101,72,77,80,44,55,448,99,547,18.09872029250457
4053,330170205000164,60,78,104,70,83,77,54,35,472,89,561,15.864527629233512
4054,330170205000165,64,63,84,63,47,47,32,26,368,58,426,13.615023474178404
4055,330170205000166,66,68,82,73,57,75,40,37,421,77,498,15.461847389558233
4056,330170205000167,90,89,110,106,59,64,34,14,518,48,566,8.480565371024735
4057,330170205000168,63,66,67,73,51,39,19,22,359,41,400,10.25
4058,330170205000169,194,205,204,156,114,92,38,33,965,71,1036,6.853281853281853
4059,330170205000170,151,196,145,142,123,74,41,20,831,61,892,6.838565022421525
4060,330170205000171,88,99,139,104,106,77,37,40,613,77,690,11.159420289855072
4061,330170205000172,105,132,113,145,94,95,40,30,684,70,754,9.283819628647215
4062,330170205000173,144,197,175,163,179,116,93,57,974,150,1124,13.345195729537366
4063,330170205000174,91,124,142,160,117,110,65,67,744,132,876,15.068493150684931
4064,330170205000175,65,109,105,96,107,101,39,46,583,85,668,12.724550898203592
4065,330170205000176,31,55,67,54,59,43,37,29,309,66,375,17.6
4066,330170205000177,54,74,67,55,53,67,30,30,370,60,430,13.953488372093023
4067,330170205000178,76,112,112,102,94,106,55,40,602,95,697,13.629842180774748
4068,330170205000179,61,59,86,67,75,80,65,48,428,113,541,20.88724584103512
4069,330170205000180,58,87,121,92,75,79,50,37,512,87,599,14.524207011686144
4070,330170205000181,111,150,119,124,134,125,64,57,763,121,884,13.687782805429864
4071,330170205000182,74,116,94,91,96,90,34,47,561,81,642,12.616822429906541
4072,330170205000183,20,44,46,31,37,30,15,14,208,29,237,12.236286919831224
4073,330170205000184,99,96,89,71,56,45,30,12,456,42,498,8.433734939759036
4074,330170205000185,74,112,66,74,74,43,24,20,443,44,487,9.034907597535934
4075,330170205000186,24,32,21,28,22,19,9,15,146,24,170,14.117647058823529
4076,330170205000187,97,113,90,99,115,57,34,34,571,68,639,10.641627543035995
4077,330170205000188,41,73,82,72,42,51,37,32,361,69,430,16.046511627906977
4078,330170205000189,77,95,106,108,116,66,53,41,568,94,662,14.19939577039275
4079,330170205000190,48,60,63,57,69,50,29,26,347,55,402,13.681592039800995
4080,330170205000191,84,134,83,109,78,70,53,36,558,89,647,13.75579598145286
4081,330170205000192,99,134,154,127,147,98,61,44,759,105,864,12.152777777777779
4082,330170205000193,84,119,111,116,84,73,37,34,587,71,658,10.790273556231003
4083,330170205000194,46,85,73,118,127,30,22,41,479,63,542,11.623616236162361
4084,330170205000195,69,85,68,54,44,36,37,16,356,53,409,12.95843520782396
4085,330170205000196,90,134,107,84,70,58,32,35,543,67,610,10.98360655737705
4086,330170205000197,61,66,53,32,24,24,12,4,260,16,276,5.797101449275362
4087,330170205000198,117,174,91,105,78,51,27,18,616,45,661,6.80786686838124
4088,330170205000199,121,125,65,81,50,30,15,6,472,21,493,4.259634888438134
4089,330170205000200,109,157,148,134,106,89,46,41,743,87,830,10.481927710843374
4090,330170205000201,98,111,112,91,66,68,38,22,546,60,606,9.900990099009901
4091,330170205000202,54,60,65,73,54,50,26,24,356,50,406,12.31527093596059
4092,330170205000203,85,96,103,104,98,60,43,31,546,74,620,11.935483870967742
4093,330170205000204,78,112,122,99,94,88,52,56,593,108,701,15.406562054208274
4094,330170205000205,101,124,129,137,115,83,51,51,689,102,791,12.895069532237674
4095,330170205000206,50,72,81,63,72,53,39,22,391,61,452,13.495575221238939
4096,330170205000207,76,68,114,84,82,47,40,27,471,67,538,12.453531598513012
4097,330170205000208,64,85,89,101,80,72,34,24,491,58,549,10.564663023679417
4098,330170205000209,108,138,133,116,85,92,67,45,672,112,784,14.285714285714286
4099,330170205000210,97,105,125,91,99,68,43,39,585,82,667,12.293853073463268
4100,330170205000211,42,73,87,52,54,62,23,19,370,42,412,10.194174757281553
4101,330170205000212,71,101,75,105,62,60,38,31,474,69,543,12.707182320441989
4102,330170205000213,104,119,127,125,101,94,40,29,670,69,739,9.336941813261165
4103,330170205000214,106,151,184,174,124,140,75,55,879,130,1009,12.88404360753221
4104,330170205000215,85,116,101,81,85,60,30,22,528,52,580,8.96551724137931
4105,330170205000216,86,108,112,91,90,79,45,19,566,64,630,10.158730158730158
4106,330170205000217,109,109,99,132,88,66,68,37,603,105,708,14.830508474576272
4107,330170205000218,65,107,79,90,97,59,28,23,497,51,548,9.306569343065693
4108,330170205000219,134,166,148,163,107,81,44,40,799,84,883,9.513023782559456
4109,330170205000220,144,253,256,280,167,132,63,39,1232,102,1334,7.646176911544228
4110,330170205000221,82,81,93,119,64,79,42,44,518,86,604,14.23841059602649
4111,330170205000222,79,101,114,120,87,74,59,28,575,87,662,13.141993957703928
4112,330170205000223,84,112,91,106,96,71,38,31,560,69,629,10.9697933227345
4113,330170205000224,43,52,84,74,64,75,34,32,392,66,458,14.410480349344978
4114,330170205000225,116,166,170,126,110,72,37,37,760,74,834,8.872901678657074
4115,330170205000226,94,121,225,99,106,49,11,1,694,12,706,1.6997167138810199
4116,330170205000227,62,114,88,105,110,115,58,38,594,96,690,13.91304347826087
4117,330170205000228,117,131,119,119,111,72,46,23,669,69,738,9.34959349593496
4118,330170205000229,32,51,63,33,38,52,23,10,269,33,302,10.927152317880795
4119,330170205000230,71,88,91,66,64,71,19,19,451,38,489,7.770961145194274
4120,330170205000231,87,109,105,123,85,69,44,29,578,73,651,11.213517665130569
4121,330170205000232,76,97,88,81,94,74,61,36,510,97,607,15.980230642504118
4122,330170205000233,76,80,88,107,107,73,57,35,531,92,623,14.76725521669342
4123,330170205000234,84,121,126,99,130,110,50,71,670,121,791,15.29709228824273
4124,330170205000235,125,175,144,168,121,111,77,59,844,136,980,13.877551020408163
4125,330170205000236,73,87,103,80,87,87,43,40,517,83,600,13.833333333333334
4126,330170205000237,81,104,100,115,101,79,63,41,580,104,684,15.2046783625731
4127,330170205000238,79,147,135,122,111,119,46,43,713,89,802,11.097256857855362
4128,330170205000239,57,93,87,93,56,57,48,46,443,94,537,17.50465549348231
4129,330170205000240,54,96,80,67,47,55,24,18,399,42,441,9.523809523809524
4130,330170205000241,87,110,131,132,131,102,70,53,693,123,816,15.073529411764707
4131,330170205000242,118,196,172,171,196,117,85,57,970,142,1112,12.76978417266187
4132,330170205000243,54,65,86,76,73,74,35,27,428,62,490,12.653061224489797
4133,330170205000244,71,93,100,107,77,86,54,26,534,80,614,13.029315960912053
4134,330170205000245,44,71,75,42,68,51,25,23,351,48,399,12.030075187969924
4135,330170205000246,41,76,92,59,70,70,37,35,408,72,480,15.0
4136,330170205000247,69,85,89,94,86,72,31,42,495,73,568,12.852112676056338
4137,330170205000248,92,94,116,88,59,68,42,23,517,65,582,11.168384879725085
4138,330170205000249,95,136,116,99,117,95,61,84,658,145,803,18.05728518057285
4139,330170205000250,61,90,115,84,102,78,49,45,530,94,624,15.064102564102564
4140,330170205000251,84,119,133,110,113,118,55,44,677,99,776,12.757731958762887
4141,330170205000252,104,149,105,147,119,68,59,66,692,125,817,15.299877600979192
4142,330170205000253,49,62,76,46,51,49,25,28,333,53,386,13.73056994818653
4143,330170205000254,72,90,79,82,78,76,38,33,477,71,548,12.956204379562044
4144,330170205000255,72,99,119,87,105,65,44,38,547,82,629,13.036565977742448
4145,330170205000256,106,120,157,139,120,114,65,46,756,111,867,12.802768166089965
4146,330170205000257,78,95,130,86,114,86,47,31,589,78,667,11.694152923538232
4147,330170205000258,64,105,82,86,125,82,39,43,544,82,626,13.099041533546325
4148,330170205000259,59,87,75,77,88,73,38,42,459,80,539,14.84230055658627
4149,330170205000260,48,74,61,72,58,60,43,17,373,60,433,13.856812933025404
4150,330170205000261,51,76,69,66,63,50,17,14,375,31,406,7.635467980295567
4151,330170205000262,32,36,48,42,49,35,17,8,242,25,267,9.363295880149813
4152,330170205000263,67,71,103,92,43,69,29,13,445,42,487,8.624229979466119
4153,330170205000264,103,113,114,107,104,90,67,39,631,106,737,14.382632293080054
4154,330170205000265,71,108,87,95,70,65,38,26,496,64,560,11.428571428571429
4155,330170205000266,89,109,120,128,131,101,71,65,678,136,814,16.707616707616708
4156,330170205000267,111,151,166,158,149,92,63,45,827,108,935,11.550802139037433
4157,330170205000268,48,63,94,84,75,74,38,29,438,67,505,13.267326732673267
4158,330170205000269,74,80,100,77,96,75,45,36,502,81,583,13.893653516295025
4159,330170205000270,90,112,122,93,109,71,45,39,597,84,681,12.334801762114537
4160,330170205000271,102,128,119,131,83,105,61,31,668,92,760,12.105263157894736
4161,330170205000272,85,142,129,125,117,116,48,33,714,81,795,10.18867924528302
4162,330170205000273,73,112,86,83,105,77,49,31,536,80,616,12.987012987012987
4163,330170205000274,75,115,108,112,100,81,60,26,591,86,677,12.703101920236337
4164,330170205000275,102,101,131,118,103,104,50,41,659,91,750,12.133333333333333
4165,330170205000276,90,101,126,91,90,71,35,30,569,65,634,10.25236593059937
4166,330170205000277,41,99,118,98,77,89,57,38,522,95,617,15.39708265802269
4167,330170205000278,120,139,143,152,122,98,70,36,774,106,880,12.045454545454545
4168,330170205000279,243,275,212,163,126,86,49,34,1105,83,1188,6.986531986531986
4169,330170205000280,108,112,149,141,106,102,48,44,718,92,810,11.358024691358025
4170,330170205000281,63,58,54,43,57,47,27,16,322,43,365,11.780821917808218
4171,330170205000282,60,69,80,58,75,40,35,28,382,63,445,14.157303370786517
4172,330170205000283,123,144,126,131,109,101,42,37,734,79,813,9.71709717097171
4173,330170205000284,89,111,107,108,91,109,48,35,615,83,698,11.89111747851003
4174,330170205000285,94,82,100,108,61,78,58,36,523,94,617,15.235008103727715
4175,330170205000286,110,116,116,121,111,78,57,36,652,93,745,12.483221476510067
4176,330170205000287,73,83,91,82,77,60,28,27,466,55,521,10.556621880998081
4177,330170205000288,80,103,75,91,71,74,41,25,494,66,560,11.785714285714286
4178,330170205000289,55,93,81,71,89,70,45,23,459,68,527,12.903225806451612
4179,330170205000290,37,52,64,55,59,53,21,25,320,46,366,12.568306010928962
4180,330170205000291,47,76,110,75,66,87,63,55,461,118,579,20.379965457685664
4181,330170205000292,34,40,53,44,37,53,37,37,261,74,335,22.08955223880597
4182,330170205000293,51,92,71,82,72,80,36,34,448,70,518,13.513513513513514
4183,330170205000294,87,117,115,112,104,96,59,31,631,90,721,12.482662968099861
4184,330170205000295,119,172,159,132,134,113,79,34,829,113,942,11.995753715498939
4185,330170205000296,151,219,226,184,155,112,63,36,1047,99,1146,8.638743455497382
4186,330170205000297,100,126,99,127,77,69,51,41,598,92,690,13.333333333333334
4187,330170205000298,80,92,85,95,73,76,32,19,501,51,552,9.23913043478261
4188,330170205000299,217,238,226,207,183,139,70,54,1210,124,1334,9.295352323838081
4189,330170205000300,83,149,122,102,118,84,37,43,658,80,738,10.840108401084011
4190,330170205000301,100,139,124,118,103,91,60,34,675,94,769,12.223667100130038
4191,330170205000302,61,93,88,97,93,71,30,30,503,60,563,10.657193605683837
4192,330170205000303,63,92,95,90,87,72,42,32,499,74,573,12.914485165794066
4193,330170205000304,85,99,96,134,73,79,49,45,566,94,660,14.242424242424242
4194,330170205000305,77,119,93,99,62,55,29,16,505,45,550,8.181818181818182
4195,330170205000306,155,180,160,180,138,110,55,41,923,96,1019,9.421000981354268
4196,330170205000307,128,133,325,146,121,93,61,23,946,84,1030,8.155339805825243
4197,330170205000308,126,183,135,141,143,102,84,59,830,143,973,14.696813977389517
4198,330170205000309,102,139,124,111,115,98,43,34,689,77,766,10.052219321148826
4199,330170205000310,50,98,83,85,79,56,35,40,451,75,526,14.258555133079849
4200,330170205000311,61,87,96,70,81,79,34,18,474,52,526,9.885931558935361
4201,330170205000312,105,112,124,118,90,89,56,29,638,85,723,11.756569847856156
4202,330170205000313,54,79,68,85,65,40,35,15,391,50,441,11.337868480725623
4203,330170205000314,80,124,104,99,90,70,33,30,567,63,630,10.0
4204,330170205000315,121,157,163,139,143,87,59,40,810,99,909,10.891089108910892
4205,330170205000316,91,124,110,119,86,72,32,29,602,61,663,9.200603318250376
4206,330170205000317,100,127,121,113,80,63,36,29,604,65,669,9.715994020926756
4207,330170205000318,123,137,154,132,102,118,53,45,766,98,864,11.342592592592593
4208,330170205000319,42,48,33,38,47,23,18,10,231,28,259,10.81081081081081
4209,330170205000320,120,156,159,156,116,132,60,46,839,106,945,11.216931216931217
4210,330170205000321,104,161,143,147,130,90,56,41,775,97,872,11.123853211009175
4211,330170205000322,105,130,136,109,125,93,47,24,698,71,769,9.232769830949286
4212,330170205000323,49,83,74,72,42,70,37,28,390,65,455,14.285714285714286
4213,330170205000324,73,81,97,85,82,98,44,37,516,81,597,13.5678391959799
4214,330170205000325,103,139,130,137,112,90,39,35,711,74,785,9.426751592356688
4215,330170205000326,60,69,82,62,55,65,30,21,393,51,444,11.486486486486486
4216,330170205000327,46,47,52,41,40,48,24,23,274,47,321,14.641744548286605
4217,330170205000328,63,106,110,89,69,80,39,33,517,72,589,12.224108658743633
4218,330170205000329,55,72,84,85,85,62,32,27,443,59,502,11.752988047808765
4219,330170205000330,89,119,123,71,128,68,47,25,598,72,670,10.746268656716419
4220,330170205000331,97,120,99,83,95,52,32,20,546,52,598,8.695652173913043
4221,330170205000332,68,99,125,129,75,100,42,19,596,61,657,9.284627092846272
4222,330170205000333,95,109,100,84,73,57,35,26,518,61,579,10.535405872193436
4223,330170205000334,90,89,124,84,68,64,43,23,519,66,585,11.282051282051283
4224,330170205000335,136,123,137,154,104,68,54,35,722,89,811,10.974106041923552
4225,330170205000336,113,179,118,166,133,92,63,36,801,99,900,11.0
4226,330170205000337,92,117,121,131,104,82,48,34,647,82,729,11.248285322359397
4227,330170205000338,72,94,94,83,102,79,36,35,524,71,595,11.932773109243698
4228,330170205000339,93,139,126,129,124,83,59,31,694,90,784,11.479591836734693
4229,330170205000340,77,83,86,76,78,55,32,27,455,59,514,11.478599221789883
4230,330170205000341,141,210,189,177,131,73,36,31,921,67,988,6.781376518218623
4231,330170205000342,135,302,162,242,233,46,2,12,1120,14,1134,1.2345679012345678
4232,330170205000343,153,241,298,247,149,122,66,26,1210,92,1302,7.06605222734255
4233,330170205000344,129,192,146,124,143,89,40,34,823,74,897,8.249721293199554
4234,330170205000345,195,245,191,191,197,135,87,50,1154,137,1291,10.611928737412859
4235,330170205000346,129,215,140,206,127,73,34,26,890,60,950,6.315789473684211
4236,330170205000347,138,145,128,132,118,82,45,30,743,75,818,9.168704156479217
4237,330170205000348,98,127,126,106,89,63,49,20,609,69,678,10.176991150442477
4238,330170205000349,105,158,112,124,128,70,54,39,697,93,790,11.772151898734178
4239,330170205000350,53,76,61,79,49,38,34,18,356,52,408,12.745098039215685
4240,330170205000351,87,117,100,122,78,69,59,31,573,90,663,13.574660633484163
4241,330170205000352,68,82,96,81,60,81,41,30,468,71,539,13.172541743970315
4242,330170205000353,97,107,96,105,81,56,51,21,542,72,614,11.726384364820847
4243,330170205000354,116,183,220,225,175,70,17,23,989,40,1029,3.8872691933916426
4244,330170205000355,103,162,146,149,111,99,42,26,770,68,838,8.1145584725537
4245,330170205000356,57,126,93,91,82,78,47,25,527,72,599,12.020033388981636
4246,330170205000357,88,87,98,88,91,61,39,22,513,61,574,10.627177700348431
4247,330170205000358,136,198,158,141,115,97,46,26,845,72,917,7.851690294438386
4248,330170205000359,96,106,100,97,77,52,33,22,528,55,583,9.433962264150944
4249,330170205000360,79,85,99,97,85,52,42,29,497,71,568,12.5
4250,330170205000361,106,128,126,100,115,83,51,36,658,87,745,11.677852348993289
4251,330170205000362,42,94,141,114,107,71,34,16,569,50,619,8.077544426494345
4252,330170205000363,134,184,176,144,140,96,56,49,874,105,979,10.725229826353422
4253,330170205000364,53,52,76,69,41,48,42,34,339,76,415,18.313253012048193
4254,330170205000365,106,110,115,120,87,77,52,30,615,82,697,11.764705882352942
4255,330170205000366,93,112,136,105,110,92,43,39,648,82,730,11.232876712328768
4256,330170205000367,131,164,152,140,153,87,71,39,827,110,937,11.739594450373533
4257,330170205000368,100,96,95,97,98,46,38,26,532,64,596,10.738255033557047
4258,330170205000369,44,70,98,81,78,60,32,31,431,63,494,12.753036437246964
4259,330170205000370,84,103,106,94,96,84,36,44,567,80,647,12.364760432766616
4260,330170205000371,102,135,137,107,105,94,60,29,680,89,769,11.573472041612483
4261,330170205000372,109,174,146,134,150,104,67,56,817,123,940,13.085106382978724
4262,330170205000373,135,158,177,147,140,92,68,37,849,105,954,11.0062893081761
4263,330170205000374,118,131,157,134,120,82,43,27,742,70,812,8.620689655172415
4264,330170205000375,126,193,158,173,139,112,75,31,901,106,1007,10.526315789473685
4265,330170205000376,85,107,115,103,102,84,51,29,596,80,676,11.834319526627219
4266,330170205000377,181,191,209,171,142,114,51,23,1008,74,1082,6.839186691312385
4267,330170205000378,6,3,3,7,3,1,1,0,23,1,24,4.166666666666667
4268,330170205000379,163,231,259,205,185,118,60,22,1161,82,1243,6.59694288012872
4269,330170205000380,131,142,161,121,106,88,57,29,749,86,835,10.29940119760479
4270,330170205000381,124,175,174,139,156,103,61,45,871,106,977,10.849539406345958
4271,330170205000382,114,132,128,144,138,107,43,58,763,101,864,11.689814814814815
4272,330170205000383,74,110,113,83,77,56,31,37,513,68,581,11.703958691910499
4273,330170205000384,62,113,114,95,107,95,37,22,586,59,645,9.147286821705427
4274,330170205000385,93,135,142,145,84,76,42,34,675,76,751,10.119840213049267
4275,330170205000386,95,157,146,137,117,96,63,39,748,102,850,12.0
4276,330170205000387,78,95,84,108,91,57,26,22,513,48,561,8.556149732620321
4277,330170205000388,78,121,106,135,107,79,38,21,626,59,685,8.613138686131387
4278,330170205000389,82,107,114,127,109,96,53,55,635,108,743,14.535666218034994
4279,330170205000390,75,108,105,85,93,75,36,28,541,64,605,10.578512396694215
4280,330170205000391,113,126,147,138,112,101,47,26,737,73,810,9.012345679012345
4281,330170205000392,112,165,149,130,123,85,74,46,764,120,884,13.574660633484163
4282,330170205000393,48,53,66,38,47,51,35,17,303,52,355,14.647887323943662
4283,330170205000394,61,82,125,95,79,84,47,43,526,90,616,14.61038961038961
4284,330170205000395,57,71,69,82,65,63,32,27,407,59,466,12.660944206008583
4285,330170205000396,48,68,78,74,65,62,30,27,395,57,452,12.610619469026549
4286,330170205000397,70,74,81,94,91,62,45,33,472,78,550,14.181818181818182
4287,330170205000398,89,85,119,113,81,89,43,42,576,85,661,12.85930408472012
4288,330170205000399,59,77,97,81,83,73,58,38,470,96,566,16.96113074204947
4289,330170205000400,96,67,51,44,49,21,9,3,328,12,340,3.5294117647058822
4290,330170205000401,106,128,113,110,104,77,60,28,638,88,726,12.121212121212121
4291,330170205000402,98,128,133,130,123,99,75,34,711,109,820,13.292682926829269
4292,330170205000403,70,73,71,60,46,45,15,10,365,25,390,6.410256410256411
4293,330170205000404,119,142,122,108,78,60,31,17,629,48,677,7.0901033973412115
4294,330170205000405,56,79,83,90,74,64,31,35,446,66,512,12.890625
4295,330170205000406,71,102,105,72,91,61,40,36,502,76,578,13.14878892733564
4296,330170205000407,73,96,113,91,86,72,37,33,531,70,601,11.647254575707155
4297,330170205000408,43,41,59,39,49,31,28,22,262,50,312,16.025641025641026
4298,330170205000409,90,123,110,112,122,97,49,45,654,94,748,12.566844919786096
4299,330170205000410,46,64,86,48,57,54,35,13,355,48,403,11.910669975186105
4300,330170205000411,62,82,96,73,87,67,41,34,467,75,542,13.837638376383763
4301,330170205000412,134,172,143,127,114,93,30,25,783,55,838,6.563245823389021
4302,330170205000413,45,82,95,96,85,65,19,5,468,24,492,4.878048780487805
4303,330170205000414,66,112,85,101,94,76,16,6,534,22,556,3.9568345323741005
4304,330170205000415,91,118,144,85,117,106,44,33,661,77,738,10.433604336043361
4305,330170205000416,55,68,82,75,63,59,38,34,402,72,474,15.189873417721518
4306,330170205000417,70,129,77,111,113,70,30,31,570,61,631,9.667194928684628
4307,330170205000418,117,155,102,108,81,39,40,17,602,57,659,8.649468892261002
4308,330170205000419,32,34,61,51,56,38,12,14,272,26,298,8.724832214765101
4309,330170205000420,94,124,113,92,107,70,45,35,600,80,680,11.764705882352942
4310,330170205000421,98,153,143,129,147,94,69,38,764,107,871,12.284730195177957
4311,330170205000422,192,205,172,183,99,78,62,23,929,85,1014,8.382642998027613
4312,330170205000423,75,84,76,66,45,60,42,26,406,68,474,14.345991561181435
4313,330170205000424,123,125,134,127,123,94,49,36,726,85,811,10.480887792848335
4314,330170205000425,135,179,137,131,115,94,32,29,791,61,852,7.15962441314554
4315,330170205000426,63,80,87,81,96,54,27,34,461,61,522,11.685823754789272
4316,330170205000427,81,86,65,72,71,39,25,21,414,46,460,10.0
4317,330170205000428,104,124,132,89,98,82,45,27,629,72,701,10.271041369472183
4318,330170205000429,53,81,75,68,58,76,44,33,411,77,488,15.778688524590164
4319,330170205000430,91,102,98,92,75,52,26,27,510,53,563,9.41385435168739
4320,330170205000431,85,105,119,109,99,77,51,32,594,83,677,12.259970457902511
4321,330170205000432,34,28,35,34,42,22,13,6,195,19,214,8.878504672897197
4322,330170205000433,120,99,96,71,62,37,20,6,485,26,511,5.088062622309198
4323,330170205000434,129,149,107,113,112,67,37,32,677,69,746,9.249329758713136
4324,330170205000435,108,155,139,114,127,89,41,27,732,68,800,8.5
4325,330170205000436,16,24,21,26,34,13,19,10,134,29,163,17.791411042944784
4326,330170205000437,79,148,103,119,96,72,56,19,617,75,692,10.83815028901734
4327,330170205000438,135,161,150,140,98,77,45,44,761,89,850,10.470588235294118
4328,330170205000439,123,146,143,113,104,74,28,33,703,61,764,7.984293193717278
4329,330170205000440,75,83,102,89,75,37,46,17,461,63,524,12.022900763358779
4330,330170205000441,145,169,186,169,110,107,63,36,886,99,985,10.050761421319796
4331,330170205000442,99,85,71,71,35,24,13,4,385,17,402,4.2288557213930345
4332,330170205000443,398,335,344,250,174,100,38,19,1601,57,1658,3.4378769601930035
4333,330170205000444,158,215,138,163,138,77,47,36,889,83,972,8.539094650205762
4334,330170205000445,122,125,149,115,89,68,46,37,668,83,751,11.051930758988016
4335,330170205000446,77,87,84,94,69,55,37,24,466,61,527,11.574952561669829
4336,330170205000447,174,221,173,179,166,95,69,33,1008,102,1110,9.18918918918919
4337,330170205000448,101,117,121,102,91,59,39,29,591,68,659,10.318664643399089
4338,330170205000449,121,177,169,153,159,124,51,34,903,85,988,8.603238866396762
4339,330170205000450,144,165,169,154,136,118,73,50,886,123,1009,12.190287413280476
4340,330170205000451,138,167,168,169,123,85,58,23,850,81,931,8.70032223415682
4341,330170205000452,100,128,110,108,90,70,44,36,606,80,686,11.661807580174926
4342,330170205000453,138,159,156,122,124,64,39,33,763,72,835,8.622754491017965
4343,330170205000454,111,144,114,128,101,71,39,30,669,69,738,9.34959349593496
4344,330170205000455,69,100,96,91,79,67,33,21,502,54,556,9.712230215827338
4345,330170205000456,140,153,98,77,67,38,31,16,573,47,620,7.580645161290323
4346,330170205000457,71,140,155,148,169,149,84,54,832,138,970,14.22680412371134
4347,330170205000458,58,73,72,60,61,56,18,19,380,37,417,8.872901678657074
4348,330170205000459,441,291,380,217,174,133,60,31,1636,91,1727,5.269253039953677
4349,330170205000460,134,65,150,156,61,58,32,9,624,41,665,6.165413533834586
4350,330170205000461,76,98,108,87,63,60,40,16,492,56,548,10.218978102189782
4351,330170205000462,80,102,83,102,114,77,39,37,558,76,634,11.987381703470032
4352,330170205000463,24,24,18,29,33,10,13,11,138,24,162,14.814814814814815
4353,330170205000464,81,134,139,107,141,100,65,62,702,127,829,15.319662243667068
4354,330170205000465,49,63,70,57,55,48,37,16,342,53,395,13.417721518987342
4355,330170205000466,108,124,110,126,101,105,56,43,674,99,773,12.807244501940492
4356,330170205000467,88,81,118,109,86,51,39,33,533,72,605,11.900826446280991
4357,330170205000468,122,156,126,104,112,82,51,45,702,96,798,12.030075187969924
4358,330170205000469,63,95,93,71,77,62,46,19,461,65,526,12.357414448669202
4359,330170205000470,51,71,75,70,49,65,34,26,381,60,441,13.605442176870747
4360,330170205000471,209,232,178,166,151,98,60,16,1034,76,1110,6.846846846846847
4361,330170205000472,117,141,99,135,106,85,46,43,683,89,772,11.528497409326425
4362,330170205000473,192,224,168,171,108,73,51,22,936,73,1009,7.234886025768088
4363,330170205000474,364,363,278,237,156,90,26,18,1488,44,1532,2.8720626631853787
4364,330170205000475,221,216,260,210,105,44,12,12,1056,24,1080,2.2222222222222223
4365,330170205000476,161,147,140,125,95,68,29,20,736,49,785,6.24203821656051
4366,330170205000477,73,102,89,123,88,66,66,49,541,115,656,17.53048780487805
4367,330170205000478,101,105,100,97,82,67,34,32,552,66,618,10.679611650485437
4368,330170205000479,31,68,66,50,86,51,33,26,352,59,411,14.355231143552311
4369,330170205000480,58,70,92,85,59,83,46,30,447,76,523,14.531548757170173
4370,330170205000481,62,92,108,101,119,94,47,64,576,111,687,16.157205240174672
4371,330170205000482,36,62,80,61,76,74,32,31,389,63,452,13.938053097345133
4372,330170205000483,51,70,80,60,69,63,28,30,393,58,451,12.86031042128603
4373,330170205000484,61,72,74,71,72,54,36,27,404,63,467,13.490364025695932
4374,330170205000485,73,96,102,88,78,91,42,37,528,79,607,13.014827018121911
4375,330170205000486,58,80,75,86,58,49,45,22,406,67,473,14.16490486257928
4376,330170205000487,68,64,63,65,46,49,28,23,355,51,406,12.561576354679802
4377,330170205000488,283,292,223,227,139,98,50,22,1262,72,1334,5.397301349325337
4378,330170205000489,91,82,84,86,49,39,24,9,431,33,464,7.112068965517241
4379,330170205000490,85,121,101,80,70,34,25,9,491,34,525,6.476190476190476
4380,330170205000491,30,54,54,52,57,24,26,28,271,54,325,16.615384615384617
4381,330170205000492,67,93,91,74,79,75,36,43,479,79,558,14.157706093189963
4382,330170205000493,35,38,69,62,64,57,42,22,325,64,389,16.452442159383033
4383,330170205000494,36,62,50,45,37,39,30,11,269,41,310,13.225806451612904
4384,330170205000495,60,116,76,89,98,64,45,24,503,69,572,12.062937062937063
4385,330170205000496,103,112,97,100,98,84,51,37,594,88,682,12.903225806451612
4386,330170205000497,55,87,83,79,44,46,9,4,394,13,407,3.194103194103194
4387,330170205000498,88,108,90,93,83,77,43,23,539,66,605,10.909090909090908
4388,330170205000499,99,112,105,131,97,63,37,31,607,68,675,10.074074074074074
4389,330170205000500,92,106,109,110,79,107,49,27,603,76,679,11.192930780559646
4390,330170205000501,53,65,88,70,55,63,35,30,394,65,459,14.161220043572985
4391,330170205000502,67,109,103,94,101,76,19,28,550,47,597,7.872696817420436
4392,330170205000503,80,106,102,90,104,53,46,20,535,66,601,10.98169717138103
4393,330170205000504,139,153,144,174,120,103,51,31,833,82,915,8.96174863387978
4394,330170205000505,100,139,93,92,89,63,37,42,576,79,655,12.061068702290076
4395,330170205000506,121,155,137,130,89,82,41,25,714,66,780,8.461538461538462
4396,330170205000507,43,52,37,36,17,12,9,6,197,15,212,7.0754716981132075
4397,330170205000508,51,71,55,55,61,42,20,17,335,37,372,9.946236559139784
4398,330170205000509,59,77,61,68,45,58,19,14,368,33,401,8.229426433915211
4399,330170205000510,68,72,104,54,62,46,23,17,406,40,446,8.968609865470851
4400,330170205000511,46,85,47,48,43,21,8,7,290,15,305,4.918032786885246
4401,330170205000512,41,85,52,50,45,36,16,10,309,26,335,7.7611940298507465
4402,330170205000513,43,56,49,47,68,34,25,23,297,48,345,13.91304347826087
4403,330170205000514,174,187,149,145,94,56,32,23,805,55,860,6.395348837209302
4404,330170205000515,48,71,72,52,54,39,25,10,336,35,371,9.433962264150944
4405,330170205000516,135,142,110,111,63,53,41,18,614,59,673,8.766716196136702
4406,330170205000517,40,57,56,52,50,38,22,10,293,32,325,9.846153846153847
4407,330170205000518,27,38,37,38,29,36,14,5,205,19,224,8.482142857142858
4408,330170205000519,99,96,53,55,30,22,6,5,355,11,366,3.0054644808743167
4409,330170205000520,79,112,68,51,58,22,22,4,390,26,416,6.25
4410,330170205000521,113,99,89,90,55,36,16,3,482,19,501,3.7924151696606785
4411,330170205000522,142,154,157,163,96,73,24,9,785,33,818,4.034229828850855
4412,330170205000523,81,93,83,95,77,40,17,10,469,27,496,5.443548387096774
4413,330170205000524,100,105,96,115,75,52,14,6,543,20,563,3.552397868561279
4414,330170205000525,9,11,13,16,18,5,1,3,72,4,76,5.2631578947368425
4415,330170205000526,14,9,64,17,21,11,9,5,136,14,150,9.333333333333334
4416,330170205000527,102,130,133,110,77,76,41,8,628,49,677,7.23781388478582
4417,330170210000001,181,245,193,190,173,113,43,45,1095,88,1183,7.438715131022823
4418,330170210000002,226,259,236,210,216,143,45,33,1290,78,1368,5.701754385964913
4419,330170210000003,97,134,136,122,92,88,32,22,669,54,723,7.468879668049793
4420,330170210000004,45,56,53,48,48,28,23,11,278,34,312,10.897435897435898
4421,330170210000005,127,115,119,108,106,54,27,20,629,47,676,6.952662721893491
4422,330170210000006,97,156,119,108,105,53,36,19,638,55,693,7.936507936507937
4423,330170210000007,97,130,70,87,74,54,27,17,512,44,556,7.913669064748201
4424,330170210000008,99,112,96,99,74,56,22,23,536,45,581,7.74526678141136
4425,330170210000009,166,189,215,137,182,104,64,28,993,92,1085,8.47926267281106
4426,330170210000010,135,165,168,146,131,76,44,23,821,67,888,7.545045045045045
4427,330170210000011,30,36,43,46,36,21,21,16,212,37,249,14.859437751004016
4428,330170210000012,84,91,99,85,75,55,21,16,489,37,526,7.034220532319392
4429,330170210000013,150,206,150,145,128,64,46,27,843,73,916,7.96943231441048
4430,330170210000014,239,268,248,232,172,101,52,39,1260,91,1351,6.7357512953367875
4431,330170210000015,161,191,185,161,147,109,57,42,954,99,1053,9.401709401709402
4432,330170210000016,118,171,140,176,145,84,52,49,834,101,935,10.802139037433156
4433,330170210000017,127,121,154,126,103,92,56,33,723,89,812,10.960591133004925
4434,330170210000018,135,188,147,130,128,86,36,17,814,53,867,6.113033448673587
4435,330170210000019,17,6,15,8,12,8,2,5,66,7,73,9.58904109589041
4436,330170210000020,116,150,128,133,111,108,54,38,746,92,838,10.978520286396181
4437,330170210000021,163,196,170,142,124,125,55,32,920,87,1007,8.639523336643496
4438,330170210000022,60,98,76,59,76,52,39,17,421,56,477,11.740041928721174
4439,330170210000023,84,96,110,70,78,51,22,26,489,48,537,8.938547486033519
4440,330170210000024,106,115,98,95,79,65,20,19,558,39,597,6.532663316582915
4441,330170210000025,109,117,92,105,83,68,32,19,574,51,625,8.16
4442,330170210000026,38,52,44,35,32,19,12,10,220,22,242,9.090909090909092
4443,330170210000027,151,181,190,125,156,86,68,35,889,103,992,10.383064516129032
4444,330170210000028,143,186,178,157,145,111,56,46,920,102,1022,9.980430528375734
4445,330170210000029,83,112,88,88,59,60,29,23,490,52,542,9.59409594095941
4446,330170210000030,54,66,63,67,56,28,13,8,334,21,355,5.915492957746479
4447,330170210000031,102,157,92,92,78,60,29,16,581,45,626,7.18849840255591
4448,330170210000032,115,136,119,117,118,69,46,36,674,82,756,10.846560846560847
4449,330170210000033,74,98,83,75,56,43,26,16,429,42,471,8.9171974522293
4450,330170210000034,189,250,171,138,161,80,40,29,989,69,1058,6.521739130434782
4451,330170210000035,54,71,81,68,55,45,23,11,374,34,408,8.333333333333334
4452,330170210000036,79,96,87,76,78,52,35,19,468,54,522,10.344827586206897
4453,330170210000037,77,101,90,90,107,64,28,32,529,60,589,10.186757215619695
4454,330170210000038,107,142,110,136,87,82,49,30,664,79,743,10.63257065948856
4455,330170210000039,43,38,45,36,29,38,22,16,229,38,267,14.232209737827715
4456,330170210000040,139,188,166,159,146,109,68,45,907,113,1020,11.07843137254902
4457,330170210000041,130,171,146,169,135,98,79,39,849,118,967,12.20268872802482
4458,330170210000042,147,187,167,136,125,109,54,39,871,93,964,9.647302904564315
4459,330170210000043,128,145,161,118,127,82,45,18,761,63,824,7.645631067961165
4460,330170210000044,87,129,101,126,88,66,35,35,597,70,667,10.494752623688155
4461,330170210000045,81,111,136,106,100,112,51,32,646,83,729,11.385459533607682
4462,330170210000046,95,104,110,141,99,77,49,36,626,85,711,11.954992967651195
4463,330170210000047,100,116,120,104,99,67,32,31,606,63,669,9.417040358744394
4464,330170210000048,214,274,210,180,164,99,64,31,1141,95,1236,7.686084142394822
4465,330170210000049,115,105,109,137,95,101,52,46,662,98,760,12.894736842105264
4466,330170210000050,73,113,99,100,80,66,34,37,531,71,602,11.794019933554818
4467,330170210000051,105,121,111,109,113,70,30,45,629,75,704,10.653409090909092
4468,330170210000052,112,137,138,142,150,97,47,40,776,87,863,10.081112398609502
4469,330170210000053,73,128,93,98,88,83,30,22,563,52,615,8.455284552845528
4470,330170210000054,151,170,154,118,134,79,42,32,806,74,880,8.409090909090908
4471,330170210000055,180,281,266,225,236,215,85,49,1403,134,1537,8.718282368249838
4472,330170210000056,32,47,62,38,48,49,20,8,276,28,304,9.210526315789474
4473,330170210000057,206,225,215,186,153,114,46,38,1099,84,1183,7.100591715976331
4474,330170210000058,142,200,161,150,118,92,53,34,863,87,950,9.157894736842104
4475,330170210000059,147,215,117,179,133,77,48,26,868,74,942,7.855626326963907
4476,330170210000060,67,86,102,81,79,67,30,27,482,57,539,10.575139146567718
4477,330170210000061,96,78,89,89,66,62,36,21,480,57,537,10.614525139664805
4478,330170210000062,65,74,90,70,61,51,20,21,411,41,452,9.070796460176991
4479,330170210000063,71,113,91,79,83,72,40,37,509,77,586,13.139931740614335
4480,330170210000064,82,123,101,116,97,75,46,29,594,75,669,11.210762331838565
4481,330170210000065,24,18,43,20,37,29,16,11,171,27,198,13.636363636363637
4482,330170210000066,73,93,78,90,68,53,33,23,455,56,511,10.95890410958904
4483,330170210000067,78,102,94,88,91,83,52,40,536,92,628,14.64968152866242
4484,330170210000068,56,62,57,85,71,55,31,28,386,59,445,13.258426966292134
4485,330170210000069,123,150,135,97,102,65,25,21,672,46,718,6.406685236768802
4486,330170210000070,81,117,75,83,59,39,26,8,454,34,488,6.967213114754099
4487,330170210000071,38,39,44,39,16,11,9,12,187,21,208,10.096153846153847
4488,330170210000072,79,98,83,83,61,39,22,14,443,36,479,7.515657620041754
4489,330170210000073,150,181,180,156,104,107,59,30,878,89,967,9.20372285418821
4490,330170210000074,125,135,106,117,104,74,45,25,661,70,731,9.575923392612859
4491,330170210000075,106,134,93,125,97,77,39,14,632,53,685,7.737226277372263
4492,330170210000076,220,220,187,190,151,144,63,42,1112,105,1217,8.627773212818406
4493,330170210000077,211,241,210,195,192,146,81,49,1195,130,1325,9.81132075471698
4494,330170210000078,73,111,94,116,27,24,31,11,445,42,487,8.624229979466119
4495,330170210000079,179,116,170,154,74,48,49,2,741,51,792,6.4393939393939394
4496,330170210000081,176,214,163,148,107,102,39,26,910,65,975,6.666666666666667
4497,330170210000082,404,487,376,368,337,189,86,47,2161,133,2294,5.797733217088056
4498,330170210000083,60,68,64,71,74,47,35,28,384,63,447,14.093959731543624
4499,330170210000084,112,129,114,135,116,83,78,66,689,144,833,17.286914765906364
4500,330170210000085,53,80,85,83,85,59,45,40,445,85,530,16.037735849056602
4501,330170210000086,161,216,196,229,203,123,77,50,1128,127,1255,10.119521912350598
4502,330170210000087,146,180,138,156,129,54,60,17,803,77,880,8.75
4503,330170210000088,83,122,87,94,89,51,29,25,526,54,580,9.310344827586206
4504,330170210000089,50,63,92,71,64,72,39,33,412,72,484,14.87603305785124
4505,330170210000090,67,96,103,103,70,73,50,25,512,75,587,12.776831345826235
4506,330170210000091,60,92,93,97,90,53,42,28,485,70,555,12.612612612612613
4507,330170210000092,54,93,79,69,90,47,39,20,432,59,491,12.016293279022403
4508,330170210000093,44,45,62,72,46,38,17,25,307,42,349,12.034383954154729
4509,330170210000094,43,46,47,59,45,40,25,13,280,38,318,11.949685534591195
4510,330170210000095,295,352,345,274,199,111,96,42,1576,138,1714,8.051341890315053
4511,330170210000096,147,169,119,137,125,59,38,30,756,68,824,8.25242718446602
4512,330170210000097,163,178,162,127,151,103,61,29,884,90,974,9.240246406570842
4513,330170210000098,111,175,134,144,139,89,65,34,792,99,891,11.11111111111111
4514,330170210000099,127,195,127,153,125,85,63,48,812,111,923,12.026002166847237
4515,330170210000100,117,164,135,126,117,79,58,36,738,94,832,11.298076923076923
4516,330170210000101,54,84,85,62,71,43,28,17,399,45,444,10.135135135135135
4517,330170210000102,73,90,128,104,46,78,31,11,519,42,561,7.4866310160427805
4518,330170210000103,208,258,270,234,211,152,59,25,1333,84,1417,5.9280169371912494
4519,330170210000104,48,82,58,56,50,36,26,16,330,42,372,11.290322580645162
4520,330170210000105,86,80,112,86,77,81,41,34,522,75,597,12.56281407035176
4521,330170210000106,137,157,180,123,153,79,56,43,829,99,928,10.668103448275861
4522,330170210000107,106,162,158,157,131,102,53,44,816,97,913,10.624315443592552
4523,330170210000108,102,174,144,132,144,111,49,36,807,85,892,9.52914798206278
4524,330170210000109,129,153,145,131,111,79,47,34,748,81,829,9.7708082026538
4525,330170210000110,145,202,176,173,140,130,57,29,966,86,1052,8.17490494296578
4526,330170210000111,126,162,147,129,119,82,59,39,765,98,863,11.355735805330243
4527,330170210000112,196,206,163,194,126,94,42,29,979,71,1050,6.761904761904762
4528,330170210000113,99,98,157,121,82,55,46,21,612,67,679,9.867452135493373
4529,330170210000114,149,198,160,140,153,84,75,28,884,103,987,10.435663627152989
4530,330170210000115,102,144,124,103,146,71,47,42,690,89,779,11.424903722721437
4531,330170210000116,81,99,76,90,95,53,44,39,494,83,577,14.38474870017331
4532,330170210000117,163,230,160,179,136,84,37,17,952,54,1006,5.36779324055666
4533,330170210000118,130,207,186,153,146,71,34,25,893,59,952,6.197478991596639
4534,330170210000119,149,202,179,138,149,119,68,41,936,109,1045,10.430622009569378
4535,330170210000120,120,156,121,121,129,72,51,35,719,86,805,10.683229813664596
4536,330170210000121,133,162,160,161,125,110,51,43,851,94,945,9.947089947089948
4537,330170210000122,105,141,129,142,118,85,61,33,720,94,814,11.547911547911548
4538,330170210000123,116,163,228,129,78,58,33,14,772,47,819,5.738705738705739
4539,330170210000124,61,87,66,68,71,36,33,22,389,55,444,12.387387387387387
4540,330170210000125,101,113,123,105,104,55,43,35,601,78,679,11.487481590574374
4541,330170210000126,68,111,77,52,56,43,25,13,407,38,445,8.539325842696629
4542,330170210000127,104,117,119,78,74,46,24,14,538,38,576,6.597222222222222
4543,330170210000128,87,112,107,100,120,56,42,18,582,60,642,9.345794392523365
4544,330170210000129,269,281,237,318,186,153,96,34,1444,130,1574,8.259212198221093
4545,330170210000130,92,124,123,103,90,85,40,34,617,74,691,10.709117221418234
4546,330170210000131,63,84,86,82,62,43,44,24,420,68,488,13.934426229508198
4547,330170210000132,46,71,65,57,41,55,42,29,335,71,406,17.48768472906404
4548,330170210000133,130,127,151,125,87,83,50,27,703,77,780,9.871794871794872
4549,330170210000134,176,168,180,127,107,90,46,21,848,67,915,7.3224043715847
4550,330170210000135,75,126,103,75,105,53,34,19,537,53,590,8.983050847457626
4551,330170210000136,105,122,109,91,79,53,29,5,559,34,593,5.733558178752108
4552,330170210000137,137,175,165,135,121,71,47,37,804,84,888,9.45945945945946
4553,330170210000138,52,75,80,63,54,65,50,45,389,95,484,19.628099173553718
4554,330170210000139,74,120,122,132,112,91,36,32,651,68,719,9.457579972183588
4555,330170210000140,93,137,175,161,125,71,36,30,762,66,828,7.971014492753623
4556,330170210000141,103,116,109,111,76,63,44,24,578,68,646,10.526315789473685
4557,330170210000142,112,157,155,129,113,72,29,29,738,58,796,7.28643216080402
4558,330170210000143,102,129,121,127,106,63,48,27,648,75,723,10.37344398340249
4559,330170210000144,157,167,105,123,63,48,17,12,663,29,692,4.190751445086705
4560,330170210000145,131,170,150,148,115,92,68,31,806,99,905,10.939226519337016
4561,330170210000146,59,79,73,56,69,38,22,19,374,41,415,9.879518072289157
4562,330170210000147,213,308,234,160,163,120,69,53,1198,122,1320,9.242424242424242
4563,330170210000149,78,92,65,43,45,38,15,17,361,32,393,8.142493638676845
4564,330170210000150,28,31,26,30,25,12,4,6,152,10,162,6.172839506172839
4565,330170210000151,50,51,26,38,29,21,10,5,215,15,230,6.521739130434782
4566,330170210000152,109,139,214,154,146,69,53,30,831,83,914,9.080962800875273
4567,330170210000153,45,76,55,69,78,46,31,23,369,54,423,12.76595744680851
4568,330170210000154,173,165,160,134,98,63,38,17,793,55,848,6.485849056603773
4569,330170210000155,73,91,133,116,82,74,53,25,569,78,647,12.055641421947449
4570,330170210000156,114,128,113,142,114,100,76,38,711,114,825,13.818181818181818
4571,330170210000157,174,190,152,151,95,80,40,18,842,58,900,6.444444444444445
4572,330170210000158,128,160,101,109,82,58,26,16,638,42,680,6.176470588235294
4573,330170210000159,221,220,193,165,128,87,43,36,1014,79,1093,7.227813357731016
4574,330170210000160,48,103,66,86,51,36,26,10,390,36,426,8.450704225352112
4575,330170210000161,143,119,111,125,71,54,28,10,623,38,661,5.748865355521937
4576,330170210000162,80,138,97,93,86,44,25,20,538,45,583,7.718696397941681
4577,330170210000163,94,100,77,98,64,38,18,12,471,30,501,5.9880239520958085
4578,330170210000164,171,234,196,225,132,97,57,25,1055,82,1137,7.211961301671065
4579,330170210000165,48,69,59,54,52,32,18,20,314,38,352,10.795454545454545
4580,330170210000166,131,132,143,102,87,57,41,9,652,50,702,7.122507122507122
4581,330170210000167,41,70,122,96,65,18,15,6,412,21,433,4.849884526558891
4582,330170210000168,76,84,88,64,58,32,29,22,402,51,453,11.258278145695364
4583,330170210000169,125,158,182,167,142,96,35,28,870,63,933,6.752411575562701
4584,330170210000170,89,115,145,125,97,72,41,34,643,75,718,10.445682451253482
4585,330170210000171,65,88,104,114,65,48,27,4,484,31,515,6.019417475728155
4586,330170210000172,49,46,91,72,63,65,33,23,386,56,442,12.669683257918551
4587,330170210000173,66,65,62,67,51,38,27,15,349,42,391,10.741687979539641
4588,330170210000174,45,71,86,68,68,66,32,35,404,67,471,14.225053078556263
4589,330170210000175,90,97,104,93,90,48,45,30,522,75,597,12.56281407035176
4590,330170210000176,197,212,170,210,145,109,41,31,1043,72,1115,6.457399103139013
4591,330170210000177,83,89,102,124,110,86,53,46,594,99,693,14.285714285714286
4592,330170210000178,40,47,59,51,46,50,27,17,293,44,337,13.056379821958457
4593,330170210000179,30,55,55,54,55,27,16,7,276,23,299,7.6923076923076925
4594,330170210000180,56,93,109,71,113,98,25,22,540,47,587,8.006814310051107
4595,330170210000181,93,116,118,131,126,68,38,38,652,76,728,10.43956043956044
4596,330170210000182,59,61,82,43,86,58,26,33,389,59,448,13.169642857142858
4597,330170210000183,40,61,53,95,88,71,34,31,408,65,473,13.742071881606766
4598,330170210000184,192,211,187,218,203,125,57,47,1136,104,1240,8.387096774193548
4599,330170210000185,221,277,235,215,208,114,70,41,1270,111,1381,8.037653874004345
4600,330170210000186,70,96,82,113,104,50,60,35,515,95,610,15.573770491803279
4601,330170210000187,99,112,96,112,113,68,62,32,600,94,694,13.544668587896254
4602,330170210000188,130,162,143,159,132,70,54,24,796,78,874,8.924485125858123
4603,330170210000189,88,115,119,137,92,70,48,35,621,83,704,11.789772727272727
4604,330170210000190,114,141,165,141,127,103,63,37,791,100,891,11.22334455667789
4605,330170210000191,36,37,51,43,46,46,30,19,259,49,308,15.909090909090908
4606,330170210000192,123,143,121,141,132,91,46,43,751,89,840,10.595238095238095
4607,330170210000193,98,174,149,137,144,112,42,47,814,89,903,9.856035437430787
4608,330170210000194,161,224,178,151,144,82,51,24,940,75,1015,7.389162561576355
4609,330170210000195,178,180,141,156,101,70,42,18,826,60,886,6.772009029345372
4610,330170210000196,163,216,192,159,161,117,72,42,1008,114,1122,10.16042780748663
4611,330170210000197,77,87,104,67,82,42,33,23,459,56,515,10.87378640776699
4612,330170210000198,111,148,119,89,60,46,25,10,573,35,608,5.756578947368421
4613,330170210000199,258,291,230,228,175,130,52,36,1312,88,1400,6.285714285714286
4614,330170210000200,107,121,112,90,88,61,35,21,579,56,635,8.818897637795276
4615,330170210000201,93,85,109,78,62,51,30,22,478,52,530,9.81132075471698
4616,330170210000202,121,177,169,157,119,108,47,46,851,93,944,9.851694915254237
4617,330170210000203,134,154,154,146,121,97,44,41,806,85,891,9.539842873176207
4618,330170210000204,75,95,120,96,90,66,39,30,542,69,611,11.292962356792144
4619,330170210000205,44,74,52,53,64,47,18,17,334,35,369,9.48509485094851
4620,330170210000206,74,102,91,100,93,78,38,36,538,74,612,12.091503267973856
4621,330170210000207,62,63,84,56,67,43,24,18,375,42,417,10.071942446043165
4622,330170210000208,51,81,64,68,74,59,23,32,397,55,452,12.168141592920353
4623,330170210000209,73,47,86,45,47,43,29,26,341,55,396,13.88888888888889
4624,330170210000210,106,181,130,130,137,81,35,40,765,75,840,8.928571428571429
4625,330170210000211,161,241,178,196,177,94,48,40,1047,88,1135,7.753303964757709
4626,330170210000212,130,144,153,102,107,71,29,34,707,63,770,8.181818181818182
4627,330170210000213,103,125,112,99,98,74,41,29,611,70,681,10.279001468428781
4628,330170210000214,43,67,76,59,61,40,30,17,346,47,393,11.959287531806616
4629,330170210000215,83,90,82,80,84,54,23,40,473,63,536,11.753731343283581
4630,330170210000216,143,133,181,126,140,118,57,42,841,99,940,10.53191489361702
4631,330170210000217,124,149,137,117,105,75,43,33,707,76,783,9.706257982120052
4632,330170210000218,134,160,136,154,129,60,45,29,773,74,847,8.736717827626919
4633,330170210000219,106,136,106,94,88,64,29,24,594,53,647,8.191653786707883
4634,330170210000220,131,121,135,106,98,51,32,31,642,63,705,8.936170212765957
4635,330170210000221,178,206,142,150,119,96,37,21,891,58,949,6.111696522655427
4636,330170210000222,152,160,120,119,89,63,39,23,703,62,765,8.104575163398692
4637,330170210000223,104,146,158,125,70,63,41,24,666,65,731,8.891928864569083
4638,330170210000224,347,320,361,314,173,59,20,7,1574,27,1601,1.6864459712679576
4639,330170210000225,87,88,83,66,52,25,15,10,401,25,426,5.868544600938967
4640,330170210000226,299,273,367,227,147,55,67,24,1368,91,1459,6.237148732008225
4641,330170210000227,92,110,81,70,83,44,22,19,480,41,521,7.869481765834933
4642,330170210000228,225,221,339,323,190,93,31,7,1391,38,1429,2.6592022393282013
4643,330170210000229,125,173,159,102,104,73,43,17,736,60,796,7.5376884422110555
4644,330170210000230,94,95,62,78,53,33,19,9,415,28,443,6.320541760722348
4645,330170210000231,368,384,388,240,119,75,56,27,1574,83,1657,5.009052504526252
4646,330170210000232,95,130,89,91,65,32,27,6,502,33,535,6.168224299065421
4647,330170210000233,56,100,64,81,77,57,45,33,435,78,513,15.2046783625731
4648,330170210000234,64,83,71,72,37,38,14,12,365,26,391,6.649616368286445
4649,330170210000235,81,102,83,88,83,56,33,22,493,55,548,10.036496350364963
4650,330170210000236,205,236,203,212,156,131,70,42,1143,112,1255,8.92430278884462
4651,330170210000237,207,245,175,198,121,84,46,25,1030,71,1101,6.448683015440508
4652,330170210000238,133,145,134,119,102,70,36,26,703,62,765,8.104575163398692
4653,330170210000239,98,117,95,98,105,68,46,26,581,72,653,11.0260336906585
4654,330170210000240,152,187,194,151,126,90,61,24,900,85,985,8.629441624365482
4655,330170210000241,90,115,112,90,71,66,31,20,544,51,595,8.571428571428571
4656,330170210000242,105,142,114,145,84,64,44,27,654,71,725,9.793103448275861
4657,330170210000243,117,123,126,150,119,72,39,34,707,73,780,9.35897435897436
4658,330170210000244,123,141,100,147,128,76,48,17,715,65,780,8.333333333333334
4659,330170210000245,65,87,75,74,75,55,33,29,431,62,493,12.57606490872211
4660,330170210000246,156,195,168,165,130,117,65,33,931,98,1029,9.523809523809524
4661,330170210000247,185,205,190,171,143,93,53,47,987,100,1087,9.19963201471941
4662,330170210000248,78,113,89,81,101,54,41,31,516,72,588,12.244897959183673
4663,330170210000249,204,265,216,221,163,115,59,34,1184,93,1277,7.282693813625685
4664,330170210000250,102,128,80,99,56,65,26,16,530,42,572,7.3426573426573425
4665,330170210000251,187,194,158,137,119,98,43,28,893,71,964,7.365145228215767
4666,330170210000252,98,140,131,154,100,108,38,26,731,64,795,8.050314465408805
4667,330170210000253,50,49,69,68,60,38,32,17,334,49,383,12.793733681462141
4668,330170210000254,70,101,115,85,86,89,39,22,546,61,607,10.049423393739703
4669,330170210000255,112,146,162,145,159,92,45,36,816,81,897,9.03010033444816
4670,330170210000256,72,111,139,83,123,91,40,42,619,82,701,11.697574893009985
4671,330170210000257,89,118,120,99,100,78,45,24,604,69,673,10.252600297176821
4672,330170210000258,127,163,135,113,119,76,50,29,733,79,812,9.729064039408867
4673,330170210000259,119,158,128,139,106,83,40,38,733,78,811,9.617755856966708
4674,330170210000260,114,146,124,110,97,59,40,14,650,54,704,7.670454545454546
4675,330170210000261,63,108,57,79,78,39,25,19,424,44,468,9.401709401709402
4676,330170210000262,211,291,215,222,160,119,78,50,1218,128,1346,9.50965824665676
4677,330170210000263,249,261,207,215,146,113,58,35,1191,93,1284,7.242990654205608
4678,330170210000264,102,129,108,118,109,71,40,37,637,77,714,10.784313725490197
4679,330170210000265,57,101,64,80,60,42,32,16,404,48,452,10.619469026548673
4680,330170210000266,112,100,80,105,59,40,17,14,496,31,527,5.882352941176471
4681,330170210000267,41,61,49,55,38,23,10,11,267,21,288,7.291666666666667
4682,330170210000268,147,175,113,136,89,58,27,18,718,45,763,5.897771952817824
4683,330170210000269,86,123,98,99,87,68,43,26,561,69,630,10.952380952380953
4684,330170210000270,56,104,103,81,89,58,43,25,491,68,559,12.164579606440071
4685,330170210000271,99,108,109,78,90,78,41,28,562,69,631,10.935023771790808
4686,330170210000272,94,173,131,139,154,106,55,46,797,101,898,11.247216035634743
4687,330170210000273,104,153,126,122,147,105,57,52,757,109,866,12.58660508083141
4688,330170210000274,88,75,75,73,52,32,30,10,395,40,435,9.195402298850574
4689,330170210000275,54,68,63,75,56,52,37,22,368,59,427,13.817330210772834
4690,330170210000276,216,294,239,253,166,125,62,33,1293,95,1388,6.844380403458214
4691,330170210000277,88,90,104,94,79,79,40,39,534,79,613,12.887438825448614
4692,330170210000278,96,151,141,141,93,99,36,29,721,65,786,8.26972010178117
4693,330170210000279,186,222,149,182,118,93,50,23,950,73,1023,7.135874877810362
4694,330170210000280,168,139,118,107,72,43,32,17,647,49,696,7.040229885057471
4695,330170210000281,205,345,219,221,214,113,43,28,1317,71,1388,5.115273775216139
4696,330170210000282,80,118,120,104,106,68,37,48,596,85,681,12.481644640234949
4697,330170210000283,97,106,115,126,123,67,61,41,634,102,736,13.858695652173912
4698,330170210000284,78,153,128,118,114,76,58,18,667,76,743,10.228802153432031
4699,330170210000285,151,155,177,176,129,84,59,32,872,91,963,9.44963655244029
4700,330170210000286,102,127,123,124,81,66,48,23,623,71,694,10.230547550432277
4701,330170210000287,125,116,131,127,68,79,38,26,646,64,710,9.014084507042254
4702,330170210000288,106,136,110,134,97,83,54,39,666,93,759,12.25296442687747
4703,330170210000289,140,147,126,117,109,73,38,29,712,67,779,8.600770218228497
4704,330170210000290,166,191,159,138,97,63,22,33,814,55,869,6.329113924050633
4705,330170210000291,143,162,162,176,122,84,49,27,849,76,925,8.216216216216216
4706,330170210000292,91,122,121,95,95,64,33,18,588,51,639,7.981220657276995
4707,330170210000293,82,59,67,56,41,44,24,9,349,33,382,8.638743455497382
4708,330170210000294,17,17,11,8,7,3,1,0,63,1,64,1.5625
4709,330170210000295,119,118,118,150,118,80,40,21,703,61,764,7.984293193717278
4710,330170210000296,139,164,167,167,191,84,38,31,912,69,981,7.033639143730887
4711,330170210000297,127,194,130,131,150,96,55,32,828,87,915,9.508196721311476
4712,330170210000298,81,109,109,109,138,112,40,28,658,68,726,9.366391184573002
4713,330170210000299,107,124,109,135,100,74,39,29,649,68,717,9.483960948396096
4714,330170210000300,116,127,155,129,120,114,63,32,761,95,856,11.098130841121495
4715,330170210000301,108,123,154,136,111,68,29,43,700,72,772,9.32642487046632
4716,330170210000302,50,57,56,51,51,29,18,8,294,26,320,8.125
4717,330170210000303,134,137,142,113,103,81,42,31,710,73,783,9.323116219667943
4718,330170210000304,78,102,107,106,88,47,43,15,528,58,586,9.897610921501707
4719,330170210000305,119,118,134,126,98,80,52,27,675,79,754,10.477453580901857
4720,330170210000306,229,252,201,245,203,136,90,31,1266,121,1387,8.723864455659697
4721,330170210000307,205,283,250,207,186,129,66,42,1260,108,1368,7.894736842105263
4722,330170210000308,112,142,128,114,95,87,50,24,678,74,752,9.840425531914894
4723,330170210000309,124,173,137,120,124,89,33,34,767,67,834,8.03357314148681
4724,330170210000310,60,85,62,74,67,53,31,14,401,45,446,10.089686098654708
4725,330170210000311,40,55,71,55,35,33,23,18,289,41,330,12.424242424242424
4726,330170210000312,39,52,55,57,31,35,25,13,269,38,307,12.37785016286645
4727,330170210000313,53,76,61,67,55,35,29,17,347,46,393,11.704834605597965
4728,330170210000314,55,85,51,56,48,39,18,7,334,25,359,6.963788300835654
4729,330170210000315,80,96,95,80,85,77,46,48,513,94,607,15.485996705107084
4730,330170210000316,65,76,71,88,79,59,27,26,438,53,491,10.79429735234216
4731,330170210000317,104,190,144,149,133,105,61,35,825,96,921,10.423452768729641
4732,330170210000318,64,58,53,59,29,42,26,12,305,38,343,11.078717201166182
4733,330170210000319,190,162,213,294,177,84,56,22,1120,78,1198,6.510851419031719
4734,330170210000320,58,96,74,71,59,42,35,13,400,48,448,10.714285714285714
4735,330170210000321,56,88,77,88,98,57,34,29,464,63,527,11.954459203036054
4736,330170210000322,43,55,54,44,38,34,18,9,268,27,295,9.152542372881356
4737,330170210000323,156,156,158,178,120,63,35,27,831,62,893,6.942889137737962
4738,330170210000324,473,488,373,390,302,138,67,30,2164,97,2261,4.2901371074745684
4739,330170210000325,252,250,171,182,153,101,36,21,1109,57,1166,4.888507718696398
4740,330170210000326,143,163,152,136,114,80,42,31,788,73,861,8.478513356562138
4741,330170210000327,80,151,113,101,72,69,26,25,586,51,637,8.006279434850864
4742,330170210000328,174,235,273,297,216,83,54,34,1278,88,1366,6.44216691068814
4743,330170210000329,91,128,154,83,133,82,52,42,671,94,765,12.287581699346406
4744,330170210000330,296,319,258,248,237,145,72,38,1503,110,1613,6.819590824550527
4745,330170210000331,178,204,162,167,129,69,30,18,909,48,957,5.015673981191223
4746,330170210000332,160,150,139,148,93,59,32,13,749,45,794,5.667506297229219
4747,330170210000333,143,201,175,158,160,97,50,41,934,91,1025,8.878048780487806
4748,330170210000334,187,265,332,335,220,95,61,23,1434,84,1518,5.533596837944664
4749,330170210000335,52,77,57,80,49,46,24,22,361,46,407,11.302211302211303
4750,330170210000336,250,313,229,194,162,98,52,68,1246,120,1366,8.784773060029282
4751,330170210000337,77,79,47,55,41,24,13,6,323,19,342,5.555555555555555
4752,330170210000338,155,140,120,120,89,52,38,11,676,49,725,6.758620689655173
4753,330170210000339,115,137,136,115,104,62,32,29,669,61,730,8.356164383561644
4754,330170210000340,177,180,165,149,135,80,36,24,886,60,946,6.342494714587738
4755,330170210000341,118,170,116,168,150,96,46,39,818,85,903,9.413067552602437
4756,330170210000342,152,204,188,192,199,96,56,32,1031,88,1119,7.864164432529043
4757,330170210000343,44,47,67,60,64,43,27,20,325,47,372,12.634408602150538
4758,330170210000344,100,110,122,140,94,57,39,13,623,52,675,7.703703703703703
4759,330170210000345,76,100,102,128,103,61,36,19,570,55,625,8.8
4760,330170210000346,242,225,171,143,109,90,29,19,980,48,1028,4.669260700389105
4761,330170210000347,129,210,156,164,132,88,59,29,879,88,967,9.100310237849017
4762,330170210000348,150,168,162,171,167,111,39,29,929,68,997,6.820461384152457
4763,330170210000349,94,123,113,109,111,67,42,19,617,61,678,8.997050147492626
4764,330170210000350,129,169,138,153,107,106,55,18,802,73,875,8.342857142857143
4765,330170210000351,80,82,105,76,65,64,36,18,472,54,526,10.26615969581749
4766,330170210000352,97,131,135,105,95,87,40,27,650,67,717,9.344490934449093
4767,330170210000353,125,149,120,125,92,75,59,37,686,96,782,12.27621483375959
4768,330170210000354,87,112,79,98,71,57,31,11,504,42,546,7.6923076923076925
4769,330170210000355,213,229,210,231,185,136,75,28,1204,103,1307,7.880642693190513
4770,330170210000356,57,60,59,54,35,40,24,10,305,34,339,10.029498525073747
4771,330170210000357,84,111,111,87,87,63,49,28,543,77,620,12.419354838709678
4772,330170210000358,84,97,102,79,74,45,22,13,481,35,516,6.782945736434108
4773,330170210000359,96,93,89,91,73,34,21,9,476,30,506,5.928853754940712
4774,330170210000360,149,174,172,149,135,108,47,30,887,77,964,7.987551867219917
4775,330170210000361,88,107,84,92,80,40,23,20,491,43,534,8.05243445692884
4776,330170210000362,127,89,119,190,100,72,31,15,697,46,743,6.191117092866756
4777,330170210000363,68,96,118,74,93,79,38,23,528,61,589,10.356536502546689
4778,330170210000364,70,95,62,54,36,30,4,6,347,10,357,2.8011204481792715
4779,330170210000365,125,140,115,125,78,50,28,21,633,49,682,7.18475073313783
4780,330170210000366,69,100,84,81,89,60,26,35,483,61,544,11.213235294117647
4781,330170210000367,194,236,203,214,159,117,68,44,1123,112,1235,9.068825910931174
4782,330170210000368,108,101,140,112,82,64,34,30,607,64,671,9.538002980625931
4783,330170210000369,148,191,164,174,119,109,38,36,905,74,979,7.558733401430031
4784,330170210000370,67,57,77,94,72,65,34,28,432,62,494,12.550607287449393
4785,330170210000371,129,145,119,109,115,72,30,15,689,45,734,6.130790190735695
4786,330170210000372,72,115,102,124,80,71,29,24,564,53,617,8.589951377633712
4787,330170210000373,84,87,100,98,74,60,28,18,503,46,549,8.37887067395264
4788,330170210000374,14,21,27,17,16,17,9,6,112,15,127,11.811023622047244
4789,330170210000375,32,44,45,38,35,21,8,10,215,18,233,7.725321888412017
4790,330170210000376,44,54,45,43,48,27,20,15,261,35,296,11.824324324324325
4791,330170210000377,165,200,154,153,111,65,30,20,848,50,898,5.567928730512249
4792,330170210000378,82,80,68,67,54,40,21,12,391,33,424,7.783018867924528
4793,330170210000379,76,122,92,69,75,57,26,20,491,46,537,8.56610800744879
4794,330170210000380,180,189,145,160,127,72,17,20,873,37,910,4.065934065934066
4795,330170210000381,14,19,24,21,16,9,11,3,103,14,117,11.965811965811966
4796,330170210000382,137,167,146,167,135,88,59,31,840,90,930,9.67741935483871
4797,330170210000383,61,84,90,88,46,23,11,9,392,20,412,4.854368932038835
4798,330170210000384,100,108,87,84,57,50,25,16,486,41,527,7.7798861480075905
4799,330170210000385,120,165,104,96,90,52,24,19,627,43,670,6.417910447761194
4800,330170210000386,153,190,132,149,111,66,45,21,801,66,867,7.612456747404845
4801,330170210000387,170,211,193,186,203,101,62,47,1064,109,1173,9.292412617220801
4802,330170210000388,200,219,159,184,140,66,26,19,968,45,1013,4.4422507403751235
4803,330170210000389,172,231,239,175,129,42,20,13,988,33,1021,3.2321253672869736
4804,330170210000390,231,237,321,316,219,111,54,8,1435,62,1497,4.141616566466266
4805,330170215000001,72,95,89,104,85,55,38,25,500,63,563,11.190053285968029
4806,330170215000002,143,178,158,172,98,95,57,30,844,87,931,9.344790547798066
4807,330170215000003,194,220,171,168,126,95,63,41,974,104,1078,9.647495361781075
4808,330170215000004,66,102,57,88,66,47,34,24,426,58,484,11.983471074380166
4809,330170215000005,63,81,73,65,70,59,31,35,411,66,477,13.836477987421384
4810,330170215000006,79,83,79,78,64,63,36,22,446,58,504,11.507936507936508
4811,330170215000007,42,34,43,38,30,28,20,12,215,32,247,12.955465587044534
4812,330170215000008,86,103,94,83,96,80,34,31,542,65,607,10.70840197693575
4813,330170215000009,65,90,88,83,72,64,30,17,462,47,509,9.233791748526523
4814,330170215000010,82,105,126,76,80,81,34,29,550,63,613,10.277324632952691
4815,330170215000011,157,191,120,135,103,80,48,27,786,75,861,8.710801393728223
4816,330170215000012,85,107,91,149,77,52,40,9,561,49,610,8.032786885245901
4817,330170215000013,112,117,102,98,83,62,42,29,574,71,645,11.007751937984496
4818,330170215000014,79,103,74,72,53,29,23,9,410,32,442,7.239819004524887
4819,330170215000015,118,123,186,123,106,95,55,20,751,75,826,9.079903147699758
4820,330170215000016,126,155,138,130,92,65,46,23,706,69,775,8.903225806451612
4821,330170215000017,83,75,81,86,53,47,24,26,425,50,475,10.526315789473685
4822,330170215000018,151,170,176,100,93,86,49,27,776,76,852,8.92018779342723
4823,330170215000019,107,123,100,81,65,57,33,25,533,58,591,9.813874788494077
4824,330170215000020,143,138,151,127,101,88,45,28,748,73,821,8.891595615103533
4825,330170215000021,181,231,164,191,134,70,54,32,971,86,1057,8.136234626300851
4826,330170215000022,71,92,64,81,64,47,24,22,419,46,465,9.89247311827957
4827,330170215000023,164,189,148,151,109,63,45,29,824,74,898,8.240534521158128
4828,330170215000024,160,196,139,156,111,71,50,22,833,72,905,7.955801104972376
4829,330170215000025,109,114,89,86,59,43,29,20,500,49,549,8.925318761384336
4830,330170215000026,122,139,98,93,62,52,31,20,566,51,617,8.26580226904376
4831,330170215000027,129,142,94,89,78,55,25,22,587,47,634,7.413249211356467
4832,330170215000028,158,178,102,121,83,65,33,25,707,58,765,7.5816993464052285
4833,330170215000029,87,106,92,84,106,58,44,24,533,68,601,11.314475873544094
4834,330170215000030,90,108,132,105,101,74,44,34,610,78,688,11.337209302325581
4835,330170215000031,109,107,112,93,62,60,31,16,543,47,590,7.966101694915254
4836,330170215000032,106,147,125,124,91,70,50,24,663,74,737,10.040705563093622
4837,330170215000033,96,166,104,132,81,67,51,20,646,71,717,9.902370990237099
4838,330170215000034,210,242,161,138,113,85,50,25,949,75,1024,7.32421875
4839,330170215000035,193,200,142,155,104,74,43,22,868,65,933,6.966773847802787
4840,330170215000036,151,158,139,139,111,77,38,23,775,61,836,7.29665071770335
4841,330170215000037,91,133,116,104,77,63,46,25,584,71,655,10.83969465648855
4842,330170215000038,164,165,196,146,138,93,64,32,902,96,998,9.619238476953909
4843,330170215000039,80,95,84,104,81,46,28,23,490,51,541,9.426987060998151
4844,330170215000040,68,103,95,80,66,72,44,34,484,78,562,13.87900355871886
4845,330170215000041,134,168,174,142,150,83,44,24,851,68,919,7.399347116430903
4846,330170215000042,93,126,116,100,101,87,45,40,623,85,708,12.005649717514125
4847,330170215000043,124,186,182,101,160,148,48,51,901,99,1000,9.9
4848,330170215000044,78,91,71,63,68,40,29,21,411,50,461,10.845986984815617
4849,330170215000045,148,151,133,148,124,80,57,26,784,83,867,9.573241061130334
4850,330170215000046,91,95,88,102,94,84,31,27,554,58,612,9.477124183006536
4851,330170215000047,130,134,152,137,104,78,62,36,735,98,833,11.764705882352942
4852,330170215000048,170,213,169,108,109,82,38,27,851,65,916,7.096069868995633
4853,330170215000049,131,131,114,100,84,61,35,31,621,66,687,9.606986899563319
4854,330170215000050,155,205,135,105,83,50,33,19,733,52,785,6.624203821656051
4855,330170215000051,166,166,122,124,94,68,34,16,740,50,790,6.329113924050633
4856,330170215000052,255,278,210,179,166,110,70,30,1198,100,1298,7.704160246533128
4857,330170215000053,137,167,128,95,94,83,40,21,704,61,765,7.973856209150327
4858,330170215000054,186,255,167,170,137,93,48,24,1008,72,1080,6.666666666666667
4859,330170215000055,134,149,133,131,121,57,51,27,725,78,803,9.71357409713574
4860,330170215000056,155,206,143,154,111,91,47,32,860,79,939,8.413205537806176
4861,330170215000057,121,190,158,162,121,82,43,33,834,76,910,8.351648351648352
4862,330170215000058,74,103,83,93,60,49,33,26,462,59,521,11.324376199616124
4863,330170215000059,191,272,162,170,175,103,44,45,1073,89,1162,7.6592082616179
4864,330170215000060,189,185,174,156,107,92,58,28,903,86,989,8.695652173913043
4865,330170215000061,228,241,206,211,144,104,67,51,1134,118,1252,9.424920127795527
4866,330170215000062,136,173,148,154,138,109,61,31,858,92,950,9.68421052631579
4867,330170215000063,227,302,203,205,141,111,99,47,1189,146,1335,10.936329588014981
4868,330170215000064,90,88,77,78,75,50,35,30,458,65,523,12.4282982791587
4869,330170215000065,173,222,158,153,132,89,43,36,927,79,1006,7.852882703777336
4870,330170215000067,349,387,276,254,262,181,72,74,1709,146,1855,7.870619946091645
4871,330170215000068,196,231,175,150,160,106,44,51,1018,95,1113,8.53548966756514
4872,330170215000069,165,202,189,180,145,117,49,54,998,103,1101,9.35513169845595
4873,330170215000070,88,109,101,85,81,68,27,43,532,70,602,11.627906976744185
4874,330170215000071,118,115,142,108,79,102,34,31,664,65,729,8.916323731138545
4875,330170215000072,124,144,151,119,99,94,48,28,731,76,807,9.417596034696407
4876,330170215000073,107,120,116,89,71,81,33,31,584,64,648,9.876543209876543
4877,330170215000074,120,129,94,72,72,45,22,14,532,36,568,6.338028169014085
4878,330170215000075,154,188,154,143,145,94,62,45,878,107,985,10.862944162436548
4879,330170215000076,154,157,163,145,127,94,43,34,840,77,917,8.396946564885496
4880,330170215000077,89,104,86,100,65,62,29,24,506,53,559,9.481216457960643
4881,330170215000078,63,68,80,75,70,55,37,29,411,66,477,13.836477987421384
4882,330170215000079,27,26,29,23,27,12,4,6,144,10,154,6.4935064935064934
4883,330170215000080,90,131,111,129,107,89,43,23,657,66,723,9.12863070539419
4884,330170215000081,99,119,121,110,106,77,48,32,632,80,712,11.235955056179776
4885,330170215000082,157,204,190,193,168,96,71,43,1008,114,1122,10.16042780748663
4886,330170215000083,166,216,190,174,164,129,70,51,1039,121,1160,10.431034482758621
4887,330170215000084,195,237,191,171,129,107,80,33,1030,113,1143,9.886264216972878
4888,330170215000085,231,284,193,205,154,90,61,33,1157,94,1251,7.5139888089528375
4889,330170215000086,191,212,181,166,118,80,58,44,948,102,1050,9.714285714285714
4890,330170215000087,124,129,125,89,83,74,42,21,624,63,687,9.170305676855895
4891,330170215000088,126,163,126,101,104,77,35,28,697,63,760,8.289473684210526
4892,330170215000089,108,108,122,90,66,75,38,22,569,60,629,9.538950715421304
4893,330170215000090,82,95,77,80,73,42,22,15,449,37,486,7.613168724279835
4894,330170215000091,162,203,182,171,171,115,78,65,1004,143,1147,12.467306015693113
4895,330170215000092,121,189,131,156,129,101,53,34,827,87,914,9.518599562363239
4896,330170215000093,213,225,202,225,189,127,74,47,1181,121,1302,9.293394777265744
4897,330170215000094,90,68,108,86,86,70,43,38,508,81,589,13.752122241086587
4898,330170215000095,107,110,143,130,81,80,60,35,651,95,746,12.734584450402144
4899,330170215000096,117,165,106,107,101,54,28,20,650,48,698,6.876790830945558
4900,330170215000097,112,123,103,89,75,64,30,23,566,53,619,8.562197092084006
4901,330170215000098,145,151,114,116,145,52,24,24,723,48,771,6.22568093385214
4902,330170215000099,79,91,81,56,55,44,14,14,406,28,434,6.451612903225806
4903,330170215000100,181,185,204,164,154,123,56,41,1011,97,1108,8.754512635379061
4904,330170215000101,115,121,104,120,87,71,38,20,618,58,676,8.579881656804734
4905,330170215000102,100,113,104,140,111,71,28,30,639,58,697,8.321377331420374
4906,330170215000103,90,116,99,107,74,64,21,26,550,47,597,7.872696817420436
4907,330170215000104,187,299,224,199,165,129,56,45,1203,101,1304,7.745398773006135
4908,330170215000105,177,168,157,177,95,91,60,51,865,111,976,11.37295081967213
4909,330170215000106,109,118,95,59,77,32,28,9,490,37,527,7.020872865275142
4910,330170215000107,101,101,80,74,66,49,28,24,471,52,523,9.94263862332696
4911,330170215000108,118,134,115,96,85,78,53,24,626,77,703,10.953058321479373
4912,330170215000109,123,205,190,206,228,118,59,16,1070,75,1145,6.550218340611353
4913,330170215000110,194,292,219,222,173,135,71,34,1235,105,1340,7.835820895522388
4914,330170215000111,198,262,202,230,203,104,92,53,1199,145,1344,10.788690476190476
4915,330170215000112,265,257,241,239,187,119,76,54,1308,130,1438,9.040333796940194
4916,330170215000113,175,270,258,252,242,119,90,61,1316,151,1467,10.29311520109066
4917,330170215000114,43,82,73,92,103,55,35,29,448,64,512,12.5
4918,330170215000115,95,116,106,107,97,62,56,33,583,89,672,13.244047619047619
4919,330170215000116,88,113,116,102,82,67,45,28,568,73,641,11.388455538221528
4920,330170215000117,149,210,165,243,157,95,75,53,1019,128,1147,11.159546643417611
4921,330170215000118,75,107,96,93,103,64,39,42,538,81,619,13.08562197092084
4922,330170215000119,101,140,106,120,120,69,51,38,656,89,745,11.946308724832214
4923,330170215000120,128,170,147,164,134,98,42,31,841,73,914,7.986870897155361
4924,330170215000121,162,196,141,147,131,67,44,38,844,82,926,8.855291576673865
4925,330170215000122,89,102,95,96,93,64,34,28,539,62,601,10.316139767054908
4926,330170215000123,115,134,148,144,135,112,64,44,788,108,896,12.053571428571429
4927,330170215000124,252,301,255,221,179,120,60,33,1328,93,1421,6.544686840253343
4928,330170215000125,211,276,219,220,165,112,64,41,1203,105,1308,8.027522935779816
4929,330170215000126,107,150,124,160,146,100,58,20,787,78,865,9.017341040462428
4930,330170215000127,41,52,40,64,36,28,30,8,261,38,299,12.709030100334449
4931,330170215000128,66,87,93,105,89,62,46,30,502,76,578,13.14878892733564
4932,330170215000129,55,85,95,78,96,55,23,18,464,41,505,8.118811881188119
4933,330170215000130,48,71,58,57,50,46,16,17,330,33,363,9.090909090909092
4934,330170215000131,165,197,149,188,123,88,40,32,910,72,982,7.3319755600814664
4935,330170215000132,165,193,164,179,145,86,43,41,932,84,1016,8.26771653543307
4936,330170215000133,73,104,119,96,82,89,43,41,563,84,647,12.982998454404946
4937,330170215000134,59,88,77,88,91,73,43,25,476,68,544,12.5
4938,330170215000135,100,120,108,111,88,61,35,28,588,63,651,9.67741935483871
4939,330170215000136,177,186,167,168,128,98,52,24,924,76,1000,7.6
4940,330170215000137,91,103,111,115,103,60,52,30,583,82,665,12.330827067669173
4941,330170215000138,123,167,122,140,129,76,35,30,757,65,822,7.907542579075426
4942,330170215000139,183,206,159,134,90,71,29,22,843,51,894,5.704697986577181
4943,330170215000140,153,160,96,97,85,42,25,25,633,50,683,7.320644216691069
4944,330170215000141,168,155,122,96,79,57,26,21,677,47,724,6.49171270718232
4945,330170215000142,152,178,121,118,85,78,37,22,732,59,791,7.458912768647282
4946,330170215000143,30,64,20,29,25,14,4,8,182,12,194,6.185567010309279
4947,330170215000144,96,106,92,123,80,58,36,24,555,60,615,9.75609756097561
4948,330170215000145,36,52,47,49,51,43,27,22,278,49,327,14.984709480122325
4949,330170215000146,152,161,151,123,129,101,55,36,817,91,908,10.022026431718063
4950,330170215000147,147,232,199,223,187,119,90,38,1107,128,1235,10.364372469635628
4951,330170215000148,46,61,78,70,60,57,22,19,372,41,413,9.927360774818402
4952,330170215000149,105,182,179,179,117,93,54,39,855,93,948,9.810126582278482
4953,330170215000150,85,60,88,83,71,40,32,31,427,63,490,12.857142857142858
4954,330170215000151,52,54,72,61,56,54,33,28,349,61,410,14.878048780487806
4955,330170215000152,87,108,102,81,84,57,37,16,519,53,572,9.265734265734265
4956,330170215000153,97,142,102,108,78,97,48,20,624,68,692,9.826589595375722
4957,330170215000154,121,128,147,109,93,80,43,37,678,80,758,10.554089709762533
4958,330170215000155,102,122,111,102,63,78,42,24,578,66,644,10.248447204968944
4959,330170215000156,85,104,90,85,72,65,25,18,501,43,544,7.904411764705882
4960,330170215000157,73,72,85,75,66,62,54,35,433,89,522,17.049808429118773
4961,330170215000158,124,156,108,104,93,64,64,28,649,92,741,12.415654520917679
4962,330170215000159,69,94,88,85,53,59,44,22,448,66,514,12.84046692607004
4963,330170215000160,100,146,121,107,106,73,57,26,653,83,736,11.277173913043478
4964,330170215000161,109,135,121,87,73,69,29,22,594,51,645,7.906976744186046
4965,330170215000162,134,159,131,126,133,88,40,34,771,74,845,8.757396449704142
4966,330170215000163,116,135,135,88,105,62,35,26,641,61,702,8.68945868945869
4967,330170215000164,113,142,128,119,92,96,54,41,690,95,785,12.101910828025478
4968,330170215000165,124,129,134,89,99,87,41,17,662,58,720,8.055555555555555
4969,330170215000166,56,88,74,61,72,53,36,13,404,49,453,10.816777041942604
4970,330170215000167,98,132,119,91,75,82,35,33,597,68,665,10.225563909774436
4971,330170215000168,55,87,74,64,65,65,28,14,410,42,452,9.29203539823009
4972,330170215000169,88,136,113,87,66,60,28,25,550,53,603,8.7893864013267
4973,330170215000170,91,131,134,101,88,80,52,26,625,78,703,11.095305832147938
4974,330170215000171,83,94,97,55,73,70,26,19,472,45,517,8.704061895551257
4975,330170215000172,90,139,110,97,96,72,41,20,604,61,665,9.172932330827068
4976,330170215000173,87,82,123,64,87,74,24,18,517,42,559,7.5134168157423975
4977,330170215000174,99,168,129,116,119,92,46,30,723,76,799,9.51188986232791
4978,330170215000175,46,70,73,61,47,59,21,23,356,44,400,11.0
4979,330170215000176,39,77,77,72,41,63,28,22,369,50,419,11.933174224343675
4980,330170215000177,109,125,91,108,95,71,29,36,599,65,664,9.789156626506024
4981,330170215000178,61,95,75,82,66,45,24,20,424,44,468,9.401709401709402
4982,330170215000179,139,194,130,186,112,64,56,43,825,99,924,10.714285714285714
4983,330170215000180,175,254,205,222,143,118,75,34,1117,109,1226,8.890701468189233
4984,330170215000181,67,94,93,82,82,38,34,27,456,61,517,11.798839458413926
4985,330170215000182,76,88,88,58,79,58,24,31,447,55,502,10.95617529880478
4986,330170215000183,224,227,239,221,193,143,57,33,1247,90,1337,6.731488406881077
4987,330170215000184,89,147,120,123,115,75,32,24,669,56,725,7.724137931034483
4988,330170215000185,129,173,117,150,115,73,39,19,757,58,815,7.116564417177914
4989,330170215000186,53,63,44,48,47,36,19,11,291,30,321,9.345794392523365
4990,330170215000187,83,116,61,88,77,42,25,13,467,38,505,7.524752475247524
4991,330170215000188,105,119,111,76,69,32,17,4,512,21,533,3.9399624765478425
4992,330170215000189,205,222,153,113,123,74,30,15,890,45,935,4.81283422459893
4993,330170215000190,108,96,75,54,44,28,21,10,405,31,436,7.110091743119266
4994,330170215000191,91,90,45,67,52,43,26,14,388,40,428,9.345794392523365
4995,330170215000192,96,117,77,89,67,38,24,13,484,37,521,7.1017274472168905
4996,330170215000193,102,105,68,66,48,46,24,9,435,33,468,7.051282051282051
4997,330170215000194,74,109,83,68,84,69,33,21,487,54,541,9.981515711645102
4998,330170215000195,30,56,32,38,40,30,18,8,226,26,252,10.317460317460318
4999,330170215000196,4,10,10,7,10,2,0,0,43,0,43,0.0
5000,330170215000197,52,43,38,46,43,36,15,6,258,21,279,7.526881720430108
5001,330170215000198,9,9,5,7,7,3,1,5,40,6,46,13.043478260869565
5002,330170215000199,156,198,133,144,108,70,45,27,809,72,881,8.172531214528945
5003,330170215000200,127,193,165,159,189,113,79,57,946,136,1082,12.569316081330868
5004,330170215000201,82,82,102,71,75,58,30,20,470,50,520,9.615384615384615
5005,330170215000202,66,95,78,75,56,41,24,17,411,41,452,9.070796460176991
5006,330170215000203,69,94,106,70,95,55,35,24,489,59,548,10.766423357664234
5007,330170215000204,105,183,101,122,114,57,40,24,682,64,746,8.579088471849866
5008,330170215000205,114,180,99,115,74,50,29,17,632,46,678,6.784660766961652
5009,330170215000206,183,230,176,164,116,75,50,36,944,86,1030,8.349514563106796
5010,330170215000207,151,164,123,117,81,63,40,23,699,63,762,8.26771653543307
5011,330170215000208,68,89,66,79,73,35,36,25,410,61,471,12.951167728237792
5012,330170215000209,103,128,105,103,88,43,41,18,570,59,629,9.379968203497615
5013,330170215000210,75,83,41,66,52,26,28,20,343,48,391,12.27621483375959
5014,330170215000211,66,105,72,87,65,39,26,16,434,42,476,8.823529411764707
5015,330170215000212,48,55,72,50,54,39,23,13,318,36,354,10.169491525423728
5016,330170215000213,305,341,221,202,191,117,66,45,1377,111,1488,7.459677419354839
5017,330170215000214,336,398,288,236,214,126,87,33,1598,120,1718,6.984866123399302
5018,330170215000215,100,102,67,71,43,35,18,13,418,31,449,6.904231625835189
5019,330170215000216,193,195,154,119,108,82,35,14,851,49,900,5.444444444444445
5020,330170215000217,149,195,131,113,86,66,27,16,740,43,783,5.491698595146871
5021,330170215000218,53,56,54,30,38,30,17,8,261,25,286,8.741258741258742
5022,330170220000001,124,172,138,110,139,96,46,52,779,98,877,11.174458380843786
5023,330170220000002,112,120,90,91,54,49,24,16,516,40,556,7.194244604316546
5024,330170220000003,312,356,311,316,255,212,92,72,1762,164,1926,8.515057113187954
5025,330170220000004,129,189,161,150,162,101,74,48,892,122,1014,12.03155818540434
5026,330170220000005,113,138,113,128,87,97,48,28,676,76,752,10.106382978723405
5027,330170220000006,67,109,115,98,140,120,52,67,649,119,768,15.494791666666666
5028,330170220000007,189,241,192,196,161,152,79,47,1131,126,1257,10.023866348448687
5029,330170220000008,17,27,21,14,26,24,10,14,129,24,153,15.686274509803921
5030,330170220000009,123,187,187,140,184,176,80,103,997,183,1180,15.508474576271187
5031,330170220000010,25,48,29,34,33,34,12,5,203,17,220,7.7272727272727275
5032,330170220000011,155,151,165,131,120,93,36,34,815,70,885,7.909604519774011
5033,330170220000012,101,98,106,89,91,61,21,31,546,52,598,8.695652173913043
5034,330170220000013,45,48,60,45,52,39,13,20,289,33,322,10.248447204968944
5035,330170220000015,122,162,193,168,151,104,55,42,900,97,997,9.729187562688065
5036,330170220000016,112,131,138,134,90,82,50,31,687,81,768,10.546875
5037,330170220000017,76,105,99,84,89,67,48,26,520,74,594,12.457912457912458
5038,330170220000018,127,169,146,142,119,73,47,26,776,73,849,8.598351001177857
5039,330170220000019,102,149,162,129,117,100,38,44,759,82,841,9.750297265160523
5040,330170220000020,78,115,67,81,75,48,25,30,464,55,519,10.597302504816955
5041,330170220000021,157,155,174,156,138,75,45,32,855,77,932,8.261802575107296
5042,330170220000022,117,124,114,114,76,70,52,22,615,74,689,10.740203193033382
5043,330170220000023,111,133,105,154,123,68,46,32,694,78,772,10.103626943005182
5044,330170220000024,114,157,127,124,140,103,59,36,765,95,860,11.046511627906977
5045,330170220000025,129,164,191,172,136,90,52,41,882,93,975,9.538461538461538
5046,330170220000026,94,134,111,119,115,100,49,45,673,94,767,12.25554106910039
5047,330170220000027,82,127,117,110,119,103,43,36,658,79,737,10.719131614654003
5048,330170220000028,90,100,142,111,106,88,68,47,637,115,752,15.292553191489361
5049,330170220000029,125,164,115,127,124,69,30,35,724,65,789,8.238276299112801
5050,330170220000030,184,243,196,196,158,147,76,51,1124,127,1251,10.151878497202238
5051,330170220000031,29,51,56,33,61,46,33,20,276,53,329,16.109422492401215
5052,330170220000032,45,59,47,51,60,41,29,28,303,57,360,15.833333333333334
5053,330170220000033,34,47,31,32,25,16,6,7,185,13,198,6.565656565656566
5054,330170220000034,147,189,155,170,110,77,59,27,848,86,934,9.207708779443255
5055,330170220000035,78,81,77,90,63,50,38,28,439,66,505,13.069306930693068
5056,330170220000036,93,130,95,95,85,74,45,26,572,71,643,11.04199066874028
5057,330170220000037,33,65,65,53,55,41,29,30,312,59,371,15.902964959568733
5058,330170220000038,141,210,148,167,157,88,67,43,911,110,1021,10.773751224289912
5060,330170220000040,120,120,108,131,84,66,36,35,629,71,700,10.142857142857142
5061,330170220000041,182,241,216,182,171,110,79,52,1102,131,1233,10.62449310624493
5062,330170220000042,222,243,179,173,125,131,74,47,1073,121,1194,10.134003350083752
5063,330170220000043,31,36,28,28,34,14,4,9,171,13,184,7.065217391304348
5064,330170220000044,72,94,58,57,42,25,19,10,348,29,377,7.6923076923076925
5065,330170220000045,19,19,28,11,17,13,9,1,107,10,117,8.547008547008547
5066,330170220000046,17,36,18,23,13,10,9,4,117,13,130,10.0
5068,330170220000048,139,156,143,96,88,67,44,32,689,76,765,9.934640522875817
5069,330170220000049,169,245,180,192,197,145,72,90,1128,162,1290,12.55813953488372
5070,330170220000050,46,34,38,37,23,12,7,2,190,9,199,4.522613065326633
5071,330170220000051,36,47,30,24,22,18,7,6,177,13,190,6.842105263157895
5072,330170220000052,134,136,142,99,99,87,39,48,697,87,784,11.096938775510203
5073,330170220000053,128,142,97,99,86,72,30,17,624,47,671,7.004470938897168
5074,330170220000054,15,7,14,13,1,8,10,3,58,13,71,18.309859154929576
5075,330170220000055,247,306,219,234,164,118,52,28,1288,80,1368,5.847953216374269
5076,330170220000056,202,252,171,161,139,103,44,42,1028,86,1114,7.719928186714542
5077,330170220000057,178,206,180,154,157,126,49,28,1001,77,1078,7.142857142857143
5078,330170220000058,180,194,170,183,132,102,48,34,961,82,1043,7.861936720997123
5079,330170220000059,126,182,138,109,117,65,37,15,737,52,789,6.590621039290241
5080,330170220000060,143,209,170,131,105,88,50,39,846,89,935,9.518716577540108
5081,330170220000061,118,104,131,146,90,42,24,16,631,40,671,5.961251862891207
5082,330170220000062,90,100,131,129,120,117,67,34,687,101,788,12.817258883248732
5083,330170220000063,95,157,162,117,142,93,67,46,766,113,879,12.85551763367463
5084,330170220000064,103,143,129,108,94,76,47,37,653,84,737,11.397557666214382
5085,330170220000065,269,258,263,260,142,117,85,54,1309,139,1448,9.599447513812155
5086,330170220000066,93,113,86,115,99,57,40,29,563,69,632,10.917721518987342
5087,330170220000067,158,219,168,157,144,113,79,43,959,122,1081,11.285846438482887
5088,330170220000068,65,82,76,81,81,53,24,17,438,41,479,8.559498956158665
5089,330170220000069,79,124,86,95,78,58,23,19,520,42,562,7.473309608540926
5090,330170220000070,104,146,111,134,112,69,49,32,676,81,757,10.700132100396301
5091,330170220000071,69,98,75,80,63,49,25,22,434,47,481,9.771309771309772
5092,330170220000072,35,41,40,38,31,26,17,17,211,34,245,13.877551020408163
5093,330170220000073,14,33,16,18,23,21,10,1,125,11,136,8.088235294117647
5094,330170220000074,16,3,12,10,6,2,6,6,49,12,61,19.672131147540984
5095,330170220000075,5,4,6,6,5,8,1,0,34,1,35,2.857142857142857
5096,330170220000076,5,3,4,3,2,5,2,2,22,4,26,15.384615384615385
5097,330170220000077,22,16,26,18,16,14,6,8,112,14,126,11.11111111111111
5098,330170220000078,9,13,17,9,14,8,7,1,70,8,78,10.256410256410257
5099,330170220000079,53,91,65,69,59,45,37,20,382,57,439,12.984054669703873
5100,330170220000080,74,88,77,58,55,55,40,19,407,59,466,12.660944206008583
5101,330170220000081,2,4,0,3,1,3,1,1,13,2,15,13.333333333333334
5102,330170220000082,22,16,12,6,12,7,5,2,75,7,82,8.536585365853659
5103,330170220000083,36,39,30,24,25,23,13,8,177,21,198,10.606060606060606
5104,330170220000084,22,30,23,23,14,12,12,7,124,19,143,13.286713286713287
5105,330170220000085,9,11,9,13,7,2,2,10,51,12,63,19.047619047619047
5106,330170220000086,68,68,58,50,62,47,21,16,353,37,390,9.487179487179487
5107,330170220000087,16,12,14,19,13,9,10,5,83,15,98,15.306122448979592
5108,330170220000088,29,50,24,31,13,22,13,4,169,17,186,9.13978494623656
5109,330170220000089,143,141,167,163,117,105,75,31,836,106,942,11.252653927813164
5110,330170220000090,104,171,157,153,153,115,50,39,853,89,942,9.447983014861995
5111,330170220000091,119,190,149,156,130,86,58,39,830,97,927,10.463861920172599
5112,330170220000092,162,204,213,194,197,146,65,48,1116,113,1229,9.19446704637917
5113,330170220000093,152,176,168,177,156,116,73,35,945,108,1053,10.256410256410257
5114,330170220000094,51,85,101,82,95,74,47,28,488,75,563,13.321492007104796
5115,330170220000095,118,128,129,136,94,90,49,38,695,87,782,11.12531969309463
5116,330170220000096,81,74,57,81,48,44,23,16,385,39,424,9.19811320754717
5117,330170220000097,154,144,109,120,86,67,41,29,680,70,750,9.333333333333334
5118,330180105000001,76,85,99,81,79,75,50,38,495,88,583,15.09433962264151
5119,330180105000002,51,75,71,56,53,73,43,35,379,78,457,17.067833698030636
5120,330180105000003,83,136,155,158,125,141,63,70,798,133,931,14.285714285714286
5121,330180105000004,106,115,115,120,132,90,41,44,678,85,763,11.140235910878113
5122,330180105000005,64,98,99,80,141,87,52,57,569,109,678,16.07669616519174
5123,330180105000006,25,29,51,51,51,53,35,41,260,76,336,22.61904761904762
5124,330180105000007,74,100,112,107,118,103,43,53,614,96,710,13.52112676056338
5125,330180105000008,48,89,93,94,101,79,88,73,504,161,665,24.210526315789473
5126,330180105000009,66,87,98,103,119,95,64,59,568,123,691,17.80028943560058
5127,330180105000010,77,100,88,78,76,59,22,31,478,53,531,9.981167608286253
5128,330180105000011,78,93,85,77,71,48,32,14,452,46,498,9.236947791164658
5129,330180105000012,118,154,187,187,153,71,48,25,870,73,943,7.741251325556734
5130,330180105000013,11,11,22,21,19,22,9,9,106,18,124,14.516129032258064
5131,330180105000014,33,60,38,55,49,39,24,20,274,44,318,13.836477987421384
5132,330180105000015,48,55,66,54,62,42,27,20,327,47,374,12.566844919786096
5133,330180105000016,15,23,20,23,28,19,12,11,128,23,151,15.2317880794702
5134,330180110000001,99,144,126,115,113,104,74,64,701,138,839,16.448152562574492
5135,330180110000002,72,111,127,117,94,91,53,37,612,90,702,12.820512820512821
5136,330180110000003,25,26,18,24,27,30,16,12,150,28,178,15.730337078651685
5137,330180110000004,19,50,27,32,38,40,26,11,206,37,243,15.22633744855967
5138,330180110000005,61,84,69,64,77,45,36,19,400,55,455,12.087912087912088
5139,330180110000006,25,43,46,31,42,28,14,10,215,24,239,10.0418410041841
5140,330180110000007,4,6,6,6,10,2,2,4,34,6,40,15.0
5141,330180110000008,119,124,143,146,81,104,65,34,717,99,816,12.132352941176471
5142,330180110000009,122,139,135,164,122,78,62,34,760,96,856,11.214953271028037
5143,330180110000010,16,17,18,14,19,15,14,3,99,17,116,14.655172413793103
5144,330185005000001,70,66,80,88,58,52,35,38,414,73,487,14.989733059548255
5145,330185005000002,74,115,100,97,85,73,49,34,544,83,627,13.237639553429027
5146,330185005000003,132,152,154,150,140,103,84,51,831,135,966,13.975155279503106
5147,330185005000004,92,110,104,109,74,89,49,54,578,103,681,15.124816446402349
5148,330185005000005,124,178,166,141,168,122,79,69,899,148,1047,14.13562559694365
5149,330185005000006,86,111,115,112,104,94,64,56,622,120,742,16.172506738544474
5150,330185005000007,79,116,98,98,115,72,51,30,578,81,659,12.291350531107739
5151,330185005000008,74,105,67,90,66,50,35,19,452,54,506,10.671936758893281
5152,330185005000009,79,85,67,75,81,55,41,32,442,73,515,14.174757281553399
5153,330185005000010,156,179,172,155,153,103,74,37,918,111,1029,10.787172011661808
5154,330185005000011,82,108,128,108,92,81,43,35,599,78,677,11.521418020679468
5155,330185005000012,163,149,181,151,119,94,37,42,857,79,936,8.44017094017094
5156,330185005000013,50,83,86,61,64,37,29,14,381,43,424,10.141509433962264
5157,330185005000014,122,122,160,115,106,88,41,44,713,85,798,10.651629072681704
5158,330185005000015,96,109,100,83,73,53,27,21,514,48,562,8.540925266903914
5159,330185005000016,130,199,226,213,209,112,62,22,1089,84,1173,7.161125319693094
5160,330185005000017,40,43,28,43,48,36,24,36,238,60,298,20.13422818791946
5161,330185005000018,135,147,129,115,99,70,40,24,695,64,759,8.432147562582346
5162,330185005000019,110,167,162,133,118,116,89,68,806,157,963,16.303219106957425
5163,330185005000020,63,98,69,65,64,44,26,16,403,42,445,9.438202247191011
5164,330185005000021,112,170,149,126,138,95,40,49,790,89,879,10.12514220705347
5165,330185005000022,150,177,151,158,132,85,45,22,853,67,920,7.282608695652174
5166,330185005000023,174,243,216,203,174,113,69,43,1123,112,1235,9.068825910931174
5167,330185005000024,169,166,140,132,118,78,55,33,803,88,891,9.876543209876543
5168,330185005000025,206,198,162,185,115,71,60,40,937,100,1037,9.643201542912246
5169,330185005000026,193,236,194,213,162,87,55,39,1085,94,1179,7.972858354537744
5170,330185005000027,119,141,118,120,89,80,55,37,667,92,759,12.121212121212121
5171,330185005000028,107,128,118,120,78,48,46,18,599,64,663,9.653092006033182
5172,330185005000029,54,83,66,56,63,48,32,25,370,57,427,13.348946135831381
5173,330185005000030,78,99,79,76,75,56,35,18,463,53,516,10.271317829457365
5174,330185005000031,71,70,45,48,43,39,23,19,316,42,358,11.731843575418994
5175,330185005000032,342,501,496,378,391,290,113,81,2398,194,2592,7.484567901234568
5176,330185005000033,105,83,95,65,64,63,34,27,475,61,536,11.380597014925373
5177,330185005000034,99,110,84,89,65,48,36,28,495,64,559,11.449016100178891
5178,330185005000035,151,186,152,155,119,77,49,33,840,82,922,8.893709327548807
5179,330185005000036,188,211,160,136,138,95,65,41,928,106,1034,10.251450676982591
5180,330185005000037,180,225,210,160,135,107,56,35,1017,91,1108,8.212996389891696
5181,330185005000038,15,16,0,0,0,1,0,1,32,1,33,3.0303030303030303
5182,330185005000039,69,63,64,45,41,29,10,9,311,19,330,5.757575757575758
5183,330185005000040,195,285,459,267,342,115,47,32,1663,79,1742,4.535017221584385
5184,330185005000041,146,181,166,159,135,76,44,29,863,73,936,7.799145299145299
5185,330185005000043,105,134,98,98,64,56,50,25,555,75,630,11.904761904761905
5186,330185005000044,9,17,8,9,6,4,3,4,53,7,60,11.666666666666666
5187,330185005000045,27,46,29,24,29,16,10,4,171,14,185,7.5675675675675675
5188,330185005000046,55,58,70,52,37,31,26,12,303,38,341,11.143695014662757
5189,330185005000047,108,121,95,157,110,75,41,17,666,58,724,8.011049723756907
5190,330185005000048,7,15,10,5,8,2,0,1,47,1,48,2.0833333333333335
5191,330185005000049,102,87,60,64,56,51,27,18,420,45,465,9.67741935483871
5192,330185005000050,6,6,11,7,7,6,1,2,43,3,46,6.521739130434782
5193,330185005000051,27,32,21,21,25,27,15,11,153,26,179,14.525139664804469
5194,330185005000052,15,28,18,20,22,26,12,4,129,16,145,11.03448275862069
5195,330185005000054,30,40,30,36,32,26,15,20,194,35,229,15.283842794759826
5196,330185005000055,25,44,37,37,29,14,8,7,186,15,201,7.462686567164179
5197,330185005000056,18,26,15,15,23,13,8,3,110,11,121,9.090909090909092
5198,330185005000058,109,103,87,70,50,43,26,14,462,40,502,7.968127490039841
5199,330185005000059,4,7,5,4,2,3,1,1,25,2,27,7.407407407407407
5200,330185005000062,9,8,11,4,0,2,2,4,34,6,40,15.0
5201,330185005000063,7,10,13,9,5,11,5,3,55,8,63,12.698412698412698
5202,330185005000064,45,77,48,35,28,28,25,9,261,34,295,11.525423728813559
5203,330185005000065,48,56,51,33,45,25,16,9,258,25,283,8.8339222614841
5204,330185005000066,34,36,34,27,18,8,6,4,157,10,167,5.9880239520958085
5205,330185005000067,36,32,23,29,18,5,3,7,143,10,153,6.5359477124183005
5206,330185005000068,7,13,3,11,9,3,1,0,46,1,47,2.127659574468085
5208,330185005000070,3,4,5,1,6,2,0,0,21,0,21,0.0
5212,330185005000076,82,107,125,76,95,74,41,49,559,90,649,13.86748844375963
5213,330185005000077,50,71,71,67,74,67,45,34,400,79,479,16.49269311064718
5214,330185005000078,107,111,86,117,86,66,46,38,573,84,657,12.785388127853881
5215,330185005000079,58,109,80,94,79,52,50,31,472,81,553,14.64737793851718
5216,330185005000080,63,60,78,44,66,55,32,18,366,50,416,12.01923076923077
5217,330185005000081,149,144,150,158,87,79,57,32,767,89,856,10.397196261682243
5218,330185005000082,16,11,18,16,18,21,15,7,100,22,122,18.0327868852459
5219,330185005000083,144,155,137,149,100,53,32,25,738,57,795,7.169811320754717
5220,330185005000084,213,228,217,193,148,84,60,44,1083,104,1187,8.761583824768323
5221,330185005000085,153,93,116,104,52,32,33,17,550,50,600,8.333333333333334
5222,330185005000086,77,75,70,67,49,37,38,21,375,59,434,13.59447004608295
5223,330185005000087,54,83,64,71,73,61,15,34,406,49,455,10.76923076923077
5224,330185005000088,53,46,42,26,36,20,15,11,223,26,249,10.441767068273093
5225,330185005000089,73,103,91,70,68,65,30,31,470,61,531,11.487758945386064
5226,330185005000090,237,251,296,218,170,150,65,51,1322,116,1438,8.066759388038943
5227,330185005000091,110,212,123,116,113,69,40,22,743,62,805,7.701863354037267
5228,330185005000092,78,85,68,107,65,31,27,20,434,47,481,9.771309771309772
5229,330185005000093,98,102,139,112,94,68,45,35,613,80,693,11.544011544011545
5230,330185005000094,32,59,37,30,27,33,14,16,218,30,248,12.096774193548388
5231,330185005000095,105,147,113,135,96,68,29,25,664,54,718,7.520891364902507
5232,330185005000096,39,64,31,51,43,36,17,25,264,42,306,13.72549019607843
5233,330185005000097,152,186,169,138,102,71,32,21,818,53,871,6.0849598163031
5234,330187605060001,21,26,27,23,30,30,22,39,157,61,218,27.98165137614679
5235,330187605060002,10,31,25,17,30,33,21,14,146,35,181,19.337016574585636
5236,330187605060003,16,16,22,19,23,22,16,19,118,35,153,22.875816993464053
5237,330187605060004,12,33,27,25,39,29,23,29,165,52,217,23.963133640552996
5239,330187605060006,11,14,14,16,20,23,21,18,98,39,137,28.467153284671532
5240,330187605060007,4,4,4,6,4,3,4,9,25,13,38,34.21052631578947
5241,330187605060008,12,18,18,12,17,19,23,11,96,34,130,26.153846153846153
5242,330187605060009,1,0,6,3,3,4,2,5,17,7,24,29.166666666666668
5243,330187605060010,47,48,38,44,61,48,48,38,286,86,372,23.118279569892472
5245,330187605060012,6,2,7,5,2,5,4,0,27,4,31,12.903225806451612
5246,330187605060013,33,64,37,50,44,40,31,24,268,55,323,17.027863777089784
5247,330187605060014,2,2,3,2,3,4,1,0,16,1,17,5.882352941176471
5248,330187605060015,31,46,46,43,44,35,50,36,245,86,331,25.981873111782477
5249,330187605060016,10,26,9,15,16,24,21,12,100,33,133,24.81203007518797
5250,330187605060017,9,16,8,14,13,12,7,3,72,10,82,12.195121951219512
5251,330187605060018,33,50,42,39,46,43,37,35,253,72,325,22.153846153846153
5252,330187605060019,30,45,27,32,41,43,33,40,218,73,291,25.085910652920962
5254,330187605060021,9,7,4,2,8,6,5,1,36,6,42,14.285714285714286
5257,330187605060024,15,15,19,27,24,18,18,7,118,25,143,17.482517482517483
5258,330187605060025,12,23,10,21,11,18,9,8,95,17,112,15.178571428571429
5260,330187605060028,19,15,21,22,15,12,14,2,104,16,120,13.333333333333334
5261,330187605060029,25,32,28,33,43,39,38,22,200,60,260,23.076923076923077
5262,330187605060030,33,44,40,36,43,35,44,38,231,82,313,26.19808306709265
5263,330187605060031,36,51,35,55,57,30,28,20,264,48,312,15.384615384615385
5264,330187605060032,54,81,60,53,62,52,27,24,362,51,413,12.34866828087167
5265,330187605060033,36,38,29,35,28,27,22,18,193,40,233,17.167381974248926
5266,330187605060034,10,32,22,14,33,30,24,26,141,50,191,26.17801047120419
5267,330187605060035,42,99,56,83,73,50,50,33,403,83,486,17.078189300411523
5268,330187605060036,16,19,23,23,30,25,16,21,136,37,173,21.387283236994218
5269,330187605060037,16,36,29,36,34,26,20,19,177,39,216,18.055555555555557
5270,330187605060038,24,44,41,42,34,40,33,32,225,65,290,22.413793103448278
5271,330187605060039,28,42,25,37,34,17,26,10,183,36,219,16.438356164383563
5272,330187605060040,145,119,121,137,79,63,55,25,664,80,744,10.75268817204301
5275,330187605060043,32,59,41,51,37,47,36,27,267,63,330,19.09090909090909
5276,330187605060044,5,2,5,4,4,2,3,2,22,5,27,18.51851851851852
5277,330187605060045,120,154,136,101,123,67,46,31,701,77,778,9.897172236503856
5278,330187605060046,6,25,13,18,16,10,7,5,88,12,100,12.0
5279,330187605060047,92,76,72,65,41,31,19,11,377,30,407,7.371007371007371
5280,330187605060048,53,57,70,42,56,60,26,16,338,42,380,11.052631578947368
5281,330187605060049,8,10,4,9,1,5,2,2,37,4,41,9.75609756097561
5284,330187605060052,74,106,79,82,73,68,42,20,482,62,544,11.397058823529411
5285,330187605060053,0,3,2,1,4,1,2,1,11,3,14,21.428571428571427
5286,330187605060054,17,21,17,16,18,11,10,3,100,13,113,11.504424778761061
5287,330187605060055,43,49,43,45,37,48,45,22,265,67,332,20.180722891566266
5288,330187605060056,67,93,74,72,83,65,45,23,454,68,522,13.026819923371647
5290,330187605060058,56,62,81,75,60,51,39,17,385,56,441,12.698412698412698
5291,330187605060059,40,63,30,67,33,50,31,22,283,53,336,15.773809523809524
5292,330187605060060,30,50,32,36,44,41,37,31,233,68,301,22.591362126245848
5293,330187605060061,27,48,29,39,29,38,28,17,210,45,255,17.647058823529413
5294,330187605060062,3,25,32,25,25,32,21,26,142,47,189,24.867724867724867
5295,330187605060063,29,51,43,46,51,45,44,38,265,82,347,23.631123919308358
5296,330187605060064,47,37,49,50,74,48,61,39,305,100,405,24.691358024691358
5297,330187605060065,30,50,46,37,36,43,39,33,242,72,314,22.929936305732483
5298,330187605060066,18,34,29,22,34,34,32,28,171,60,231,25.974025974025974
5299,330187605060067,5,8,7,6,3,5,2,2,34,4,38,10.526315789473685
5300,330187605060068,15,37,37,27,46,28,24,20,190,44,234,18.803418803418804
5301,330187605060069,13,16,25,19,28,18,15,12,119,27,146,18.493150684931507
5302,330187605060070,27,44,11,30,37,28,34,23,177,57,234,24.358974358974358
5303,330187605060071,21,31,28,27,31,23,4,10,161,14,175,8.0
5304,330187605060072,93,103,85,95,80,77,36,41,533,77,610,12.62295081967213
5305,330187605060073,4,10,3,8,6,4,5,2,35,7,42,16.666666666666668
5306,330187605060074,29,35,46,54,52,41,34,28,257,62,319,19.435736677115987
5307,330187605060075,8,6,10,14,8,11,11,8,57,19,76,25.0
5309,330187605060077,10,9,3,11,5,6,7,11,44,18,62,29.032258064516128
5310,330187605060078,9,10,8,6,8,15,11,7,56,18,74,24.324324324324323
5311,330187605060079,75,104,77,81,100,43,22,25,480,47,527,8.918406072106261
5312,330187605060080,72,74,87,74,63,47,40,14,417,54,471,11.464968152866241
5313,330187605060081,51,60,47,58,60,42,32,22,318,54,372,14.516129032258064
5314,330187605060082,99,144,119,107,104,64,41,21,637,62,699,8.869814020028612
5315,330187605060083,25,41,40,40,38,39,21,9,223,30,253,11.857707509881424
5316,330187605060084,46,60,35,47,55,44,32,15,287,47,334,14.071856287425149
5317,330187605060085,12,19,19,19,21,21,16,23,111,39,150,26.0
5320,330187605070003,85,91,78,60,74,36,18,25,424,43,467,9.207708779443255
5322,330187605070005,11,9,8,12,0,7,4,3,47,7,54,12.962962962962964
5323,330187605070006,82,165,83,74,81,42,30,14,527,44,571,7.705779334500876
5324,330187605070007,64,82,64,64,63,25,28,18,362,46,408,11.27450980392157
5326,330187605070009,0,2,0,0,2,0,0,0,4,0,4,0.0
5327,330187605070010,103,143,116,102,96,56,43,39,616,82,698,11.74785100286533
5328,330187605080001,39,55,48,44,37,35,29,14,258,43,301,14.285714285714286
5329,330187605080002,59,42,45,49,37,40,28,20,272,48,320,15.0
5330,330187605080003,6,9,8,4,4,0,0,3,31,3,34,8.823529411764707
5331,330187605080004,36,40,48,47,52,46,31,21,269,52,321,16.1993769470405
5332,330187605080005,38,46,45,32,49,32,27,12,242,39,281,13.87900355871886
5333,330187605080006,18,34,28,42,30,48,46,25,200,71,271,26.199261992619927
5334,330187605080007,19,26,19,24,26,30,18,13,144,31,175,17.714285714285715
5335,330190005000001,81,80,100,107,97,78,69,55,543,124,667,18.590704647676162
5336,330190005000002,87,107,117,117,102,81,58,26,611,84,695,12.086330935251798
5337,330190005000003,4,12,9,14,9,11,5,3,59,8,67,11.940298507462687
5338,330190005000004,22,34,26,27,25,18,17,4,152,21,173,12.138728323699421
5339,330190005000005,50,77,95,91,106,99,67,71,518,138,656,21.036585365853657
5340,330190005000006,36,51,73,77,89,60,47,40,386,87,473,18.39323467230444
5341,330190005000007,25,60,73,60,63,64,41,53,345,94,439,21.4123006833713
5342,330190005000008,63,108,127,109,130,107,60,71,644,131,775,16.903225806451612
5343,330190005000009,19,22,26,23,26,25,18,11,141,29,170,17.058823529411764
5344,330190005000010,116,175,192,173,170,125,74,57,951,131,1082,12.10720887245841
5345,330190005000011,34,43,53,57,48,48,18,22,283,40,323,12.38390092879257
5346,330190005000012,95,112,101,144,115,98,41,47,665,88,753,11.686586985391767
5347,330190005000013,105,160,141,107,96,79,34,36,688,70,758,9.234828496042216
5348,330190005000014,125,156,126,114,125,78,52,30,724,82,806,10.173697270471465
5349,330190005000015,57,91,71,87,70,37,25,15,413,40,453,8.830022075055188
5350,330190005000016,36,37,34,45,19,24,10,6,195,16,211,7.5829383886255926
5351,330190005000017,37,39,45,40,42,35,19,7,238,26,264,9.848484848484848
5352,330190005000018,72,104,110,88,114,85,31,23,573,54,627,8.61244019138756
5353,330190005000019,77,91,79,108,91,81,57,37,527,94,621,15.136876006441224
5354,330190005000020,52,87,70,142,68,39,38,37,458,75,533,14.071294559099437
5355,330190005000021,90,112,151,120,108,78,45,21,659,66,725,9.10344827586207
5356,330190005000022,89,108,106,126,114,85,63,58,628,121,749,16.15487316421896
5357,330190005000023,105,125,146,104,134,78,64,42,692,106,798,13.283208020050125
5358,330190005000024,54,101,96,96,84,79,55,33,510,88,598,14.715719063545151
5359,330190005000025,116,177,186,187,162,128,58,51,956,109,1065,10.234741784037558
5360,330190005000026,172,211,257,256,221,137,80,65,1254,145,1399,10.364546104360258
5361,330190005000027,122,201,170,174,152,90,80,38,909,118,1027,11.489776046738072
5362,330190005000028,138,158,158,170,131,103,44,39,858,83,941,8.820403825717323
5363,330190005000029,67,83,78,85,71,51,29,10,435,39,474,8.227848101265822
5364,330190005000030,67,80,98,82,84,73,39,29,484,68,552,12.318840579710145
5365,330190005000031,84,103,93,114,64,40,16,10,498,26,524,4.961832061068702
5366,330190005000032,57,122,112,104,89,82,35,20,566,55,621,8.856682769726248
5367,330190005000033,238,281,261,375,279,178,88,70,1612,158,1770,8.926553672316384
5368,330190005000034,107,117,146,158,122,126,88,67,776,155,931,16.648764769065522
5369,330190005000035,101,124,116,143,117,94,52,47,695,99,794,12.468513853904282
5370,330190005000036,82,91,104,129,95,69,49,41,570,90,660,13.636363636363637
5371,330190005000037,167,177,178,187,174,135,82,46,1018,128,1146,11.169284467713787
5372,330190005000038,128,125,147,144,117,103,65,34,764,99,863,11.471610660486675
5373,330190005000039,158,166,177,184,139,108,53,36,932,89,1021,8.71694417238002
5374,330190005000040,202,244,193,194,171,124,45,46,1128,91,1219,7.465135356849877
5375,330190005000041,114,131,115,111,106,61,36,22,638,58,696,8.333333333333334
5376,330190005000042,111,98,105,82,94,66,47,24,556,71,627,11.323763955342903
5377,330190005000043,231,209,195,171,120,104,58,32,1030,90,1120,8.035714285714286
5378,330190005000044,105,113,57,71,54,37,19,24,437,43,480,8.958333333333334
5379,330190005000045,69,103,68,74,75,42,43,25,431,68,499,13.627254509018035
5380,330190005000046,63,90,85,85,86,61,24,18,470,42,512,8.203125
5381,330190005000047,126,170,106,117,138,81,68,31,738,99,837,11.827956989247312
5382,330190005000048,59,78,66,88,95,51,27,28,437,55,492,11.178861788617887
5383,330190005000049,90,126,71,110,90,45,47,14,532,61,593,10.286677908937605
5384,330190005000050,89,104,101,85,63,63,24,14,505,38,543,6.998158379373849
5385,330190005000051,168,196,226,174,175,124,89,78,1063,167,1230,13.577235772357724
5386,330190005000052,37,31,28,37,34,15,10,10,182,20,202,9.900990099009901
5387,330190005000053,132,153,139,127,117,63,38,32,731,70,801,8.739076154806492
5388,330190005000054,155,201,175,162,141,92,55,43,926,98,1024,9.5703125
5389,330190005000055,120,162,114,143,77,66,40,28,682,68,750,9.066666666666666
5390,330190005000056,49,79,43,62,44,33,16,10,310,26,336,7.738095238095238
5391,330190005000057,108,120,104,130,84,58,40,27,604,67,671,9.985096870342772
5392,330190005000058,65,111,119,81,101,94,28,33,571,61,632,9.651898734177216
5393,330190005000059,76,81,105,99,80,62,49,28,503,77,580,13.275862068965518
5394,330190005000060,49,67,75,68,56,33,21,16,348,37,385,9.61038961038961
5395,330190005000061,50,79,83,61,55,48,32,20,376,52,428,12.149532710280374
5396,330190005000062,124,149,130,134,102,93,52,37,732,89,821,10.840438489646772
5397,330190005000063,140,176,176,127,109,92,50,27,820,77,897,8.58416945373467
5398,330190005000064,129,173,159,137,145,98,51,27,841,78,919,8.487486398258977
5399,330190005000065,78,130,93,121,77,58,38,12,557,50,607,8.237232289950576
5400,330190005000066,118,158,138,147,108,83,41,27,752,68,820,8.292682926829269
5401,330190005000067,165,193,169,172,145,97,51,29,941,80,1021,7.835455435847209
5402,330190005000068,96,107,103,107,95,53,47,23,561,70,631,11.09350237717908
5403,330190005000069,85,108,92,108,104,61,29,34,558,63,621,10.144927536231885
5404,330190005000070,59,87,60,79,61,47,31,29,393,60,453,13.245033112582782
5406,330190005000072,62,68,70,52,48,41,17,13,341,30,371,8.086253369272237
5407,330190005000073,64,83,75,68,62,40,30,34,392,64,456,14.035087719298245
5408,330190005000074,50,81,65,72,58,65,38,38,391,76,467,16.27408993576017
5409,330190005000075,9,19,19,18,25,18,15,10,108,25,133,18.796992481203006
5410,330190005000076,66,96,80,88,101,72,48,45,503,93,596,15.604026845637584
5411,330190005000077,52,49,52,48,38,40,22,20,279,42,321,13.08411214953271
5412,330190005000078,42,53,45,46,42,31,16,10,259,26,285,9.12280701754386
5413,330190005000079,78,114,98,91,84,60,52,33,525,85,610,13.934426229508198
5414,330190005000080,64,72,87,84,77,82,48,50,466,98,564,17.375886524822697
5415,330190005000081,77,122,106,114,104,82,38,40,605,78,683,11.420204978038067
5416,330190005000082,91,164,140,150,149,98,64,23,792,87,879,9.897610921501707
5417,330190005000083,105,162,160,156,94,108,52,38,785,90,875,10.285714285714286
5418,330190005000084,100,143,154,131,142,100,57,40,770,97,867,11.18800461361015
5419,330190005000085,68,93,122,91,98,70,35,31,542,66,608,10.855263157894736
5420,330190005000086,156,230,156,198,163,86,67,53,989,120,1109,10.820559062218214
5421,330190005000087,141,167,149,173,142,108,57,45,880,102,982,10.386965376782078
5422,330190005000088,135,120,126,135,81,64,35,21,661,56,717,7.810320781032078
5423,330190005000089,85,94,102,121,96,75,38,27,573,65,638,10.18808777429467
5424,330190005000090,53,79,93,71,90,56,35,22,442,57,499,11.422845691382765
5425,330190005000091,79,75,97,73,57,63,41,23,444,64,508,12.598425196850394
5426,330190005000092,115,160,160,155,125,74,60,28,789,88,877,10.034207525655644
5427,330190005000093,90,109,87,128,99,71,30,21,584,51,635,8.031496062992126
5428,330190005000094,69,101,93,88,77,67,45,25,495,70,565,12.389380530973451
5429,330190005000095,75,108,99,94,93,56,27,13,525,40,565,7.079646017699115
5430,330190005000096,106,96,109,100,77,57,30,20,545,50,595,8.403361344537815
5431,330190005000097,79,116,112,96,94,65,45,27,562,72,634,11.35646687697161
5432,330190005000098,212,233,194,205,172,100,64,40,1116,104,1220,8.524590163934427
5433,330190005000099,31,46,29,45,41,25,21,9,217,30,247,12.145748987854251
5434,330190005000100,95,142,134,122,101,80,56,25,674,81,755,10.728476821192054
5435,330190005000101,4,7,3,4,5,2,3,0,25,3,28,10.714285714285714
5436,330190005000102,103,143,102,119,101,69,34,30,637,64,701,9.12981455064194
5437,330190005000103,135,179,180,208,149,99,58,55,950,113,1063,10.630291627469425
5438,330190005000104,152,181,192,184,128,127,81,55,964,136,1100,12.363636363636363
5439,330190005000105,99,113,127,124,118,86,46,22,667,68,735,9.251700680272108
5440,330190005000106,95,121,109,113,85,69,39,15,592,54,646,8.359133126934985
5441,330190005000107,86,98,97,106,72,55,34,21,514,55,569,9.666080843585238
5442,330190005000108,76,83,90,80,73,45,27,23,447,50,497,10.060362173038229
5443,330190005000109,74,105,86,91,88,73,39,16,517,55,572,9.615384615384615
5444,330190005000110,107,130,144,106,111,80,53,45,678,98,776,12.628865979381443
5445,330190005000111,111,138,116,98,86,51,31,20,600,51,651,7.8341013824884795
5446,330190005000112,39,42,43,55,33,28,16,7,240,23,263,8.745247148288973
5447,330190005000113,55,61,50,50,56,41,31,28,313,59,372,15.86021505376344
5448,330190005000114,7,7,9,10,9,14,6,1,56,7,63,11.11111111111111
5449,330190005000115,94,143,139,144,123,96,58,41,739,99,838,11.813842482100238
5450,330190005000116,49,75,61,56,76,69,38,29,386,67,453,14.79028697571744
5451,330190005000117,12,8,6,14,12,7,2,7,59,9,68,13.235294117647058
5452,330190005000118,16,21,16,29,32,23,7,6,137,13,150,8.666666666666666
5453,330190005000119,18,33,25,30,21,17,6,6,144,12,156,7.6923076923076925
5454,330190005000120,38,45,52,34,34,16,10,9,219,19,238,7.983193277310924
5455,330190005000121,19,26,27,28,22,20,9,8,142,17,159,10.69182389937107
5456,330190005000122,92,74,76,70,48,36,18,6,396,24,420,5.714285714285714
5458,330190005000124,67,89,97,109,66,54,28,22,482,50,532,9.398496240601503
5460,330190005000126,124,137,99,162,141,84,33,22,747,55,802,6.85785536159601
5461,330190005000127,15,17,31,22,18,16,14,11,119,25,144,17.36111111111111
5462,330190005000128,32,39,45,38,44,29,10,3,227,13,240,5.416666666666667
5463,330190005000129,98,143,90,92,70,40,25,7,533,32,565,5.663716814159292
5464,330190005000130,8,7,5,9,3,2,5,4,34,9,43,20.930232558139537
5465,330190005000131,54,69,51,71,63,30,20,15,338,35,373,9.383378016085791
5466,330190005000132,32,49,26,28,25,14,4,5,174,9,183,4.918032786885246
5467,330190005000133,100,115,110,127,92,66,51,24,610,75,685,10.94890510948905
5468,330190005000134,64,101,101,89,85,68,45,26,508,71,579,12.26252158894646
5469,330190005000135,21,42,36,37,31,29,22,18,196,40,236,16.949152542372882
5470,330190005000136,27,35,35,29,55,28,19,8,209,27,236,11.440677966101696
5471,330190005000137,3,6,6,14,4,2,2,2,35,4,39,10.256410256410257
5472,330190005000138,71,86,113,137,99,75,33,25,581,58,639,9.076682316118935
5473,330190005000139,3,9,3,10,5,5,4,5,35,9,44,20.454545454545453
5474,330190005000140,37,50,45,54,56,38,24,19,280,43,323,13.312693498452012
5475,330190005000141,22,25,29,30,26,19,8,5,151,13,164,7.926829268292683
5476,330190005000142,68,85,95,85,81,47,18,21,461,39,500,7.8
5477,330190005000143,15,9,19,11,15,9,5,2,78,7,85,8.235294117647058
5478,330190005000144,39,58,39,51,44,23,23,14,254,37,291,12.714776632302405
5479,330190005000145,28,31,26,29,27,9,7,3,150,10,160,6.25
5480,330190005000146,40,55,41,47,43,19,18,9,245,27,272,9.926470588235293
5482,330190005000148,7,7,10,7,10,6,4,3,47,7,54,12.962962962962964
5483,330190005000149,15,16,7,16,9,12,8,3,75,11,86,12.790697674418604
5484,330190005000150,93,105,69,92,56,47,31,15,462,46,508,9.05511811023622
5485,330190005000151,49,46,50,38,41,9,17,10,233,27,260,10.384615384615385
5486,330190005000152,43,51,34,43,36,18,5,10,225,15,240,6.25
5487,330190005000153,94,126,73,107,89,46,32,17,535,49,584,8.39041095890411
5488,330190005000154,111,116,102,117,67,62,33,21,575,54,629,8.585055643879173
5489,330190005000155,162,168,146,119,100,63,32,9,758,41,799,5.131414267834794
5491,330190005000157,111,240,148,146,164,60,37,18,869,55,924,5.9523809523809526
5492,330190005000158,35,56,35,50,44,20,22,17,240,39,279,13.978494623655914
5493,330190005000159,69,78,70,76,80,61,36,34,434,70,504,13.88888888888889
5494,330190005000160,112,128,112,130,86,62,39,17,630,56,686,8.16326530612245
5495,330190005000161,95,139,105,101,99,55,29,25,594,54,648,8.333333333333334
5496,330190005000162,19,16,20,16,14,10,8,5,95,13,108,12.037037037037036
5497,330190005000163,37,43,36,29,28,13,8,8,186,16,202,7.920792079207921
5498,330190005000164,107,131,103,85,77,45,26,19,548,45,593,7.588532883642496
5499,330190005000165,113,69,113,71,71,54,29,13,491,42,533,7.879924953095685
5500,330190005000167,103,110,91,94,91,55,27,19,544,46,590,7.796610169491525
5501,330190005000168,37,68,81,58,68,53,33,17,365,50,415,12.048192771084338
5502,330190005000169,11,14,14,22,15,15,10,10,91,20,111,18.01801801801802
5503,330190005000170,72,112,69,112,110,78,33,22,553,55,608,9.046052631578947
5504,330190005000171,42,89,68,70,78,43,17,19,390,36,426,8.450704225352112
5506,330190005000173,12,12,11,8,11,8,11,6,62,17,79,21.518987341772153
5507,330190005000174,16,30,21,27,26,24,13,7,144,20,164,12.195121951219512
5508,330190005000175,70,93,70,89,69,44,29,18,435,47,482,9.751037344398341
5509,330190005000176,89,125,121,116,110,81,41,45,642,86,728,11.813186813186814
5510,330190005000177,49,71,57,79,80,48,31,18,384,49,433,11.316397228637413
5511,330190005000178,84,122,85,113,84,65,40,28,553,68,621,10.950080515297907
5512,330190005000179,20,22,18,32,23,17,9,12,132,21,153,13.72549019607843
5513,330190005000180,128,168,144,143,142,71,38,32,796,70,866,8.083140877598153
5514,330190005000181,93,110,102,92,87,61,24,18,545,42,587,7.155025553662692
5515,330190005000182,3,8,5,4,10,3,5,6,33,11,44,25.0
5516,330190005000183,14,5,8,9,8,2,3,1,46,4,50,8.0
5517,330190005000184,137,166,161,142,142,90,41,37,838,78,916,8.51528384279476
5519,330190005000187,81,76,70,91,57,50,28,17,425,45,470,9.574468085106384
5520,330190005000188,72,75,87,65,59,44,25,25,402,50,452,11.061946902654867
5521,330190005000189,100,113,138,108,82,70,26,16,611,42,653,6.431852986217458
5522,330190005000190,106,159,112,108,80,52,25,26,617,51,668,7.634730538922156
5523,330190005000191,77,92,102,87,50,57,31,20,465,51,516,9.883720930232558
5524,330190005000192,61,75,74,62,71,56,35,25,399,60,459,13.071895424836601
5525,330190005000193,90,106,66,64,82,65,27,13,473,40,513,7.797270955165692
5527,330190005000195,49,71,58,69,70,37,23,14,354,37,391,9.462915601023019
5528,330190005000196,17,36,19,17,15,12,4,8,116,12,128,9.375
5529,330190005000197,0,0,0,0,1,0,0,0,1,0,1,0.0
5530,330190005000198,246,205,183,182,127,85,41,28,1028,69,1097,6.289881494986326
5531,330190005000199,132,119,102,94,98,65,39,25,610,64,674,9.495548961424332
5532,330190005000200,74,79,80,83,79,75,49,23,470,72,542,13.284132841328413
5533,330190005000201,44,62,58,56,48,45,23,15,313,38,351,10.826210826210826
5534,330190005000202,7,17,6,7,10,10,3,4,57,7,64,10.9375
5535,330190005000203,6,7,10,4,4,2,1,0,33,1,34,2.9411764705882355
5536,330190010000001,55,91,83,89,74,72,56,47,464,103,567,18.1657848324515
5537,330190010000002,95,140,103,104,120,76,61,50,638,111,749,14.819759679572764
5538,330190010000003,74,102,69,102,82,49,37,26,478,63,541,11.645101663585953
5539,330190010000004,106,155,153,143,142,119,73,41,818,114,932,12.231759656652361
5540,330190010000005,96,128,96,102,92,60,48,34,574,82,656,12.5
5542,330190010000007,0,10,6,4,5,3,1,2,28,3,31,9.67741935483871
5543,330190010000008,8,12,9,9,4,6,2,2,48,4,52,7.6923076923076925
5544,330190010000009,2,9,0,4,4,4,3,0,23,3,26,11.538461538461538
5545,330190010000010,6,7,7,5,8,3,3,1,36,4,40,10.0
5546,330190010000011,129,119,140,128,102,104,60,30,722,90,812,11.083743842364532
5547,330190010000012,20,44,24,21,31,22,18,17,162,35,197,17.766497461928935
5548,330190010000013,157,150,144,188,142,101,79,70,882,149,1031,14.451988360814743
5549,330190010000014,184,195,186,214,180,126,70,45,1085,115,1200,9.583333333333334
5550,330190010000015,13,12,16,9,2,16,3,2,68,5,73,6.8493150684931505
5551,330190010000016,14,19,14,14,22,7,14,11,90,25,115,21.73913043478261
5552,330190010000017,20,33,22,45,28,43,37,23,191,60,251,23.904382470119522
5553,330190010000018,18,37,16,35,20,19,18,16,145,34,179,18.99441340782123
5554,330190010000019,3,10,5,7,16,2,5,2,43,7,50,14.0
5555,330190010000020,3,14,7,11,8,9,2,4,52,6,58,10.344827586206897
5556,330190010000021,6,3,7,7,2,1,0,2,26,2,28,7.142857142857143
5557,330190010000022,5,9,4,13,8,4,6,3,43,9,52,17.307692307692307
5560,330190010000025,38,66,72,62,69,49,32,20,356,52,408,12.745098039215685
5561,330190010000026,18,8,13,15,9,13,10,7,76,17,93,18.27956989247312
5562,330190010000027,10,8,10,8,5,7,2,2,48,4,52,7.6923076923076925
5563,330190010000028,15,21,14,13,10,8,8,4,81,12,93,12.903225806451612
5564,330190015000001,11,15,8,13,5,7,2,3,59,5,64,7.8125
5565,330190015000002,33,41,35,35,24,26,9,5,194,14,208,6.730769230769231
5566,330190015000003,196,241,172,202,129,126,56,32,1066,88,1154,7.625649913344887
5567,330190015000004,123,143,144,140,94,80,47,28,724,75,799,9.386733416770964
5568,330190015000005,104,120,78,95,71,47,24,16,515,40,555,7.207207207207207
5569,330190015000006,73,87,60,73,44,35,24,19,372,43,415,10.36144578313253
5570,330190015000007,227,251,215,190,141,134,47,31,1158,78,1236,6.310679611650485
5572,330190015000009,5,4,3,3,7,0,0,4,22,4,26,15.384615384615385
5573,330190015000010,44,57,35,32,14,14,4,5,196,9,205,4.390243902439025
5574,330190015000011,87,87,83,69,57,34,19,14,417,33,450,7.333333333333333
5575,330190015000012,76,125,98,110,94,67,44,32,570,76,646,11.764705882352942
5576,330190015000013,77,86,74,86,86,61,51,33,470,84,554,15.16245487364621
5577,330190015000014,97,128,109,141,84,60,48,20,619,68,687,9.8981077147016
5578,330190015000015,97,117,109,95,76,73,38,10,567,48,615,7.804878048780488
5579,330190015000016,134,152,154,140,91,89,51,27,760,78,838,9.307875894988067
5580,330190015000017,158,170,163,170,131,110,52,25,902,77,979,7.865168539325842
5581,330190015000018,117,178,136,162,116,78,67,35,787,102,889,11.473565804274466
5582,330190015000019,117,131,140,92,101,67,27,17,648,44,692,6.358381502890174
5583,330190015000020,192,197,176,180,144,91,62,47,980,109,1089,10.009182736455463
5584,330190015000021,104,125,103,94,77,72,39,24,575,63,638,9.87460815047022
5585,330190015000022,115,153,103,99,78,74,33,24,622,57,679,8.394698085419735
5586,330190015000023,92,125,96,118,95,56,52,27,582,79,661,11.951588502269288
5587,330190015000024,29,43,11,23,27,21,9,6,154,15,169,8.875739644970414
5588,330190015000025,150,217,150,168,151,108,67,51,944,118,1062,11.11111111111111
5589,330190015000026,57,77,63,66,44,33,24,15,340,39,379,10.29023746701847
5590,330190015000027,23,31,48,39,41,35,23,23,217,46,263,17.490494296577946
5591,330190015000028,16,17,33,27,20,22,5,10,135,15,150,10.0
5593,330190015000030,20,29,29,9,15,11,8,0,113,8,121,6.6115702479338845
5594,330190015000031,99,110,75,107,62,51,36,23,504,59,563,10.479573712255773
5595,330190015000032,33,37,21,27,27,17,9,4,162,13,175,7.428571428571429
5597,330190015000034,6,3,0,3,2,2,4,1,16,5,21,23.80952380952381
5598,330190015000035,64,93,83,98,61,38,30,25,437,55,492,11.178861788617887
5600,330190015000037,93,100,75,107,122,64,39,23,561,62,623,9.951845906902086
5601,330190015000038,117,132,111,123,71,74,43,26,628,69,697,9.899569583931134
5603,330190015000040,6,3,4,4,5,3,2,0,25,2,27,7.407407407407407
5604,330190015000041,21,23,12,20,12,8,5,4,96,9,105,8.571428571428571
5606,330190015000043,37,62,40,56,29,28,10,6,252,16,268,5.970149253731344
5607,330190015000044,48,51,56,35,38,38,28,14,266,42,308,13.636363636363637
5608,330190015000045,21,20,22,23,11,13,1,6,110,7,117,5.982905982905983
5609,330190015000046,137,180,151,120,119,78,37,35,785,72,857,8.401400233372229
5610,330190015000047,134,138,140,127,99,78,47,32,716,79,795,9.937106918238994
5611,330190015000048,71,71,78,67,42,53,29,28,382,57,439,12.984054669703873
5612,330190015000049,78,90,100,89,65,53,39,20,475,59,534,11.04868913857678
5613,330190015000050,25,35,38,37,33,38,19,11,206,30,236,12.711864406779661
5614,330190018000001,63,93,111,84,90,81,46,26,522,72,594,12.121212121212121
5615,330190018000002,62,82,96,96,86,74,37,29,496,66,562,11.743772241992882
5616,330190018000003,52,70,75,64,55,37,28,18,353,46,399,11.528822055137844
5617,330190018000004,52,76,50,59,57,37,25,24,331,49,380,12.894736842105264
5618,330190018000005,78,160,136,163,136,105,64,53,778,117,895,13.072625698324023
5619,330190018000006,154,202,187,226,209,127,63,42,1105,105,1210,8.677685950413224
5620,330190018000007,82,80,91,97,86,61,37,14,497,51,548,9.306569343065693
5621,330190018000008,109,123,143,133,109,79,59,26,696,85,781,10.88348271446863
5622,330190018000009,168,233,150,235,166,93,53,24,1045,77,1122,6.862745098039215
5623,330190018000010,92,111,125,101,97,64,32,7,590,39,629,6.200317965023848
5624,330190018000011,62,108,93,105,100,65,54,31,533,85,618,13.754045307443366
5625,330190018000012,14,14,19,17,22,9,5,1,95,6,101,5.9405940594059405
5626,330190018000013,62,119,77,93,83,69,38,21,503,59,562,10.498220640569395
5627,330190018000014,134,178,120,221,163,96,45,30,912,75,987,7.598784194528875
5628,330190018000015,89,121,80,121,81,43,54,21,535,75,610,12.295081967213115
5629,330190018000016,190,196,181,187,147,147,81,38,1048,119,1167,10.197086546700943
5630,330190018000017,6,5,10,8,21,7,6,7,57,13,70,18.571428571428573
5631,330190018000018,58,80,69,71,60,33,31,17,371,48,419,11.455847255369928
5632,330190018000019,58,67,49,45,42,38,20,16,299,36,335,10.746268656716419
5633,330190018000020,1,7,5,3,10,5,1,1,31,2,33,6.0606060606060606
5634,330190018000021,78,104,101,89,98,71,43,15,541,58,599,9.68280467445743
5635,330190018000022,6,3,3,9,2,3,1,0,26,1,27,3.7037037037037037
5636,330190018000023,67,74,86,77,63,59,36,15,426,51,477,10.69182389937107
5637,330190018000024,94,132,118,110,87,64,40,18,605,58,663,8.74811463046757
5638,330190018000025,99,156,112,128,128,79,39,22,702,61,763,7.99475753604194
5639,330190018000026,46,67,80,57,52,63,27,18,365,45,410,10.975609756097562
5640,330190018000027,40,69,83,54,61,72,33,16,379,49,428,11.448598130841122
5641,330190018000028,57,70,84,47,60,53,28,11,371,39,410,9.512195121951219
5642,330190018000029,65,82,136,61,82,86,31,29,512,60,572,10.48951048951049
5643,330190018000030,116,108,128,105,91,88,38,20,636,58,694,8.357348703170029
5644,330190018000031,82,95,106,105,79,75,38,12,542,50,592,8.445945945945946
5645,330190018000032,138,146,151,166,135,118,64,28,854,92,946,9.725158562367865
5646,330190018000033,115,167,166,192,132,122,70,40,894,110,1004,10.95617529880478
5647,330190018000034,55,72,67,84,67,52,30,16,397,46,443,10.383747178329571
5648,330190018000035,47,49,47,56,28,36,15,9,263,24,287,8.362369337979095
5649,330190018000036,189,205,205,212,176,90,76,35,1077,111,1188,9.343434343434344
5650,330190018000037,66,98,87,84,68,36,18,19,439,37,476,7.773109243697479
5651,330190018000038,73,78,60,103,47,48,22,11,409,33,442,7.46606334841629
5652,330190018000039,86,138,141,140,111,103,54,32,719,86,805,10.683229813664596
5653,330190018000040,99,107,98,115,94,56,24,18,569,42,611,6.873977086743044
5654,330190018000041,109,142,133,126,96,66,37,28,672,65,737,8.819538670284938
5655,330190018000042,33,33,63,48,38,38,22,8,253,30,283,10.60070671378092
5656,330190018000043,81,96,107,102,73,67,44,27,526,71,597,11.892797319932999
5657,330190018000044,40,28,39,53,19,38,30,8,217,38,255,14.901960784313726
5658,330190018000045,37,38,54,42,41,32,18,9,244,27,271,9.96309963099631
5659,330190018000046,77,79,100,74,87,74,39,21,491,60,551,10.88929219600726
5660,330190018000047,25,27,13,28,15,9,4,0,117,4,121,3.3057851239669422
5661,330190018000048,91,136,113,107,90,63,50,16,600,66,666,9.90990990990991
5662,330190018000049,30,47,30,35,32,16,6,5,190,11,201,5.472636815920398
5663,330190018000050,131,193,183,182,172,134,65,35,995,100,1095,9.132420091324201
5664,330190018000051,101,126,126,120,139,85,38,29,697,67,764,8.769633507853403
5665,330190018000052,36,58,53,73,43,48,21,19,311,40,351,11.396011396011396
5666,330190018000053,73,94,91,83,72,54,26,23,467,49,516,9.496124031007753
5667,330190018000054,54,59,63,58,44,36,18,13,314,31,345,8.985507246376812
5668,330190018000055,81,89,106,108,55,73,33,18,512,51,563,9.058614564831261
5669,330190018000056,71,126,87,92,80,67,23,31,523,54,577,9.358752166377815
5670,330190018000057,81,73,113,100,55,78,27,21,500,48,548,8.75912408759124
5671,330190018000058,53,81,87,67,74,56,38,14,418,52,470,11.063829787234043
5672,330190018000059,64,88,75,90,64,60,30,14,441,44,485,9.072164948453608
5673,330190018000060,78,99,113,109,102,84,44,34,585,78,663,11.764705882352942
5674,330190018000061,119,173,146,160,145,111,79,36,854,115,969,11.867905056759547
5675,330190018000062,67,95,69,92,107,59,51,31,489,82,571,14.360770577933451
5676,330190018000063,76,111,90,94,71,49,31,19,491,50,541,9.242144177449168
5677,330190018000064,89,122,106,124,84,77,41,31,602,72,674,10.682492581602373
5678,330190018000065,92,110,108,93,95,53,56,27,551,83,634,13.091482649842272
5679,330190018000066,140,145,168,177,143,103,59,42,876,101,977,10.337768679631525
5680,330190018000067,155,209,177,167,114,105,41,28,927,69,996,6.927710843373494
5681,330190018000068,161,182,184,168,147,129,57,40,971,97,1068,9.082397003745319
5682,330190018000069,120,126,119,115,89,91,29,25,660,54,714,7.563025210084033
5683,330190018000070,83,129,90,130,96,69,27,20,597,47,644,7.298136645962733
5684,330190018000071,97,106,126,117,88,68,47,14,602,61,663,9.200603318250376
5685,330190018000072,74,107,110,97,76,54,37,21,518,58,576,10.069444444444445
5686,330190018000073,31,45,24,42,56,18,16,5,216,21,237,8.860759493670885
5687,330190018000074,191,252,120,284,226,84,46,18,1157,64,1221,5.241605241605241
5688,330190018000075,67,70,49,67,63,45,16,15,361,31,392,7.908163265306122
5689,330190018000076,117,88,93,168,95,38,23,11,599,34,633,5.371248025276461
5690,330190018000077,99,137,116,114,100,82,42,26,648,68,716,9.497206703910615
5691,330190018000078,63,148,116,132,145,87,48,10,691,58,749,7.74365821094793
5692,330190018000079,128,137,147,128,126,98,55,26,764,81,845,9.585798816568047
5693,330190018000080,99,111,97,112,94,51,37,13,564,50,614,8.143322475570033
5694,330190018000081,11,19,13,21,9,14,9,4,87,13,100,13.0
5695,330190018000082,95,62,81,112,48,48,20,12,446,32,478,6.694560669456067
5696,330190018000083,53,69,86,82,74,49,22,8,413,30,443,6.772009029345372
5697,330190018000084,46,74,66,68,55,54,27,15,363,42,405,10.37037037037037
5698,330190018000085,48,116,75,89,72,50,30,20,450,50,500,10.0
5699,330190018000086,87,92,81,87,73,56,43,23,476,66,542,12.177121771217712
5700,330190018000087,86,116,89,126,74,64,63,23,555,86,641,13.41653666146646
5701,330190018000088,12,17,13,13,10,7,1,4,72,5,77,6.4935064935064934
5702,330190018000089,156,186,175,202,146,131,53,48,996,101,1097,9.206927985414767
5703,330190018000090,118,94,106,117,88,76,36,20,599,56,655,8.549618320610687
5704,330190018000091,95,125,126,106,101,53,30,22,606,52,658,7.90273556231003
5705,330190018000092,122,136,124,132,93,78,22,10,685,32,717,4.463040446304045
5706,330190018000093,16,20,25,14,13,9,2,6,97,8,105,7.619047619047619
5707,330190018000094,128,172,144,157,122,88,65,35,811,100,911,10.97694840834248
5708,330190018000095,104,102,118,99,82,71,31,19,576,50,626,7.987220447284345
5709,330190018000096,186,201,212,200,158,122,64,29,1079,93,1172,7.935153583617748
5710,330190018000097,32,62,74,42,61,51,17,15,322,32,354,9.03954802259887
5711,330190018000098,68,79,85,100,65,69,31,23,466,54,520,10.384615384615385
5712,330190018000099,40,51,38,36,18,19,5,12,202,17,219,7.762557077625571
5713,330190019000001,61,76,54,82,49,28,32,20,350,52,402,12.935323383084578
5714,330190019000002,7,19,12,11,13,10,6,3,72,9,81,11.11111111111111
5715,330190019000003,22,40,23,45,32,26,29,13,188,42,230,18.26086956521739
5716,330190019000004,16,11,19,16,15,11,13,10,88,23,111,20.72072072072072
5717,330190019000005,29,55,39,33,37,22,18,20,215,38,253,15.019762845849803
5718,330190019000006,43,90,42,69,61,42,28,35,347,63,410,15.365853658536585
5719,330190019000007,48,61,49,40,63,48,24,28,309,52,361,14.404432132963988
5721,330190019000009,91,118,105,115,114,73,60,45,616,105,721,14.563106796116505
5723,330190019000011,68,73,76,79,72,52,47,37,420,84,504,16.666666666666668
5724,330190019000012,38,51,48,51,47,36,36,17,271,53,324,16.358024691358025
5725,330190019000013,20,29,33,32,27,25,17,14,166,31,197,15.736040609137056
5726,330190019000014,28,40,23,25,13,11,14,2,140,16,156,10.256410256410257
5727,330190019000015,18,17,14,21,13,20,18,13,103,31,134,23.134328358208954
5729,330190020000001,149,216,176,185,166,91,46,32,983,78,1061,7.351555136663525
5730,330190020000002,88,116,110,92,87,86,40,20,579,60,639,9.389671361502348
5731,330190020000003,109,134,176,134,112,92,51,46,757,97,854,11.358313817330211
5732,330190020000004,129,172,138,168,150,71,46,34,828,80,908,8.810572687224669
5733,330190020000005,10,26,22,18,20,13,8,3,109,11,120,9.166666666666666
5734,330190020000008,7,5,4,5,1,2,1,0,24,1,25,4.0
5735,330190020000009,33,30,26,36,20,12,12,6,157,18,175,10.285714285714286
5736,330190025000001,38,33,35,31,31,20,6,12,188,18,206,8.737864077669903
5737,330190025000002,38,66,33,54,42,48,18,27,281,45,326,13.803680981595091
5738,330190025000003,45,66,67,65,73,43,25,32,359,57,416,13.701923076923077
5739,330190025000004,16,14,17,18,18,3,9,6,86,15,101,14.851485148514852
5740,330190025000005,4,9,10,8,8,14,7,3,53,10,63,15.873015873015873
5741,330190025000006,47,61,46,58,47,30,13,16,289,29,318,9.119496855345911
5742,330190025000007,16,14,7,17,19,10,8,8,83,16,99,16.161616161616163
5743,330190025000008,33,46,22,32,20,14,13,11,167,24,191,12.565445026178011
5744,330190025000009,41,58,36,50,43,38,14,11,266,25,291,8.59106529209622
5745,330190025000010,150,200,161,149,166,81,55,50,907,105,1012,10.375494071146244
5746,330190025000011,8,4,8,3,5,7,1,1,35,2,37,5.405405405405405
5747,330190025000012,30,34,31,26,29,28,26,11,178,37,215,17.209302325581394
5748,330190025000013,36,50,32,40,37,23,24,5,218,29,247,11.740890688259109
5750,330190025000015,97,128,57,75,57,31,26,24,445,50,495,10.1010101010101
5751,330190025000016,28,52,26,30,35,22,12,11,193,23,216,10.648148148148149
5753,330190025000018,8,5,5,6,1,3,2,0,28,2,30,6.666666666666667
5754,330190025000019,6,7,9,2,9,1,1,3,34,4,38,10.526315789473685
5756,330190025000021,48,60,76,74,67,40,14,11,365,25,390,6.410256410256411
5758,330190040000001,121,169,122,133,125,91,45,27,761,72,833,8.643457382953182
5759,330190040000002,85,93,94,115,80,45,36,25,512,61,573,10.645724258289704
5760,330190040000003,80,87,109,70,64,84,39,38,494,77,571,13.485113835376533
5761,330190040000004,6,8,7,9,11,5,4,5,46,9,55,16.363636363636363
5762,330190040000005,10,8,8,11,13,5,4,1,55,5,60,8.333333333333334
5763,330190040000006,84,96,92,95,79,59,30,30,505,60,565,10.619469026548673
5764,330190040000007,1,7,5,5,3,4,3,2,25,5,30,16.666666666666668
5765,330190040000008,97,149,107,107,125,75,42,20,660,62,722,8.587257617728532
5766,330190040000009,152,166,129,118,79,89,39,39,733,78,811,9.617755856966708
5767,330190040000010,131,118,118,105,119,95,47,36,686,83,769,10.793237971391417
5768,330190040000011,137,161,122,119,100,70,49,28,709,77,786,9.79643765903308
5769,330190040000012,24,15,14,13,15,4,9,4,85,13,98,13.26530612244898
5771,330190040000014,15,29,20,19,22,33,13,6,138,19,157,12.101910828025478
5773,330190040000016,178,197,189,166,165,102,57,36,997,93,1090,8.53211009174312
5774,330190040000017,153,188,161,163,137,100,67,44,902,111,1013,10.957551826258637
5776,330200705000001,50,57,79,67,72,79,39,40,404,79,483,16.356107660455486
5777,330200705000002,93,108,96,114,97,84,47,46,592,93,685,13.576642335766424
5778,330200705000003,98,138,159,154,153,118,92,108,820,200,1020,19.607843137254903
5779,330200705000004,69,111,153,123,130,101,72,61,687,133,820,16.21951219512195
5780,330200705000005,102,107,136,153,98,83,53,46,679,99,778,12.724935732647815
5781,330200705000006,99,94,132,94,107,87,48,42,613,90,703,12.802275960170697
5782,330200705000007,93,118,114,119,102,111,60,62,657,122,779,15.661103979460847
5783,330200705000008,98,107,116,99,101,76,40,32,597,72,669,10.762331838565023
5784,330200705000009,64,101,77,95,68,68,41,19,473,60,533,11.25703564727955
5785,330200705000010,67,107,91,96,108,65,38,34,534,72,606,11.881188118811881
5786,330200705000011,114,129,136,164,92,66,37,19,701,56,757,7.397622192866579
5787,330200705000012,27,56,79,61,48,43,37,22,314,59,373,15.817694369973191
5788,330200705000013,72,124,154,141,142,74,47,41,707,88,795,11.069182389937106
5789,330200705000014,91,122,134,170,125,93,43,27,735,70,805,8.695652173913043
5790,330200705000015,51,81,71,97,58,67,35,30,425,65,490,13.26530612244898
5791,330200705000016,73,111,161,107,115,89,51,49,656,100,756,13.227513227513228
5792,330200705000017,68,86,130,122,106,109,55,49,621,104,725,14.344827586206897
5793,330200705000018,66,93,119,119,83,70,39,40,550,79,629,12.559618441971383
5794,330200705000019,47,63,73,81,66,44,35,20,374,55,429,12.820512820512821
5795,330200705000020,119,111,171,120,106,102,41,28,729,69,798,8.646616541353383
5796,330200705000021,189,106,147,173,92,79,57,31,786,88,874,10.068649885583524
5797,330200705000022,30,47,45,31,24,40,12,5,217,17,234,7.264957264957265
5798,330200705000023,108,131,109,105,85,65,29,23,603,52,655,7.938931297709924
5799,330200705000024,80,122,107,95,111,97,44,25,612,69,681,10.13215859030837
5800,330200705000025,84,112,117,109,103,52,32,8,577,40,617,6.482982171799027
5801,330200705000026,133,151,205,173,134,120,60,30,916,90,1006,8.946322067594433
5802,330200705000027,143,151,200,142,118,93,53,23,847,76,923,8.234019501625136
5803,330200705000028,136,149,119,114,93,44,25,17,655,42,697,6.025824964131994
5804,330200705000029,125,142,169,142,126,91,43,32,795,75,870,8.620689655172415
5805,330200705000030,156,175,215,250,156,96,56,33,1048,89,1137,7.827616534740545
5806,330200705000031,168,190,270,226,175,131,63,37,1160,100,1260,7.936507936507937
5807,330200705000032,87,77,114,88,94,55,32,22,515,54,569,9.490333919156415
5808,330200705000033,187,214,159,151,145,90,50,22,946,72,1018,7.072691552062868
5809,330200705000034,277,234,254,255,147,102,46,25,1269,71,1340,5.298507462686567
5810,330200705000035,105,155,118,137,110,121,64,30,746,94,840,11.19047619047619
5811,330200705000036,131,133,153,115,98,61,25,17,691,42,733,5.729877216916781
5812,330200705000037,209,223,197,205,163,76,57,26,1073,83,1156,7.179930795847751
5813,330200705000038,38,44,39,24,25,14,6,4,184,10,194,5.154639175257732
5814,330200705000039,97,110,120,93,88,72,31,27,580,58,638,9.090909090909092
5815,330200705000040,205,249,195,194,142,98,55,22,1083,77,1160,6.637931034482759
5816,330200705000041,161,151,214,187,113,107,71,37,933,108,1041,10.37463976945245
5817,330200705000042,74,96,85,80,50,40,25,21,425,46,471,9.766454352441613
5818,330200705000043,170,237,205,168,127,117,36,32,1024,68,1092,6.227106227106227
5819,330200705000044,67,90,101,77,62,51,27,25,448,52,500,10.4
5820,330200705000045,153,153,188,180,163,121,47,33,958,80,1038,7.707129094412331
5821,330200705000046,139,174,232,154,149,107,55,32,955,87,1042,8.349328214971209
5822,330200705000047,108,125,142,126,89,86,54,28,676,82,758,10.817941952506596
5823,330200705000048,80,93,109,88,81,34,32,17,485,49,534,9.176029962546817
5824,330200705000049,83,103,107,101,89,61,22,21,544,43,587,7.325383304940375
5825,330200705000050,158,176,205,213,164,134,60,65,1050,125,1175,10.638297872340425
5826,330200705000051,64,61,104,107,51,39,21,22,426,43,469,9.168443496801705
5827,330200705000052,101,148,136,105,102,89,51,45,681,96,777,12.355212355212355
5828,330200705000053,115,137,137,129,111,100,68,34,729,102,831,12.274368231046932
5829,330200705000054,108,118,139,120,76,85,36,22,646,58,704,8.238636363636363
5830,330200705000055,82,141,157,143,122,106,58,35,751,93,844,11.018957345971565
5831,330200705000056,81,100,103,95,102,80,37,31,561,68,629,10.81081081081081
5832,330200705000057,122,129,147,154,116,78,58,43,746,101,847,11.92443919716647
5833,330200705000058,106,112,131,111,97,82,49,28,639,77,716,10.754189944134078
5834,330200705000059,69,105,106,128,86,90,49,39,584,88,672,13.095238095238095
5835,330200705000060,52,73,91,82,72,69,44,20,439,64,503,12.723658051689862
5836,330200705000061,117,155,142,170,141,78,40,19,803,59,862,6.844547563805104
5837,330200705000062,89,128,105,130,107,65,52,24,624,76,700,10.857142857142858
5838,330200705000063,162,175,153,195,132,102,54,34,919,88,1007,8.738828202581926
5839,330200705000064,161,205,156,186,123,78,55,35,909,90,999,9.00900900900901
5840,330200705000065,195,243,214,196,159,103,65,36,1110,101,1211,8.340214698596201
5841,330200705000066,152,176,176,182,147,106,45,37,939,82,1021,8.03134182174339
5842,330200705000067,153,166,179,151,128,99,50,33,876,83,959,8.654848800834202
5843,330200705000068,256,293,221,258,174,109,56,30,1311,86,1397,6.156048675733715
5844,330200705000069,122,146,120,116,78,71,36,23,653,59,712,8.286516853932584
5845,330200705000070,55,61,48,38,19,24,9,5,245,14,259,5.405405405405405
5846,330200705000071,84,98,77,87,54,49,30,18,449,48,497,9.6579476861167
5847,330200705000072,119,121,105,90,66,46,29,15,547,44,591,7.4450084602368864
5848,330200705000073,97,119,119,116,79,69,56,14,599,70,669,10.46337817638266
5849,330200705000074,189,176,151,131,116,89,51,33,852,84,936,8.974358974358974
5850,330200705000075,65,68,72,78,47,50,35,29,380,64,444,14.414414414414415
5851,330200705000076,86,120,95,126,80,67,52,32,574,84,658,12.76595744680851
5852,330200705000077,34,64,45,39,50,24,27,24,256,51,307,16.612377850162865
5853,330200705000078,92,110,72,94,79,62,38,24,509,62,571,10.85814360770578
5854,330200705000079,115,145,135,153,116,93,54,28,757,82,839,9.773539928486294
5855,330200705000080,153,134,147,113,93,63,47,27,703,74,777,9.523809523809524
5856,330200705000081,83,98,94,97,81,42,31,21,495,52,547,9.506398537477148
5857,330200705000082,84,78,73,68,43,30,14,4,376,18,394,4.568527918781726
5858,330200705000083,256,289,222,249,149,114,54,34,1279,88,1367,6.437454279444038
5859,330200705000084,182,176,161,146,92,73,31,18,830,49,879,5.5745164960182025
5860,330200705000085,94,125,114,100,85,87,42,36,605,78,683,11.420204978038067
5861,330200705000086,62,72,51,44,33,38,11,7,300,18,318,5.660377358490566
5862,330200705000087,84,101,98,118,110,81,42,30,592,72,664,10.843373493975903
5863,330200705000088,117,143,123,114,88,63,40,15,648,55,703,7.823613086770981
5864,330200705000089,158,175,153,142,115,75,37,27,818,64,882,7.2562358276643995
5865,330200705000090,62,84,62,59,49,30,25,13,346,38,384,9.895833333333334
5866,330200705000091,83,122,96,105,72,53,28,8,531,36,567,6.349206349206349
5867,330200705000092,131,134,123,126,91,80,30,35,685,65,750,8.666666666666666
5868,330200705000093,127,137,126,124,135,81,57,37,730,94,824,11.407766990291263
5869,330200705000094,111,140,123,131,106,70,41,20,681,61,742,8.221024258760108
5870,330200705000095,143,166,186,127,119,81,39,23,822,62,884,7.013574660633484
5871,330200705000096,109,141,143,92,115,69,42,24,669,66,735,8.979591836734693
5872,330200705000097,246,274,221,222,155,118,58,48,1236,106,1342,7.898658718330849
5873,330200705000098,83,109,86,66,78,51,26,19,473,45,518,8.687258687258687
5874,330200705000099,95,106,106,103,74,65,35,31,549,66,615,10.731707317073171
5875,330200705000100,154,225,180,167,160,137,97,52,1023,149,1172,12.713310580204778
5876,330200705000101,91,129,119,99,109,123,68,57,670,125,795,15.723270440251572
5877,330200705000102,25,38,25,27,40,46,32,25,201,57,258,22.093023255813954
5878,330200705000103,27,47,50,35,46,49,25,28,254,53,307,17.263843648208468
5879,330200705000104,30,37,49,35,51,53,34,25,255,59,314,18.78980891719745
5880,330200705000105,60,68,65,44,62,53,37,35,352,72,424,16.9811320754717
5881,330200705000106,42,63,63,58,53,46,39,12,325,51,376,13.563829787234043
5882,330200705000107,88,120,113,117,74,78,47,23,590,70,660,10.606060606060606
5883,330200705000108,45,64,54,65,59,40,35,24,327,59,386,15.284974093264248
5884,330200705000109,66,96,107,67,85,80,56,29,501,85,586,14.505119453924914
5885,330200705000110,101,125,127,108,74,84,40,21,619,61,680,8.970588235294118
5886,330200705000111,240,271,275,198,166,109,57,26,1259,83,1342,6.184798807749627
5887,330200705000112,87,152,161,130,133,111,66,21,774,87,861,10.104529616724738
5888,330200705000113,176,178,142,114,102,60,37,21,772,58,830,6.9879518072289155
5889,330200705000114,53,73,32,40,35,35,11,7,268,18,286,6.293706293706293
5890,330200705000115,100,115,132,128,92,99,57,33,666,90,756,11.904761904761905
5891,330200705000116,183,201,188,143,133,86,43,36,934,79,1013,7.7986179664363275
5892,330200705000117,145,210,160,174,127,73,45,33,889,78,967,8.066184074457084
5893,330200705000118,158,150,138,114,92,75,38,22,727,60,787,7.6238881829733165
5894,330200705000119,90,123,89,110,70,59,35,32,541,67,608,11.019736842105264
5895,330200705000120,82,93,104,81,75,55,33,15,490,48,538,8.921933085501859
5896,330200705000121,256,284,238,258,215,135,89,46,1386,135,1521,8.875739644970414
5897,330200705000122,42,62,50,50,61,36,27,14,301,41,342,11.988304093567251
5898,330200705000123,281,234,285,360,156,210,67,29,1526,96,1622,5.9186189889025895
5899,330200705000124,69,92,84,68,64,43,27,32,420,59,479,12.31732776617954
5900,330200705000125,34,64,35,44,45,32,19,17,254,36,290,12.413793103448276
5901,330200705000126,16,6,40,22,13,6,1,0,103,1,104,0.9615384615384616
5902,330200705000127,72,132,90,99,82,64,52,46,539,98,637,15.384615384615385
5903,330200705000128,27,22,20,22,21,28,24,6,140,30,170,17.647058823529413
5904,330200705000129,12,12,8,17,16,4,1,3,69,4,73,5.47945205479452
5905,330200705000130,56,43,38,47,30,21,14,18,235,32,267,11.985018726591761
5906,330200705000131,26,31,28,26,27,20,13,10,158,23,181,12.707182320441989
5907,330200705000132,9,9,2,6,3,0,1,0,29,1,30,3.3333333333333335
5908,330200705000133,32,25,25,34,9,11,12,4,136,16,152,10.526315789473685
5909,330200705000134,217,237,144,163,109,66,29,19,936,48,984,4.878048780487805
5910,330200705000135,102,111,122,108,103,79,33,21,625,54,679,7.952871870397644
5911,330200705000136,56,64,55,43,33,28,16,7,279,23,302,7.6158940397351
5912,330200705000137,34,37,45,34,40,17,4,6,207,10,217,4.608294930875576
5913,330200705000138,104,125,121,120,86,69,36,14,625,50,675,7.407407407407407
5914,330200705000139,129,141,106,109,101,88,39,24,674,63,737,8.548168249660787
5915,330200705000140,45,60,55,68,47,27,12,6,302,18,320,5.625
5916,330200705000141,129,141,164,129,98,57,36,17,718,53,771,6.874189364461738
5917,330200705000142,110,115,103,90,69,38,24,17,525,41,566,7.243816254416961
5918,330200705000143,33,41,22,18,14,15,8,3,143,11,154,7.142857142857143
5919,330200705000144,115,110,136,118,83,85,53,28,647,81,728,11.126373626373626
5920,330200705000145,78,106,138,134,105,106,55,30,667,85,752,11.303191489361701
5921,330200705000146,83,79,125,85,61,61,32,18,494,50,544,9.191176470588236
5922,330200705000147,119,158,159,130,103,82,41,23,751,64,815,7.852760736196319
5923,330200705000148,146,100,142,103,101,69,29,18,661,47,708,6.638418079096045
5924,330200705000149,123,137,101,83,81,45,25,6,570,31,601,5.158069883527454
5925,330200705000150,168,212,189,175,98,92,33,20,934,53,987,5.369807497467072
5926,330200705000151,113,140,128,114,100,60,23,14,655,37,692,5.3468208092485545
5927,330200705000152,74,94,91,70,87,34,23,23,450,46,496,9.274193548387096
5928,330200705000153,211,251,229,244,175,135,45,34,1245,79,1324,5.966767371601208
5929,330200705000154,112,154,133,141,102,64,37,23,706,60,766,7.83289817232376
5930,330200715000001,8,15,7,8,9,1,2,3,48,5,53,9.433962264150944
5931,330200715000002,52,64,54,50,54,26,41,30,300,71,371,19.137466307277627
5932,330200715000003,36,55,45,60,47,54,30,25,297,55,352,15.625
5933,330205605000001,43,54,68,63,59,57,54,56,344,110,454,24.229074889867842
5934,330205605000002,49,76,85,66,84,75,59,73,435,132,567,23.280423280423282
5935,330205605000003,52,70,64,66,85,52,34,41,389,75,464,16.163793103448278
5936,330205605000004,105,121,107,90,91,75,37,19,589,56,645,8.682170542635658
5937,330205605000005,108,111,128,109,90,79,48,45,625,93,718,12.952646239554317
5938,330205605000006,54,79,75,91,62,56,60,44,417,104,521,19.961612284069098
5939,330205605000007,126,131,128,117,113,88,60,47,703,107,810,13.209876543209877
5940,330205605000008,107,141,168,129,178,118,91,91,841,182,1023,17.790811339198434
5941,330205605000009,50,49,74,69,75,79,50,57,396,107,503,21.272365805168985
5942,330205605000010,87,92,111,92,104,88,59,47,574,106,680,15.588235294117647
5943,330205605000011,71,58,93,74,89,78,53,37,463,90,553,16.2748643761302
5944,330205605000012,87,103,90,108,100,69,50,63,557,113,670,16.865671641791046
5945,330205605000013,44,56,56,54,69,48,47,46,327,93,420,22.142857142857142
5946,330205605000014,55,75,82,68,93,79,53,57,452,110,562,19.572953736654803
5947,330205605000015,66,73,89,89,94,54,59,54,465,113,578,19.55017301038062
5948,330205605000016,42,52,64,66,74,49,40,23,347,63,410,15.365853658536585
5949,330205605000017,47,76,53,52,51,36,26,28,315,54,369,14.634146341463415
5950,330205605000018,60,55,75,67,49,70,45,33,376,78,454,17.180616740088105
5951,330205605000019,1,3,4,2,1,4,4,0,15,4,19,21.05263157894737
5952,330205605000020,45,56,51,46,51,50,31,35,299,66,365,18.08219178082192
5953,330205605000021,41,68,42,51,55,54,42,33,311,75,386,19.430051813471504
5954,330205605000022,80,59,76,78,92,68,60,58,453,118,571,20.665499124343256
5955,330205605000023,14,21,23,20,12,18,11,7,108,18,126,14.285714285714286
5956,330205605000024,52,63,44,70,62,48,46,25,339,71,410,17.317073170731707
5957,330205605000025,22,31,14,24,19,27,22,22,137,44,181,24.30939226519337
5958,330205605000026,6,16,18,15,16,16,15,10,87,25,112,22.321428571428573
5959,330205605000027,45,55,65,56,51,50,56,40,322,96,418,22.966507177033492
5960,330205605000028,49,59,79,73,52,58,30,23,370,53,423,12.529550827423169
5961,330205605000029,103,98,100,85,111,63,51,40,560,91,651,13.978494623655914
5962,330210605000001,43,77,70,57,78,74,54,59,399,113,512,22.0703125
5963,330210605000002,84,95,89,90,99,67,71,71,524,142,666,21.32132132132132
5964,330210605000003,47,66,66,69,66,74,56,62,388,118,506,23.320158102766797
5965,330210605000004,82,91,100,86,96,89,63,54,544,117,661,17.700453857791224
5966,330210605000005,129,143,167,146,119,101,72,61,805,133,938,14.17910447761194
5967,330210605000006,45,66,67,55,82,73,59,60,388,119,507,23.471400394477318
5968,330210605000007,116,126,156,134,141,139,76,60,812,136,948,14.345991561181435
5969,330210605000008,172,172,178,160,139,88,62,48,909,110,1019,10.794896957801766
5970,330210605000009,178,158,188,153,148,105,60,49,930,109,1039,10.490856592877767
5971,330210605000010,96,118,107,133,101,93,73,54,648,127,775,16.387096774193548
5972,330210605000011,57,78,83,70,84,50,36,27,422,63,485,12.989690721649485
5973,330210605000012,25,27,47,39,51,29,15,20,218,35,253,13.83399209486166
5974,330210605000013,65,68,99,93,81,68,41,32,474,73,547,13.345521023765997
5975,330210605000014,142,165,199,188,165,92,79,63,951,142,1093,12.991765782250686
5976,330210605000015,105,128,138,140,120,106,62,44,737,106,843,12.574139976275207
5977,330210605000016,83,144,141,130,144,111,68,51,753,119,872,13.646788990825687
5978,330210605000017,144,140,156,179,159,105,64,39,883,103,986,10.446247464503042
5979,330210605000019,44,64,53,50,74,56,19,27,341,46,387,11.886304909560723
5980,330210605000020,39,61,52,56,65,42,33,16,315,49,364,13.461538461538462
5981,330210605000021,26,26,41,31,35,39,26,22,198,48,246,19.51219512195122
5982,330210607000001,44,63,41,53,79,58,52,73,338,125,463,26.997840172786177
5983,330210607000002,30,60,34,52,59,30,38,27,265,65,330,19.696969696969695
5984,330210610000001,10,26,18,22,25,22,20,22,123,42,165,25.454545454545453
5985,330210610000002,27,32,36,36,43,34,40,34,208,74,282,26.24113475177305
5986,330210610000003,12,27,15,34,28,31,30,32,147,62,209,29.66507177033493
5987,330210615000001,72,102,121,105,94,96,73,76,590,149,739,20.16238159675237
5988,330210615000002,24,27,28,30,42,33,25,19,184,44,228,19.29824561403509
5989,330210615000003,22,26,21,34,24,15,18,20,142,38,180,21.11111111111111
5990,330210615000004,48,38,38,31,46,53,26,19,254,45,299,15.050167224080267
5991,330210615000005,84,114,98,115,117,78,56,60,606,116,722,16.066481994459835
5992,330210615000006,53,64,74,63,76,63,52,40,393,92,485,18.969072164948454
5993,330210620000001,40,60,66,52,82,75,55,89,375,144,519,27.745664739884393
5994,330210620000002,94,129,151,109,149,115,72,112,747,184,931,19.763694951664878
5995,330210620000003,66,78,79,66,75,67,39,56,431,95,526,18.06083650190114
5996,330210620000004,19,24,29,26,40,34,21,12,172,33,205,16.097560975609756
5997,330210620000005,27,49,33,47,54,41,36,35,251,71,322,22.049689440993788
5998,330210620000006,10,19,10,18,23,22,15,14,102,29,131,22.137404580152673
5999,330210625000001,85,109,94,113,89,88,68,68,578,136,714,19.047619047619047
6000,330210625000002,73,107,101,106,78,75,62,58,540,120,660,18.181818181818183
6001,330210625000003,23,49,47,29,60,38,23,28,246,51,297,17.171717171717173
6002,330210625000004,48,52,70,51,54,49,39,35,324,74,398,18.592964824120603
6003,330210625000005,51,78,47,82,67,57,35,30,382,65,447,14.5413870246085
6004,330220505000001,23,36,68,29,54,44,31,41,254,72,326,22.085889570552148
6005,330220505000002,9,31,30,28,30,27,27,55,155,82,237,34.59915611814346
6006,330220505000003,13,25,32,16,30,28,27,52,144,79,223,35.426008968609864
6007,330220505000004,15,33,36,30,39,27,31,48,180,79,259,30.501930501930502
6008,330220505000005,49,72,122,91,90,78,68,77,502,145,647,22.41112828438949
6009,330220505000006,18,35,42,41,41,21,25,24,198,49,247,19.838056680161944
6010,330220505000007,74,95,118,91,100,78,44,51,556,95,651,14.592933947772657
6011,330220505000008,46,66,91,65,60,51,39,29,379,68,447,15.212527964205817
6012,330220505000009,78,94,79,92,69,68,42,26,480,68,548,12.408759124087592
6013,330220505000010,55,71,97,83,66,68,54,57,440,111,551,20.14519056261343
6014,330220505000011,104,113,138,146,128,115,72,68,744,140,884,15.83710407239819
6015,330220505000012,110,139,149,143,151,110,60,34,802,94,896,10.491071428571429
6016,330220505000013,66,87,107,73,82,67,48,30,482,78,560,13.928571428571429
6017,330220505000014,67,110,98,92,99,57,36,35,523,71,594,11.952861952861953
6018,330220505000015,66,76,79,98,72,65,46,32,456,78,534,14.606741573033707
6019,330220505000016,30,38,69,63,56,41,28,28,297,56,353,15.864022662889518
6020,330220505000017,41,53,121,56,52,38,33,30,361,63,424,14.858490566037736
6021,330220505000018,44,88,100,86,92,70,44,41,480,85,565,15.044247787610619
6022,330220505000019,80,110,113,103,113,53,56,35,572,91,663,13.72549019607843
6023,330220505000020,48,42,70,55,47,65,45,41,327,86,413,20.82324455205811
6024,330220505000021,63,88,121,95,115,101,65,68,583,133,716,18.575418994413408
6025,330220505000022,64,93,92,97,89,84,53,54,519,107,626,17.0926517571885
6026,330220505000023,78,74,87,71,61,60,50,39,431,89,520,17.115384615384617
6027,330220505000024,74,100,89,82,82,58,41,52,485,93,578,16.089965397923876
6028,330220505000025,63,68,92,67,68,49,37,22,407,59,466,12.660944206008583
6029,330220505000026,77,78,88,88,66,53,33,38,450,71,521,13.62763915547025
6030,330220505000027,45,54,82,61,48,69,43,33,359,76,435,17.471264367816094
6031,330220505000028,76,99,110,101,91,90,92,53,567,145,712,20.365168539325843
6032,330220505000029,77,98,95,83,100,75,35,32,528,67,595,11.260504201680673
6033,330220505000030,53,65,77,71,66,46,46,39,378,85,463,18.3585313174946
6034,330220505000031,75,107,124,97,96,81,41,33,580,74,654,11.314984709480122
6035,330220505000032,93,150,133,129,125,77,43,39,707,82,789,10.392902408111533
6036,330220505000033,89,166,121,156,123,85,47,47,740,94,834,11.270983213429256
6037,330220505000034,75,128,108,120,115,81,57,39,627,96,723,13.278008298755188
6038,330220505000035,73,105,100,106,91,85,51,44,560,95,655,14.50381679389313
6039,330220505000036,36,63,62,58,54,63,41,48,336,89,425,20.941176470588236
6040,330220505000037,61,106,110,116,102,76,74,56,571,130,701,18.54493580599144
6041,330220505000038,79,95,102,112,103,89,75,48,580,123,703,17.496443812233284
6042,330220505000039,88,87,116,130,121,125,102,69,667,171,838,20.405727923627683
6043,330220505000040,57,64,77,61,84,68,39,36,411,75,486,15.432098765432098
6044,330220505000041,123,119,177,136,114,109,53,43,778,96,874,10.983981693363845
6045,330220505000042,119,137,132,163,107,81,37,39,739,76,815,9.325153374233128
6046,330220505000043,71,124,142,133,125,102,67,65,697,132,829,15.922798552472859
6047,330220505000044,87,119,129,103,118,87,58,66,643,124,767,16.166883963494133
6048,330220505000045,67,111,142,96,107,86,43,52,609,95,704,13.494318181818182
6049,330220505000046,101,124,136,129,127,93,54,49,710,103,813,12.669126691266912
6050,330220505000047,101,96,84,88,82,40,36,21,491,57,548,10.401459854014599
6051,330220505000048,86,103,128,105,99,82,42,43,603,85,688,12.354651162790697
6052,330220505000049,76,98,106,97,112,97,67,60,586,127,713,17.812061711079945
6053,330220505000050,87,101,83,96,116,86,67,53,569,120,689,17.41654571843251
6054,330220505000051,74,92,124,106,106,93,81,79,595,160,755,21.192052980132452
6055,330220505000052,69,105,125,107,114,90,57,52,610,109,719,15.159944367176633
6056,330220505000053,86,127,94,110,76,60,47,25,553,72,625,11.52
6057,330220505000054,54,74,75,84,83,63,39,27,433,66,499,13.226452905811623
6058,330220505000055,70,75,69,82,68,56,43,47,420,90,510,17.647058823529413
6059,330220505000056,56,51,54,66,44,33,28,15,304,43,347,12.39193083573487
6060,330220505000057,112,129,180,140,148,92,49,37,801,86,887,9.695603156708005
6061,330220505000058,79,94,91,110,93,49,39,27,516,66,582,11.34020618556701
6062,330220505000059,87,70,87,86,68,48,43,21,446,64,510,12.549019607843137
6063,330220505000060,126,123,146,150,131,92,56,49,768,105,873,12.027491408934708
6064,330220505000061,131,133,138,124,104,91,50,48,721,98,819,11.965811965811966
6065,330220505000062,82,107,111,82,99,55,39,27,536,66,602,10.96345514950166
6066,330220505000063,96,106,103,107,91,82,45,39,585,84,669,12.556053811659194
6067,330220505000064,62,62,71,63,66,52,20,36,376,56,432,12.962962962962964
6068,330220505000065,100,111,103,96,89,58,38,27,557,65,622,10.45016077170418
6069,330220505000066,115,113,108,109,92,66,42,24,603,66,669,9.865470852017937
6070,330220505000067,65,79,85,84,77,56,40,23,446,63,509,12.37721021611002
6071,330220505000068,64,76,73,75,60,47,32,31,395,63,458,13.755458515283843
6072,330220505000069,40,62,52,53,44,39,17,21,290,38,328,11.585365853658537
6073,330220505000070,54,61,77,56,64,53,19,35,365,54,419,12.88782816229117
6074,330220505000071,0,0,2,2,7,15,31,81,26,112,138,81.15942028985508
6075,330220505000072,42,52,64,51,58,43,36,27,310,63,373,16.890080428954423
6076,330220505000073,68,65,74,77,53,46,29,23,383,52,435,11.954022988505747
6077,330220505000074,71,53,77,59,50,49,24,21,359,45,404,11.138613861386139
6078,330220505000075,57,77,81,73,53,50,28,19,391,47,438,10.730593607305936
6079,330220505000076,117,131,186,158,123,72,40,21,787,61,848,7.193396226415095
6080,330220505000077,51,64,88,71,69,62,36,30,405,66,471,14.012738853503185
6081,330220505000078,58,48,90,80,77,76,33,32,429,65,494,13.157894736842104
6082,330220505000079,48,44,70,51,64,50,28,31,327,59,386,15.284974093264248
6083,330220505000080,51,62,91,85,78,57,49,40,424,89,513,17.348927875243664
6084,330220505000081,90,113,117,138,125,76,51,32,659,83,742,11.185983827493262
6085,330220505000082,106,134,173,142,166,129,61,53,850,114,964,11.825726141078839
6086,330220505000083,93,122,165,135,131,101,57,40,747,97,844,11.492890995260664
6087,330220505000084,87,95,100,111,113,62,23,24,568,47,615,7.642276422764228
6088,330220505000085,147,187,193,153,210,115,66,49,1005,115,1120,10.267857142857142
6089,330220505000086,75,90,100,93,80,62,33,34,500,67,567,11.81657848324515
6090,330220505000087,107,146,158,155,126,125,54,41,817,95,912,10.416666666666666
6091,330220505000088,111,142,124,133,120,92,46,49,722,95,817,11.627906976744185
6092,330220505000089,82,90,129,102,73,80,35,33,556,68,624,10.897435897435898
6093,330220505000090,116,131,116,124,121,74,41,53,682,94,776,12.11340206185567
6094,330220505000091,88,82,111,95,89,76,36,24,541,60,601,9.983361064891847
6095,330220505000092,92,85,97,103,82,76,29,43,535,72,607,11.86161449752883
6096,330220505000093,62,66,108,88,78,57,56,32,459,88,547,16.087751371115175
6097,330220505000094,65,76,64,67,81,54,33,31,407,64,471,13.588110403397028
6098,330220505000095,66,100,104,101,108,86,50,51,565,101,666,15.165165165165165
6099,330220505000096,142,174,166,142,138,104,70,39,866,109,975,11.179487179487179
6100,330220505000097,93,110,88,111,115,69,39,35,586,74,660,11.212121212121213
6101,330220505000098,78,81,116,76,64,84,31,24,499,55,554,9.927797833935019
6102,330220505000099,69,83,101,75,84,54,45,43,466,88,554,15.884476534296029
6103,330220505000100,77,83,81,79,95,58,48,36,473,84,557,15.080789946140037
6104,330220505000101,70,104,112,107,89,78,44,26,560,70,630,11.11111111111111
6105,330220505000102,79,89,103,110,81,70,38,29,532,67,599,11.185308848080133
6106,330220505000103,94,135,139,139,133,103,37,45,743,82,825,9.93939393939394
6107,330220505000104,78,99,115,99,86,84,59,44,561,103,664,15.512048192771084
6108,330220505000105,68,94,103,101,106,80,45,43,552,88,640,13.75
6109,330220505000106,63,122,97,100,112,63,51,36,557,87,644,13.509316770186336
6110,330220505000107,89,116,114,118,115,71,57,40,623,97,720,13.472222222222221
6111,330220505000108,118,130,149,116,94,119,72,34,726,106,832,12.740384615384615
6112,330220505000109,63,72,141,148,86,42,36,23,552,59,611,9.656301145662848
6113,330220505000110,8,10,10,9,7,8,7,5,52,12,64,18.75
6114,330220505000111,14,28,17,13,24,19,6,7,115,13,128,10.15625
6115,330220505000112,17,10,13,9,10,5,4,8,64,12,76,15.789473684210526
6116,330220505000113,14,29,23,27,21,17,26,11,131,37,168,22.023809523809526
6117,330220505000114,12,17,13,14,16,11,8,1,83,9,92,9.782608695652174
6118,330220505000115,37,54,46,49,51,46,20,19,283,39,322,12.111801242236025
6119,330220505000116,46,47,59,40,34,45,28,22,271,50,321,15.576323987538942
6120,330220505000117,20,27,22,19,10,9,8,4,107,12,119,10.084033613445378
6121,330220505000118,52,42,36,38,35,45,13,20,248,33,281,11.743772241992882
6122,330220505000119,52,68,62,63,72,45,32,43,362,75,437,17.162471395881006
6123,330220505000120,46,45,48,51,53,35,21,25,278,46,324,14.197530864197532
6124,330220505000121,23,42,29,34,23,27,10,6,178,16,194,8.24742268041237
6125,330220505000122,31,60,53,47,58,32,27,29,281,56,337,16.617210682492583
6126,330220505000123,25,30,27,40,32,32,24,18,186,42,228,18.42105263157895
6127,330220505000124,40,38,23,39,32,29,15,11,201,26,227,11.45374449339207
6128,330220505000125,55,73,126,70,68,41,33,21,433,54,487,11.08829568788501
6129,330220505000126,91,119,152,137,119,86,27,19,704,46,750,6.133333333333334
6130,330220505000127,60,72,82,106,80,36,19,17,436,36,472,7.627118644067797
6131,330220505000128,166,142,158,162,111,90,35,28,829,63,892,7.062780269058296
6132,330220505000129,98,117,137,150,117,108,71,42,727,113,840,13.452380952380953
6133,330220505000130,78,106,120,92,105,87,46,34,588,80,668,11.976047904191617
6134,330220505000131,75,81,91,83,81,53,26,18,464,44,508,8.661417322834646
6135,330220505000132,105,117,101,107,92,44,15,15,566,30,596,5.033557046979865
6136,330220505000133,80,91,124,149,106,87,22,24,637,46,683,6.734992679355783
6137,330220505000134,99,97,103,115,82,53,35,30,549,65,614,10.586319218241043
6138,330220505000135,75,74,46,64,49,47,19,18,355,37,392,9.438775510204081
6139,330220505000136,81,88,120,91,115,83,52,61,578,113,691,16.35311143270622
6140,330220505000137,155,148,133,193,120,83,41,31,832,72,904,7.964601769911504
6141,330220505000138,49,55,62,63,47,31,16,14,307,30,337,8.90207715133531
6142,330220505000139,45,51,73,55,49,41,45,29,314,74,388,19.072164948453608
6143,330220505000140,43,59,80,54,74,43,28,24,353,52,405,12.839506172839506
6144,330220505000141,49,53,68,78,75,47,43,41,370,84,454,18.502202643171806
6145,330220510000001,68,89,120,79,82,77,53,55,515,108,623,17.335473515248797
6146,330220510000002,56,97,85,73,80,67,50,60,458,110,568,19.366197183098592
6147,330220510000003,2,0,3,0,0,2,2,3,7,5,12,41.666666666666664
6148,330220510000004,30,22,38,27,22,31,25,27,170,52,222,23.423423423423422
6149,330220510000005,3,1,2,1,4,1,0,1,12,1,13,7.6923076923076925
6150,330220510000006,23,37,20,25,21,29,24,9,155,33,188,17.5531914893617
6151,330220510000007,4,4,6,4,5,5,4,0,28,4,32,12.5
6152,330220510000008,28,36,18,31,27,23,9,10,163,19,182,10.43956043956044
6153,330220510000009,14,30,21,20,19,20,13,4,124,17,141,12.056737588652481
6154,330220510000010,42,97,92,76,78,76,50,34,461,84,545,15.412844036697248
6155,330220515000001,105,174,126,127,118,114,77,67,764,144,908,15.859030837004406
6156,330220515000002,71,79,66,80,49,45,37,23,390,60,450,13.333333333333334
6157,330220515000003,113,132,121,120,97,74,55,46,657,101,758,13.324538258575197
6158,330220515000004,4,5,3,4,8,5,2,7,29,9,38,23.68421052631579
6159,330220515000005,26,35,29,33,38,30,14,20,191,34,225,15.11111111111111
6160,330220515000006,32,19,27,29,24,17,16,5,148,21,169,12.42603550295858
6161,330220515000007,16,21,23,41,27,17,10,5,145,15,160,9.375
6162,330220515000008,18,29,21,21,20,10,12,9,119,21,140,15.0
6163,330220515000009,64,78,75,75,65,45,45,34,402,79,481,16.424116424116423
6164,330220520000001,30,41,28,38,35,21,16,18,193,34,227,14.977973568281937
6165,330220520000002,3,8,5,6,5,3,5,2,30,7,37,18.91891891891892
6166,330220520000003,26,33,24,33,18,19,19,9,153,28,181,15.469613259668508
6167,330220520000004,6,8,7,19,11,14,10,5,65,15,80,18.75
6168,330220520000005,10,15,20,9,15,15,9,7,84,16,100,16.0
6169,330220520000006,10,11,8,10,12,2,7,4,53,11,64,17.1875
6170,330220520000007,9,14,12,7,17,7,4,3,66,7,73,9.58904109589041
6171,330220525000001,110,142,151,137,135,100,72,72,775,144,919,15.669205658324266
6172,330220525000002,12,26,21,16,20,18,11,10,113,21,134,15.671641791044776
6173,330220525000003,57,97,68,87,75,68,41,41,452,82,534,15.355805243445692
6174,330220525000004,28,42,32,31,46,34,16,23,213,39,252,15.476190476190476
6175,330220525000005,18,27,9,23,27,30,27,8,134,35,169,20.71005917159763
6176,330220525000006,23,42,48,48,50,40,42,22,251,64,315,20.317460317460316
6177,330220525000007,37,52,30,48,51,56,31,17,274,48,322,14.906832298136646
6178,330220530000001,80,86,103,94,88,70,58,43,521,101,622,16.237942122186496
6179,330220530000002,93,115,100,102,88,75,51,41,573,92,665,13.834586466165414
6180,330220530000003,42,90,71,71,67,51,34,22,392,56,448,12.5
6181,330220530000004,27,48,44,45,45,39,17,18,248,35,283,12.36749116607774
6182,330220530000005,54,65,94,66,71,61,34,37,411,71,482,14.730290456431534
6183,330220530000006,33,54,38,49,68,37,22,34,279,56,335,16.71641791044776
6184,330220530000007,27,27,19,30,27,15,12,9,145,21,166,12.650602409638553
6185,330220530000008,17,22,13,31,13,13,15,5,109,20,129,15.503875968992247
6186,330220535000001,33,60,39,42,38,43,30,15,255,45,300,15.0
6187,330220535000002,57,70,81,97,64,52,52,28,421,80,501,15.968063872255488
6188,330220535000003,159,191,190,222,149,101,66,47,1012,113,1125,10.044444444444444
6189,330220535000004,73,79,84,94,57,49,36,23,436,59,495,11.919191919191919
6190,330220535000005,22,41,22,37,28,14,11,17,164,28,192,14.583333333333334
6191,330220535000006,16,15,14,15,17,18,11,9,95,20,115,17.391304347826086
6192,330220535000007,113,135,115,123,96,68,46,49,650,95,745,12.751677852348994
6193,330225405000001,73,102,101,118,114,89,52,58,597,110,707,15.558698727015559
6194,330225405000002,112,112,119,114,113,85,48,42,655,90,745,12.080536912751677
6195,330225405000003,115,104,155,126,86,81,65,48,667,113,780,14.487179487179487
6196,330225405000004,95,87,108,113,99,78,41,21,580,62,642,9.657320872274143
6197,330225405000005,28,22,34,29,31,16,19,15,160,34,194,17.52577319587629
6198,330225405000006,55,74,80,86,65,75,37,38,435,75,510,14.705882352941176
6199,330225405000007,31,19,37,26,22,14,11,7,149,18,167,10.778443113772456
6200,330225405000008,75,116,119,112,100,75,54,44,597,98,695,14.100719424460431
6201,330225405000009,114,155,145,124,94,73,51,40,705,91,796,11.4321608040201
6202,330225405000010,70,87,106,74,65,48,29,29,450,58,508,11.417322834645669
6203,330225405000011,122,136,121,144,90,81,50,26,694,76,770,9.87012987012987
6204,330225405000012,35,46,25,29,25,17,9,10,177,19,196,9.693877551020408
6205,330225405000013,111,122,168,135,109,103,67,45,748,112,860,13.023255813953488
6206,330225405000014,72,100,135,106,89,60,46,25,562,71,633,11.216429699842022
6207,330225405000015,69,103,101,96,70,57,25,22,496,47,543,8.655616942909761
6208,330225405000016,98,139,114,131,102,72,75,37,656,112,768,14.583333333333334
6209,330225405000017,27,33,50,45,47,34,16,8,236,24,260,9.23076923076923
6210,330225405000018,196,196,241,154,133,102,59,27,1022,86,1108,7.76173285198556
6211,330225405000019,95,102,90,75,47,34,19,10,443,29,472,6.1440677966101696
6212,330225405000020,95,139,107,119,146,67,41,24,673,65,738,8.807588075880759
6213,330225405000021,119,139,172,165,168,116,74,47,879,121,1000,12.1
6214,330225405000022,146,169,183,183,185,157,80,39,1023,119,1142,10.42031523642732
6215,330225405000023,121,134,114,165,97,54,53,27,685,80,765,10.457516339869281
6216,330225405000024,9,8,8,14,16,2,2,1,57,3,60,5.0
6217,330225405000025,103,154,138,126,101,62,43,42,684,85,769,11.053315994798439
6218,330225405000026,4,6,9,8,2,4,2,3,33,5,38,13.157894736842104
6219,330225405000027,44,76,88,61,79,59,20,16,407,36,443,8.126410835214447
6220,330225405000028,52,60,63,82,67,48,31,12,372,43,415,10.36144578313253
6221,330225405000029,160,206,164,146,118,79,49,25,873,74,947,7.81414994720169
6222,330225405000030,44,41,31,26,28,20,8,11,190,19,209,9.090909090909092
6223,330225405000031,10,8,8,10,8,5,2,3,49,5,54,9.25925925925926
6224,330225405000032,88,68,84,101,117,101,69,51,559,120,679,17.673048600883654
6225,330225405000033,36,47,63,45,65,46,32,26,302,58,360,16.11111111111111
6226,330225405000034,31,46,44,43,42,20,15,12,226,27,253,10.671936758893281
6227,330225405000035,68,73,68,68,61,32,23,9,370,32,402,7.960199004975125
6228,330225405000036,24,34,27,39,32,35,8,8,191,16,207,7.729468599033816
6229,330225405000037,5,18,12,8,17,17,6,8,77,14,91,15.384615384615385
6230,330225405000038,47,50,59,62,69,51,30,37,338,67,405,16.54320987654321
6231,330225405000039,31,21,32,44,42,33,25,16,203,41,244,16.80327868852459
6232,330225405000041,39,56,55,53,55,28,15,12,286,27,313,8.626198083067093
6233,330225405000042,7,11,9,14,15,12,8,10,68,18,86,20.930232558139537
6234,330225405000043,4,17,10,8,19,15,11,8,73,19,92,20.652173913043477
6235,330225405000044,2,6,3,4,4,2,2,0,21,2,23,8.695652173913043
6236,330225405000045,58,50,45,48,31,21,15,8,253,23,276,8.333333333333334
6237,330225405000046,18,48,30,37,27,21,8,3,181,11,192,5.729166666666667
6238,330225405000047,80,104,99,90,86,76,39,19,535,58,593,9.780775716694773
6239,330225405000048,71,99,87,95,78,36,33,13,466,46,512,8.984375
6240,330225405000049,71,81,66,66,56,45,18,16,385,34,419,8.1145584725537
6241,330225405000050,61,99,68,114,77,63,28,14,482,42,524,8.01526717557252
6242,330225405000051,43,40,33,26,24,19,13,5,185,18,203,8.866995073891626
6243,330225405000052,132,138,102,104,84,66,24,25,626,49,675,7.2592592592592595
6244,330225405000053,124,115,127,104,75,53,33,29,598,62,660,9.393939393939394
6245,330225405000054,59,84,66,93,105,62,46,40,469,86,555,15.495495495495495
6246,330225405000055,96,62,107,73,56,44,23,5,438,28,466,6.008583690987124
6247,330225405000056,126,147,149,109,101,64,30,12,696,42,738,5.691056910569106
6248,330225405000057,89,105,102,84,73,49,23,12,502,35,537,6.517690875232774
6249,330225405000058,75,72,67,88,85,64,32,16,451,48,499,9.619238476953909
6250,330225405000059,47,60,37,39,28,21,7,7,232,14,246,5.691056910569106
6251,330225405000060,4,7,2,7,5,8,4,2,33,6,39,15.384615384615385
6252,330225405000061,63,97,54,78,65,48,28,23,405,51,456,11.18421052631579
6253,330225405000062,17,16,21,14,10,11,11,3,89,14,103,13.592233009708737
6254,330227005010001,48,58,67,64,64,63,27,29,364,56,420,13.333333333333334
6255,330227005010002,106,106,110,101,106,75,41,25,604,66,670,9.850746268656716
6256,330227005010003,94,97,97,99,79,62,35,29,528,64,592,10.81081081081081
6257,330227005010004,41,91,84,85,58,66,29,36,425,65,490,13.26530612244898
6258,330227005010005,11,15,26,14,12,8,6,12,86,18,104,17.307692307692307
6259,330227005010006,58,92,94,68,86,44,34,34,442,68,510,13.333333333333334
6260,330227005010007,13,20,16,10,9,7,3,6,75,9,84,10.714285714285714
6261,330227005010008,98,132,114,140,96,65,49,24,645,73,718,10.167130919220055
6262,330227005010009,6,20,19,20,22,12,15,5,99,20,119,16.80672268907563
6263,330227005010010,136,160,176,154,128,87,66,31,841,97,938,10.341151385927505
6264,330227005010011,93,117,112,113,129,77,28,42,641,70,711,9.845288326300984
6265,330227005010012,172,217,189,169,159,116,64,47,1022,111,1133,9.796999117387466
6266,330227005010013,88,100,93,86,93,64,24,27,524,51,575,8.869565217391305
6267,330227005010014,51,74,43,50,42,34,15,9,294,24,318,7.547169811320755
6268,330227005010015,121,164,147,154,112,59,47,37,757,84,841,9.988109393579073
6269,330227005010016,93,113,101,121,86,38,32,25,552,57,609,9.35960591133005
6270,330227005010017,98,113,102,98,87,55,46,22,553,68,621,10.950080515297907
6271,330227005010018,85,100,88,96,98,59,25,25,526,50,576,8.680555555555555
6272,330227005010019,146,192,204,206,123,87,67,52,958,119,1077,11.049210770659238
6273,330227005010020,104,112,110,139,88,63,39,19,616,58,674,8.6053412462908
6274,330227005010021,90,114,112,135,64,74,46,20,589,66,655,10.076335877862595
6275,330227005010022,93,122,102,103,65,57,24,25,542,49,591,8.29103214890017
6276,330227005010023,119,147,121,132,97,62,38,33,678,71,749,9.479305740987984
6277,330227005010024,98,119,120,113,88,58,39,21,596,60,656,9.146341463414634
6278,330227005010025,65,89,83,62,72,56,28,19,427,47,474,9.915611814345992
6279,330227005010026,63,64,74,66,48,32,18,14,347,32,379,8.443271767810026
6280,330227005010027,147,289,253,196,150,94,45,40,1129,85,1214,7.00164744645799
6281,330227005010028,132,157,127,152,73,70,36,16,711,52,763,6.815203145478375
6282,330227005010029,193,223,214,169,107,95,76,24,1001,100,1101,9.082652134423252
6283,330227005010030,107,127,107,102,95,51,35,30,589,65,654,9.938837920489297
6284,330227005010031,44,59,34,46,38,49,34,26,270,60,330,18.181818181818183
6285,330227005010032,56,86,74,80,69,53,37,23,418,60,478,12.552301255230125
6286,330227005010033,74,92,77,92,58,39,41,15,432,56,488,11.475409836065573
6287,330227005010034,124,151,144,120,107,84,33,33,730,66,796,8.291457286432161
6288,330227005010035,103,111,109,113,89,46,41,26,571,67,638,10.501567398119123
6289,330227005010036,49,73,57,64,45,34,16,13,322,29,351,8.262108262108262
6290,330227005010037,87,118,130,98,98,43,37,23,574,60,634,9.46372239747634
6291,330227005010038,88,95,108,81,75,50,28,17,497,45,542,8.302583025830259
6292,330227005010039,103,141,116,112,84,56,31,11,612,42,654,6.422018348623853
6293,330227005010040,180,225,185,161,171,83,50,39,1005,89,1094,8.135283363802559
6294,330227005010041,1,2,0,3,3,0,1,7,9,8,17,47.05882352941177
6295,330227005010042,29,44,34,49,31,14,12,11,201,23,224,10.267857142857142
6296,330227005010043,137,107,111,86,73,38,23,12,552,35,587,5.9625212947189095
6297,330227005010044,35,37,26,28,21,10,4,6,157,10,167,5.9880239520958085
6298,330227005020001,15,21,23,15,18,9,11,1,101,12,113,10.619469026548673
6299,330227005020002,131,112,113,101,65,38,32,20,560,52,612,8.49673202614379
6300,330227005020003,120,148,86,78,75,39,17,17,546,34,580,5.862068965517241
6301,330227005020004,136,201,139,135,98,58,41,30,767,71,838,8.47255369928401
6302,330227005020005,183,234,146,172,128,85,49,34,948,83,1031,8.050436469447138
6303,330227005020006,86,97,81,100,88,51,27,17,503,44,547,8.043875685557587
6304,330227005020007,74,98,89,59,65,40,30,18,425,48,473,10.14799154334038
6305,330227005020008,135,158,139,109,111,88,35,39,740,74,814,9.090909090909092
6306,330227005020009,130,152,126,143,123,78,58,43,752,101,853,11.840562719812427
6307,330227005020010,110,145,135,140,82,77,64,27,689,91,780,11.666666666666666
6308,330227005020011,128,192,141,144,105,77,33,30,787,63,850,7.411764705882353
6309,330227005020012,134,178,156,189,131,84,28,22,872,50,922,5.422993492407809
6310,330227005020013,94,88,95,90,64,47,24,19,478,43,521,8.253358925143955
6311,330227005020014,116,164,147,151,121,67,34,35,766,69,835,8.263473053892216
6312,330227005020015,227,295,304,281,158,82,69,33,1347,102,1449,7.0393374741200825
6313,330227005020016,80,134,104,123,88,78,40,34,607,74,681,10.866372980910425
6314,330227005020017,126,152,152,102,104,61,37,28,697,65,762,8.530183727034121
6315,330227005020018,128,168,146,115,106,69,32,13,732,45,777,5.7915057915057915
6316,330227005020019,116,127,131,84,61,50,28,18,569,46,615,7.479674796747967
6317,330227005020020,169,195,143,148,91,97,58,38,843,96,939,10.223642172523961
6318,330227005020021,112,141,119,103,86,63,39,39,624,78,702,11.11111111111111
6319,330227005020022,216,240,192,188,159,108,53,28,1103,81,1184,6.841216216216216
6320,330227005020023,150,166,141,133,75,43,23,11,708,34,742,4.5822102425876015
6321,330227005020024,53,85,65,74,58,38,36,19,373,55,428,12.850467289719626
6322,330227005020025,186,196,147,176,91,99,48,32,895,80,975,8.205128205128204
6323,330227005020026,168,147,152,130,95,63,50,31,755,81,836,9.688995215311005
6324,330227005020027,68,98,93,102,61,57,39,13,479,52,531,9.792843691148775
6325,330227005020028,144,183,154,161,110,85,65,30,837,95,932,10.193133047210301
6326,330227005020029,80,95,75,75,81,59,28,25,465,53,518,10.231660231660232
6327,330227005020030,193,260,191,199,144,88,54,35,1075,89,1164,7.646048109965636
6328,330227005020031,69,85,71,66,60,55,36,23,406,59,465,12.688172043010752
6329,330227005020032,124,166,129,117,92,57,26,15,685,41,726,5.647382920110193
6330,330227005020033,196,229,185,151,126,83,44,32,970,76,1046,7.265774378585086
6331,330227005020034,96,113,115,117,93,60,37,32,594,69,663,10.407239819004525
6332,330227005020035,177,184,206,161,115,90,57,33,933,90,1023,8.79765395894428
6333,330227005020036,206,235,210,156,114,90,59,39,1011,98,1109,8.836789900811542
6334,330227005020037,152,176,173,156,107,78,48,46,842,94,936,10.042735042735043
6335,330227005020038,61,82,84,47,54,24,10,8,352,18,370,4.864864864864865
6336,330227005020039,59,57,61,35,35,24,17,3,271,20,291,6.8728522336769755
6337,330227005020040,171,179,191,144,102,67,38,21,854,59,913,6.4622124863088715
6338,330227005020041,60,93,100,92,60,50,44,16,455,60,515,11.650485436893204
6339,330227005020042,106,262,145,131,115,71,22,33,830,55,885,6.214689265536723
6340,330227005020043,128,123,93,111,70,43,31,21,568,52,620,8.387096774193548
6341,330227005020044,164,189,147,147,109,58,40,28,814,68,882,7.709750566893424
6342,330227005020045,93,124,111,91,82,64,31,22,565,53,618,8.576051779935275
6343,330227005020046,61,88,82,82,61,55,27,21,429,48,477,10.062893081761006
6344,330227005020047,117,152,167,141,108,68,38,39,753,77,830,9.27710843373494
6345,330227005020048,110,157,123,104,83,40,25,20,617,45,662,6.7975830815709966
6346,330227005020049,130,171,163,126,111,64,40,25,765,65,830,7.831325301204819
6347,330227005020050,68,101,91,70,72,38,44,25,440,69,509,13.555992141453832
6348,330227005020051,91,89,107,91,74,62,34,22,514,56,570,9.824561403508772
6349,330227005020052,132,147,110,120,77,42,24,12,628,36,664,5.421686746987952
6350,330227005020053,89,129,101,77,77,48,33,17,521,50,571,8.756567425569177
6351,330227005020054,18,25,15,14,13,7,11,4,92,15,107,14.018691588785046
6352,330227005020055,58,77,62,55,61,40,30,18,353,48,401,11.970074812967582
6353,330227005020056,89,102,98,85,74,40,23,15,488,38,526,7.224334600760456
6354,330227005020057,67,84,84,60,56,36,28,9,387,37,424,8.726415094339623
6355,330227005020058,111,93,136,88,65,52,24,18,545,42,587,7.155025553662692
6356,330227005020059,60,76,91,64,55,41,29,17,387,46,433,10.623556581986143
6357,330227005020060,109,102,96,85,72,51,26,11,515,37,552,6.702898550724638
6358,330227005020061,67,76,46,45,45,31,23,15,310,38,348,10.919540229885058
6359,330227005020062,127,151,106,108,80,69,37,16,641,53,694,7.636887608069165
6360,330227005020063,120,169,115,126,85,54,32,14,669,46,715,6.433566433566433
6361,330227005020064,58,69,50,57,40,34,20,8,308,28,336,8.333333333333334
6362,330227005020065,124,145,144,106,103,52,27,21,674,48,722,6.648199445983379
6363,330227005020066,98,102,108,131,59,72,32,30,570,62,632,9.810126582278482
6364,330227005020067,103,142,120,106,88,48,49,32,607,81,688,11.773255813953488
6365,330227005020068,87,110,114,78,83,58,29,24,530,53,583,9.090909090909092
6366,330227005020069,226,235,245,191,126,101,60,43,1124,103,1227,8.394458027709861
6367,330227005020070,94,118,102,100,78,54,23,13,546,36,582,6.185567010309279
6368,330227005020071,116,146,147,142,127,74,31,25,752,56,808,6.930693069306931
6369,330227005020072,45,48,41,40,42,28,25,9,244,34,278,12.23021582733813
6370,330227005020073,84,102,132,98,76,54,29,11,546,40,586,6.825938566552901
6371,330227005020074,205,335,644,299,147,91,57,33,1721,90,1811,4.969630038652678
6372,330227005020075,143,167,141,141,91,52,40,28,735,68,803,8.468244084682441
6373,330227005020076,83,96,113,81,64,48,18,13,485,31,516,6.007751937984496
6374,330227005020077,91,143,82,71,69,27,28,22,483,50,533,9.380863039399625
6375,330227005020078,72,79,66,66,36,30,19,15,349,34,383,8.877284595300262
6376,330227005020079,77,78,66,46,59,46,30,15,372,45,417,10.79136690647482
6377,330227005020080,99,114,113,79,60,40,23,17,505,40,545,7.339449541284404
6378,330227005020081,159,259,1008,387,145,78,32,15,2036,47,2083,2.256361017762842
6379,330227005020082,166,170,123,104,79,42,20,12,684,32,716,4.4692737430167595
6380,330227005020083,105,149,87,100,66,33,10,9,540,19,559,3.3989266547406083
6381,330227005030001,70,76,59,39,57,30,24,24,331,48,379,12.664907651715039
6382,330227005030002,186,234,200,161,121,104,46,48,1006,94,1100,8.545454545454545
6383,330227005030003,97,136,96,101,73,48,35,31,551,66,617,10.696920583468396
6384,330227005030004,54,89,67,82,59,40,15,16,391,31,422,7.345971563981043
6385,330227005030005,73,95,64,67,59,46,22,35,404,57,461,12.364425162689805
6386,330227005030006,111,130,79,82,72,60,24,25,534,49,583,8.404802744425385
6387,330227005030007,133,129,125,86,103,64,40,40,640,80,720,11.11111111111111
6388,330227005030008,127,122,93,92,99,53,47,24,586,71,657,10.80669710806697
6389,330227005030009,106,111,96,62,81,66,32,29,522,61,583,10.4631217838765
6390,330227005040001,31,39,26,26,23,16,11,13,161,24,185,12.972972972972974
6391,330227005040002,11,13,14,10,12,9,5,0,69,5,74,6.756756756756757
6392,330227005040003,160,206,204,194,138,79,45,32,981,77,1058,7.277882797731569
6393,330227005040004,16,21,16,12,12,9,6,5,86,11,97,11.34020618556701
6394,330227005040005,92,142,98,99,109,65,48,42,605,90,695,12.949640287769784
6395,330227005040006,98,111,76,91,50,46,17,22,472,39,511,7.632093933463796
6396,330227005040007,33,46,45,34,18,18,12,5,194,17,211,8.056872037914692
6397,330227005040008,162,173,127,126,93,61,31,26,742,57,799,7.133917396745932
6398,330227005040009,23,30,19,21,22,17,12,8,132,20,152,13.157894736842104
6399,330227005040010,127,124,90,93,69,64,29,23,567,52,619,8.40064620355412
6400,330227005050001,45,73,65,64,54,37,15,16,338,31,369,8.401084010840108
6401,330227005050002,30,25,41,17,18,11,9,1,142,10,152,6.578947368421052
6402,330227005050003,38,56,44,48,23,18,18,13,227,31,258,12.015503875968992
6403,330230405000001,138,170,154,141,132,108,57,66,843,123,966,12.732919254658386
6404,330230405000002,113,165,128,113,89,69,40,23,677,63,740,8.513513513513514
6405,330230405000003,70,72,69,72,61,54,46,57,398,103,501,20.55888223552894
6406,330230405000004,63,142,98,89,123,83,53,82,598,135,733,18.417462482946792
6407,330230405000005,62,46,49,49,56,40,42,30,302,72,374,19.25133689839572
6408,330230405000006,51,61,70,68,49,50,41,30,349,71,420,16.904761904761905
6409,330230405000007,110,128,127,100,105,64,44,29,634,73,707,10.325318246110326
6410,330230405000008,87,134,91,109,110,84,44,34,615,78,693,11.255411255411255
6411,330230405000009,35,32,34,28,35,28,22,20,192,42,234,17.94871794871795
6412,330230405000010,12,19,21,19,25,18,15,10,114,25,139,17.985611510791365
6413,330230405000011,95,119,108,96,113,73,66,36,604,102,706,14.44759206798867
6414,330230405000012,31,39,46,34,30,25,31,12,205,43,248,17.338709677419356
6415,330230405000013,55,75,58,53,59,63,36,26,363,62,425,14.588235294117647
6416,330230405000014,13,7,18,16,16,11,9,8,81,17,98,17.346938775510203
6417,330230405000015,78,98,82,74,59,61,26,25,452,51,503,10.139165009940358
6418,330240305010001,69,75,114,91,85,77,48,29,511,77,588,13.095238095238095
6419,330240305010002,65,113,122,99,121,55,36,13,575,49,624,7.852564102564102
6420,330240305010003,66,80,83,48,72,42,18,22,391,40,431,9.280742459396752
6421,330240305010004,36,40,57,42,31,24,10,8,230,18,248,7.258064516129032
6422,330240305010005,61,74,96,61,68,39,26,13,399,39,438,8.904109589041095
6423,330240305010006,99,131,179,156,103,62,56,28,730,84,814,10.31941031941032
6424,330240305010007,64,57,73,69,51,44,19,7,358,26,384,6.770833333333333
6425,330240305010008,38,49,63,40,47,26,13,9,263,22,285,7.719298245614035
6426,330240305010009,56,75,84,66,39,19,26,6,339,32,371,8.625336927223719
6427,330240305010010,114,108,169,102,71,70,21,10,634,31,665,4.661654135338346
6428,330240305010011,74,90,121,94,61,42,24,9,482,33,515,6.407766990291262
6429,330240305010012,53,60,72,57,38,29,7,0,309,7,316,2.2151898734177213
6430,330240305010013,58,73,89,62,40,32,11,5,354,16,370,4.324324324324325
6431,330240305010014,92,95,97,95,63,31,18,16,473,34,507,6.70611439842209
6432,330240305010015,47,82,66,48,52,19,7,3,314,10,324,3.0864197530864197
6433,330240305010016,93,83,94,79,71,35,14,4,455,18,473,3.8054968287526427
6434,330240305010017,59,66,104,59,71,32,11,6,391,17,408,4.166666666666667
6435,330240305010018,147,158,176,132,127,77,35,12,817,47,864,5.439814814814815
6436,330240305010019,127,136,147,182,130,68,36,23,790,59,849,6.9493521790341575
6437,330240305010020,106,134,113,112,95,41,26,6,601,32,633,5.055292259083728
6438,330240305010021,149,146,173,149,104,43,20,10,764,30,794,3.7783375314861463
6439,330240305010022,160,145,143,127,88,43,12,6,706,18,724,2.4861878453038675
6440,330240305010023,42,51,61,44,47,18,15,7,263,22,285,7.719298245614035
6441,330240305010024,106,91,112,79,95,56,27,11,539,38,577,6.58578856152513
6442,330240305010025,118,157,155,129,97,48,26,26,704,52,756,6.878306878306878
6443,330240305010026,72,67,91,65,56,39,20,11,390,31,421,7.363420427553444
6444,330240305010027,109,120,140,116,79,79,30,15,643,45,688,6.540697674418604
6445,330240305010028,109,100,135,128,81,38,11,4,591,15,606,2.4752475247524752
6446,330240305010029,87,73,113,78,65,49,31,21,465,52,517,10.058027079303676
6447,330240305010030,94,88,112,99,76,54,28,20,523,48,571,8.40630472854641
6448,330240305010031,32,39,60,48,45,21,10,11,245,21,266,7.894736842105263
6449,330240305010032,81,97,119,98,70,38,28,12,503,40,543,7.366482504604051
6450,330240305010033,67,61,69,68,46,31,15,8,342,23,365,6.301369863013699
6451,330240305010034,64,57,85,44,39,40,12,2,329,14,343,4.081632653061225
6452,330240305010035,123,128,104,107,74,44,13,5,580,18,598,3.0100334448160537
6453,330240305010036,79,89,82,66,53,49,13,14,418,27,445,6.067415730337078
6454,330240305010037,52,63,59,58,40,27,13,8,299,21,320,6.5625
6455,330240305010038,54,61,65,50,42,18,13,7,290,20,310,6.451612903225806
6456,330240305010039,88,78,83,82,71,38,23,11,440,34,474,7.172995780590718
6457,330240305010040,40,42,95,36,35,25,13,2,273,15,288,5.208333333333333
6458,330240305010041,89,97,107,85,85,59,22,14,522,36,558,6.451612903225806
6459,330240305010042,110,118,120,136,65,35,15,7,584,22,606,3.6303630363036303
6460,330240305010043,60,85,72,76,63,32,22,16,388,38,426,8.92018779342723
6461,330240305010044,45,36,69,46,32,33,15,7,261,22,283,7.773851590106007
6462,330240305010045,165,144,173,129,94,44,21,15,749,36,785,4.585987261146497
6463,330240305010046,165,167,158,138,122,44,14,8,794,22,816,2.696078431372549
6464,330240305010047,179,163,206,160,109,52,18,8,869,26,895,2.905027932960894
6465,330240305010048,153,135,175,131,109,64,23,13,767,36,803,4.483188044831881
6466,330240305010049,254,214,237,176,124,50,22,9,1055,31,1086,2.85451197053407
6467,330240305010050,38,39,37,32,31,21,7,0,198,7,205,3.4146341463414633
6468,330240305010051,149,138,125,120,85,45,18,7,662,25,687,3.63901018922853
6469,330240305010052,104,149,112,136,86,46,19,6,633,25,658,3.7993920972644375
6470,330240305010053,57,53,63,46,36,21,11,15,276,26,302,8.609271523178808
6471,330240305010054,87,114,94,92,62,48,20,8,497,28,525,5.333333333333333
6472,330240305010055,106,111,113,94,68,42,18,13,534,31,565,5.486725663716814
6473,330240305010056,156,170,149,146,110,63,27,13,794,40,834,4.796163069544365
6474,330240305010057,164,126,137,137,102,46,24,7,712,31,743,4.172274562584119
6475,330240305010058,105,126,127,107,93,38,24,6,596,30,626,4.792332268370607
6476,330240305010059,122,110,123,103,64,33,12,4,555,16,571,2.8021015761821366
6477,330240305010060,69,63,95,80,43,27,9,4,377,13,390,3.3333333333333335
6478,330240305020001,65,99,134,102,66,91,41,13,557,54,611,8.8379705400982
6479,330240305020002,107,121,165,110,121,91,29,26,715,55,770,7.142857142857143
6480,330240305020003,73,66,117,80,54,57,34,19,447,53,500,10.6
6481,330240305020004,55,87,116,86,69,81,43,18,494,61,555,10.99099099099099
6482,330240305020005,52,88,105,113,99,65,20,22,522,42,564,7.446808510638298
6483,330240305020006,68,89,117,83,85,65,28,20,507,48,555,8.64864864864865
6484,330240305020007,90,89,179,113,86,86,37,21,643,58,701,8.273894436519258
6485,330240305020008,39,52,83,92,78,53,18,13,397,31,428,7.242990654205608
6486,330240305020009,78,74,126,90,78,57,29,21,503,50,553,9.041591320072333
6487,330240305020010,47,67,109,72,65,67,28,20,427,48,475,10.105263157894736
6488,330240305020011,57,68,86,82,52,52,25,17,397,42,439,9.567198177676538
6489,330240305020012,153,142,212,236,136,69,22,13,948,35,983,3.560528992878942
6490,330240305020013,164,168,261,206,143,94,31,14,1036,45,1081,4.162812210915819
6491,330240305020014,78,94,121,111,71,31,15,7,506,22,528,4.166666666666667
6492,330240305020015,145,130,332,205,149,82,29,25,1043,54,1097,4.922515952597995
6493,330240305020016,150,151,204,205,139,55,29,13,904,42,946,4.439746300211416
6494,330240305020017,94,94,90,100,82,45,30,11,505,41,546,7.509157509157509
6495,330240305020018,262,261,311,311,214,149,55,34,1508,89,1597,5.572949279899812
6496,330240305020019,96,93,115,138,84,35,11,14,561,25,586,4.266211604095563
6497,330240305020020,10,4,3,7,5,3,2,1,32,3,35,8.571428571428571
6498,330240305020021,228,305,254,242,164,92,40,19,1285,59,1344,4.3898809523809526
6499,330240305020022,174,222,213,205,124,81,37,19,1019,56,1075,5.209302325581396
6500,330240305020023,149,177,146,161,135,66,26,16,834,42,876,4.794520547945205
6501,330240305020024,72,55,85,76,52,33,11,2,373,13,386,3.3678756476683938
6502,330240305020025,73,89,127,100,90,76,48,20,555,68,623,10.914927768860354
6503,330240305020026,73,103,82,70,73,42,26,6,443,32,475,6.7368421052631575
6504,330240305020027,34,52,86,62,51,39,15,6,324,21,345,6.086956521739131
6505,330240305020028,74,80,96,104,69,75,33,29,498,62,560,11.071428571428571
6506,330240305020029,103,77,165,111,79,97,30,28,632,58,690,8.405797101449275
6507,330240305020030,69,86,107,75,59,58,27,21,454,48,502,9.56175298804781
6508,330240305020031,49,58,118,88,38,48,21,9,399,30,429,6.993006993006993
6509,330240305020032,68,99,142,103,73,67,53,25,552,78,630,12.380952380952381
6510,330240305020033,91,121,175,125,113,97,47,23,722,70,792,8.83838383838384
6511,330240305020034,56,75,125,91,65,68,28,18,480,46,526,8.745247148288973
6512,330240305020035,85,101,157,136,90,90,54,33,659,87,746,11.662198391420912
6513,330240305020036,119,125,223,139,120,91,56,28,817,84,901,9.32297447280799
6514,330240305020037,89,124,334,204,79,36,24,12,866,36,902,3.991130820399113
6515,330240305020038,11,11,23,11,13,7,1,2,76,3,79,3.7974683544303796
6516,330240305020039,108,94,129,137,103,73,30,16,644,46,690,6.666666666666667
6517,330240305020040,137,129,212,182,113,75,25,21,848,46,894,5.145413870246085
6518,330240305020041,122,117,126,167,109,71,18,13,712,31,743,4.172274562584119
6519,330240305020042,139,137,106,146,78,49,10,3,655,13,668,1.9461077844311376
6520,330240305020043,103,137,74,101,75,25,19,6,515,25,540,4.62962962962963
6521,330240305020044,239,236,265,239,141,81,24,21,1201,45,1246,3.611556982343499
6522,330240305020045,214,246,275,189,175,70,32,26,1169,58,1227,4.726976365118174
6523,330240305020047,90,98,75,101,72,45,26,12,481,38,519,7.321772639691715
6524,330240305020048,29,50,26,30,41,20,16,14,196,30,226,13.274336283185841
6525,330240305020049,93,109,182,154,111,75,29,13,724,42,766,5.483028720626632
6526,330240305020050,103,111,284,188,133,53,19,25,872,44,916,4.8034934497816595
6527,330240305020051,177,143,155,163,110,56,22,11,804,33,837,3.942652329749104
6528,330240305020052,186,202,175,204,106,62,18,11,935,29,964,3.008298755186722
6529,330240305020053,172,147,260,225,103,65,36,14,972,50,1022,4.892367906066537
6530,330240305020054,65,54,74,82,41,15,13,3,331,16,347,4.610951008645533
6531,330240305020055,125,151,147,118,97,49,22,15,687,37,724,5.110497237569061
6532,330240305030001,1,5,1,4,4,5,1,1,20,2,22,9.090909090909092
6533,330240305030002,123,100,138,138,83,54,20,9,636,29,665,4.360902255639098
6534,330240305030003,103,86,134,107,61,44,20,11,535,31,566,5.477031802120141
6535,330240305030004,90,119,164,129,96,48,27,19,646,46,692,6.6473988439306355
6536,330240305030005,107,111,157,145,82,50,22,10,652,32,684,4.678362573099415
6537,330240305030006,138,177,238,148,131,102,41,37,934,78,1012,7.707509881422925
6538,330240305030007,151,181,183,152,97,66,33,18,830,51,881,5.788876276958002
6539,330240305030008,16,15,6,2,7,4,2,1,50,3,53,5.660377358490566
6540,330240305030009,180,190,242,214,122,73,30,12,1021,42,1063,3.951081843838194
6541,330240305030010,191,204,212,183,135,77,22,12,1002,34,1036,3.281853281853282
6542,330240305030011,133,122,187,145,81,53,24,13,721,37,758,4.881266490765172
6543,330240305030012,120,108,126,141,92,70,45,11,657,56,713,7.854137447405329
6544,330240305030013,153,164,149,135,107,54,31,7,762,38,800,4.75
6545,330240305030014,245,229,224,199,131,72,22,13,1100,35,1135,3.0837004405286343
6546,330240305030015,128,96,156,119,67,56,18,13,622,31,653,4.747320061255743
6547,330240305030016,153,154,172,145,92,60,32,8,776,40,816,4.901960784313726
6548,330240305030017,121,118,156,120,101,50,25,12,666,37,703,5.2631578947368425
6549,330240305030018,63,83,90,60,71,21,12,7,388,19,407,4.6683046683046685
6550,330240305030019,6,7,7,4,3,0,0,1,27,1,28,3.5714285714285716
6551,330240305030020,117,131,93,83,97,81,32,28,602,60,662,9.06344410876133
6552,330240305030021,14,15,10,12,15,12,3,2,78,5,83,6.024096385542169
6553,330240305030023,169,148,160,154,86,54,18,6,771,24,795,3.018867924528302
6554,330240305030024,156,154,156,151,84,56,18,17,757,35,792,4.41919191919192
6555,330240305030025,189,202,219,176,126,59,30,12,971,42,1013,4.146100691016782
6556,330240305030026,105,65,113,86,49,31,11,4,449,15,464,3.2327586206896552
6557,330240305030027,183,184,217,206,120,71,32,14,981,46,1027,4.47906523855891
6558,330240305030028,129,87,133,95,78,38,16,6,560,22,582,3.7800687285223367
6559,330240305030029,159,143,165,136,85,53,14,8,741,22,763,2.8833551769331587
6560,330240305030030,296,255,354,264,170,88,36,15,1427,51,1478,3.4506089309878214
6561,330240305030031,133,108,178,108,61,36,16,8,624,24,648,3.7037037037037037
6562,330240305030032,200,189,273,216,123,69,20,12,1070,32,1102,2.9038112522686026
6563,330240305030033,156,107,160,127,82,35,16,8,667,24,691,3.4732272069464543
6564,330240305030034,100,74,123,102,42,26,9,5,467,14,481,2.9106029106029108
6565,330240305030035,118,117,169,118,92,53,12,5,667,17,684,2.4853801169590644
6566,330240305040001,74,67,76,85,59,28,24,10,389,34,423,8.037825059101655
6567,330240305040002,85,95,143,121,110,99,19,16,653,35,688,5.087209302325581
6568,330240305040003,70,78,120,112,105,81,28,18,566,46,612,7.516339869281046
6569,330240305040004,86,92,146,157,122,91,36,28,694,64,758,8.443271767810026
6570,330240305040005,279,213,534,373,201,137,64,34,1737,98,1835,5.340599455040872
6571,330240305040006,77,82,134,108,95,47,13,13,543,26,569,4.569420035149385
6572,330240305040007,23,30,46,41,35,11,4,4,186,8,194,4.123711340206185
6573,330240305040008,71,69,99,97,83,38,19,14,457,33,490,6.73469387755102
6574,330240305040009,60,54,91,67,46,37,20,8,355,28,383,7.310704960835509
6575,330240305040010,67,53,125,109,60,52,23,14,466,37,503,7.355864811133201
6576,330240305040011,73,60,111,143,78,50,31,9,515,40,555,7.207207207207207
6577,330240305040012,71,80,85,76,64,52,13,8,428,21,449,4.67706013363029
6578,330240305040013,139,173,154,193,173,99,27,19,931,46,977,4.7082906857727735
6579,330240305040014,73,63,144,131,61,37,12,4,509,16,525,3.0476190476190474
6580,330240305040015,72,114,108,104,139,110,37,11,647,48,695,6.906474820143885
6581,330240305040016,53,63,95,87,55,62,23,18,415,41,456,8.991228070175438
6582,330240305040017,27,37,66,48,33,37,20,12,248,32,280,11.428571428571429
6583,330240305040018,35,46,76,65,64,85,34,22,371,56,427,13.114754098360656
6584,330240305040019,75,83,92,124,139,94,37,15,607,52,659,7.890743550834598
6585,330240305040020,59,70,65,97,81,64,26,18,436,44,480,9.166666666666666
6586,330240305040021,82,118,110,104,121,74,23,8,609,31,640,4.84375
6587,330240305040022,116,121,196,160,87,50,41,21,730,62,792,7.828282828282828
6588,330240305040023,69,84,111,103,64,39,16,10,470,26,496,5.241935483870968
6589,330240305040024,100,60,62,105,86,45,16,8,458,24,482,4.979253112033195
6590,330240305040025,87,102,117,100,100,84,30,24,590,54,644,8.385093167701863
6591,330240305040026,50,54,80,68,59,67,30,20,378,50,428,11.682242990654206
6592,330240305040027,30,30,50,41,45,42,27,12,238,39,277,14.07942238267148
6595,330240305040030,96,89,123,139,82,43,6,9,572,15,587,2.5553662691652472
6596,330240305040031,78,75,113,122,81,34,26,9,503,35,538,6.5055762081784385
6597,330240305040032,81,63,110,126,62,19,11,7,461,18,479,3.757828810020877
6598,330240305040033,105,107,126,133,111,74,16,18,656,34,690,4.927536231884058
6599,330240305040034,48,21,35,48,17,14,4,1,183,5,188,2.6595744680851063
6600,330240305040035,59,59,144,102,74,14,12,6,452,18,470,3.8297872340425534
6601,330240305040036,76,78,227,143,76,30,8,3,630,11,641,1.71606864274571
6602,330240305040037,98,94,113,151,111,69,35,18,636,53,689,7.6923076923076925
6603,330240305050001,21,30,27,29,38,28,19,22,173,41,214,19.1588785046729
6604,330240305050002,35,54,98,66,63,85,43,55,401,98,499,19.639278557114228
6605,330240305050003,40,46,66,47,50,49,28,19,298,47,345,13.623188405797102
6606,330240305050004,10,30,25,23,30,34,28,15,152,43,195,22.05128205128205
6607,330240305050005,9,14,17,14,14,14,19,22,82,41,123,33.333333333333336
6608,330240305050006,34,48,59,42,52,46,50,52,281,102,383,26.631853785900784
6609,330240305050007,27,47,76,58,46,51,36,37,305,73,378,19.312169312169313
6610,330240305050008,37,37,65,49,52,36,33,38,276,71,347,20.461095100864554
6611,330240305050009,25,36,38,36,34,37,24,29,206,53,259,20.463320463320464
6612,330240305050010,13,22,20,25,34,17,12,21,131,33,164,20.121951219512194
6613,330240305050011,10,26,26,19,25,28,17,24,134,41,175,23.428571428571427
6614,330240305050012,24,32,57,36,40,38,32,28,227,60,287,20.905923344947734
6615,330240305050013,9,7,18,18,9,21,15,13,82,28,110,25.454545454545453
6616,330240305050014,8,6,7,14,13,4,2,3,52,5,57,8.771929824561404
6617,330240305050015,20,31,42,39,26,28,21,8,186,29,215,13.488372093023257
6618,330240305050016,33,41,52,40,50,40,41,46,256,87,343,25.364431486880466
6620,330240305050018,26,38,42,41,38,43,38,35,228,73,301,24.25249169435216
6621,330240305050019,46,49,69,69,48,55,40,38,336,78,414,18.840579710144926
6623,330240305050021,32,44,41,50,36,27,7,11,230,18,248,7.258064516129032
6624,330240305050022,18,20,31,28,26,15,10,6,138,16,154,10.38961038961039
6625,330240305050023,41,55,96,64,69,50,45,39,375,84,459,18.30065359477124
6626,330240305050024,12,14,20,16,32,22,15,33,116,48,164,29.26829268292683
6627,330240305050025,49,53,78,70,54,50,45,35,354,80,434,18.433179723502302
6628,330240305050026,35,38,65,65,41,37,20,17,281,37,318,11.635220125786164
6629,330240305050027,83,95,92,84,80,59,39,23,493,62,555,11.17117117117117
6630,330240305050028,47,58,115,77,60,69,37,26,426,63,489,12.883435582822086
6631,330240305050029,23,47,58,41,27,22,20,15,218,35,253,13.83399209486166
6632,330240305050030,64,112,101,99,85,77,39,31,538,70,608,11.513157894736842
6633,330240305050031,71,92,141,79,97,90,25,21,570,46,616,7.467532467532467
6634,330240305050032,22,45,41,46,53,23,30,14,230,44,274,16.05839416058394
6635,330240305050033,59,52,73,67,44,46,47,35,341,82,423,19.38534278959811
6636,330240305050034,13,26,35,63,29,25,30,15,191,45,236,19.06779661016949
6637,330240305050035,77,88,109,116,73,59,28,19,522,47,569,8.260105448154658
6638,330240305050036,46,50,63,64,57,42,23,19,322,42,364,11.538461538461538
6639,330240305050037,28,19,42,22,35,21,14,16,167,30,197,15.228426395939087
6640,330240305050038,43,66,78,53,50,50,34,27,340,61,401,15.211970074812967
6641,330240305050039,39,60,84,75,60,40,21,21,358,42,400,10.5
6642,330240305050040,68,101,101,107,71,88,35,16,536,51,587,8.68824531516184
6643,330240305050041,48,68,97,82,65,50,28,13,410,41,451,9.090909090909092
6644,330240305050042,31,49,54,55,58,54,20,11,301,31,332,9.337349397590362
6645,330240305050043,71,72,117,76,74,64,22,13,474,35,509,6.8762278978389
6646,330240305050044,102,106,193,151,108,60,24,14,720,38,758,5.013192612137203
6647,330240305050045,168,169,213,141,130,110,48,32,931,80,1011,7.9129574678536105
6648,330240305050046,82,98,119,118,85,65,40,27,567,67,634,10.56782334384858
6649,330240305050047,33,43,58,37,39,50,32,19,260,51,311,16.39871382636656
6650,330240305050048,83,133,178,113,148,140,57,56,795,113,908,12.444933920704846
6651,330240305050049,80,83,81,72,53,52,26,19,421,45,466,9.656652360515022
6652,330240305050050,35,55,89,79,71,73,29,15,402,44,446,9.865470852017937
6653,330240305050051,69,85,100,90,71,52,26,13,467,39,506,7.707509881422925
6654,330240305050052,40,57,82,76,53,49,20,28,357,48,405,11.851851851851851
6655,330240305050053,33,53,60,62,47,35,18,15,290,33,323,10.21671826625387
6656,330240305050054,47,48,93,47,62,45,10,8,342,18,360,5.0
6657,330240305050055,51,83,142,80,108,74,27,19,538,46,584,7.876712328767123
6658,330240305050056,88,133,135,125,153,111,24,22,745,46,791,5.815423514538558
6659,330240305050057,104,113,114,140,127,75,15,13,673,28,701,3.9942938659058487
6660,330240305050058,158,125,187,191,123,54,14,12,838,26,864,3.009259259259259
6661,330240305050059,99,113,168,140,90,70,35,16,680,51,731,6.976744186046512
6662,330240305050060,64,94,110,89,101,61,21,7,519,28,547,5.118829981718465
6663,330240305050061,103,98,158,143,110,92,24,11,704,35,739,4.7361299052774015
6664,330240305050062,106,99,124,90,62,43,27,15,524,42,566,7.420494699646643
6665,330240305050063,157,162,206,144,148,78,25,22,895,47,942,4.989384288747346
6666,330240305050064,47,63,74,49,64,32,13,10,329,23,352,6.534090909090909
6667,330240305050065,107,148,135,127,97,70,31,24,684,55,739,7.442489851150203
6668,330240305050066,118,115,154,101,105,56,18,15,649,33,682,4.838709677419355
6669,330240305050067,177,208,224,220,147,109,42,34,1085,76,1161,6.546080964685616
6670,330240305050068,58,120,123,98,116,78,38,11,593,49,642,7.632398753894081
6671,330240305050069,82,116,117,91,129,90,28,16,625,44,669,6.576980568011958
6672,330240305050070,99,108,152,139,105,88,37,20,691,57,748,7.620320855614973
6674,330240305050072,92,110,140,129,111,76,32,24,658,56,714,7.8431372549019605
6675,330240305050073,87,95,150,102,75,82,47,23,591,70,661,10.590015128593041
6676,330240305050074,49,66,78,64,77,65,38,28,399,66,465,14.193548387096774
6677,330240305050075,49,63,107,80,53,67,31,19,419,50,469,10.660980810234541
6678,330240305050076,54,76,103,71,66,51,35,31,421,66,487,13.552361396303901
6679,330240305050077,33,54,65,56,51,40,27,24,299,51,350,14.571428571428571
6680,330240305050078,97,123,162,110,85,64,32,22,641,54,695,7.76978417266187
6681,330240305050079,64,109,115,76,92,52,31,21,508,52,560,9.285714285714286
6682,330240305050080,99,99,94,97,82,58,28,16,529,44,573,7.678883071553229
6683,330240305050081,127,124,159,131,96,70,34,24,707,58,765,7.5816993464052285
6684,330240305050082,164,184,165,145,98,76,36,25,832,61,893,6.83090705487122
6685,330240305050083,186,157,186,133,138,92,18,10,892,28,920,3.0434782608695654
6686,330240305050084,97,120,107,77,88,37,29,9,526,38,564,6.73758865248227
6687,330240305050085,118,130,116,93,71,43,23,5,571,28,599,4.674457429048414
6688,330240305050086,82,84,115,71,53,29,19,8,434,27,461,5.856832971800434
6689,330240305050087,94,132,113,110,58,54,19,10,561,29,590,4.915254237288136
6690,330240305050088,182,171,164,138,91,57,24,9,803,33,836,3.9473684210526314
6691,330240305050089,96,160,156,127,112,40,22,9,691,31,722,4.293628808864266
6692,330240305050090,128,160,177,159,84,51,23,11,759,34,793,4.287515762925599
6693,330240305050091,109,95,121,78,60,44,17,10,507,27,534,5.056179775280899
6694,330240305050092,83,109,84,79,55,31,14,11,441,25,466,5.364806866952789
6695,330240305050093,185,192,195,181,135,72,51,16,960,67,1027,6.523855890944499
6696,330240305050094,15,25,22,22,23,29,18,20,136,38,174,21.839080459770116
6697,330240305050095,9,16,19,16,14,11,12,18,85,30,115,26.08695652173913
6698,330240305050096,43,55,57,62,63,45,33,26,325,59,384,15.364583333333334
6699,330240305050097,17,23,33,25,23,23,19,7,144,26,170,15.294117647058824
6700,330240305050098,3,7,16,13,9,7,5,8,55,13,68,19.11764705882353
6701,330240305050099,7,18,34,28,31,28,16,28,146,44,190,23.157894736842106
6702,330240305050100,17,24,26,24,28,25,18,27,144,45,189,23.80952380952381
6703,330240305050101,25,43,52,37,38,54,21,25,249,46,295,15.59322033898305
6704,330240305050102,22,30,36,32,24,22,24,31,166,55,221,24.8868778280543
6705,330240305050103,54,56,84,62,65,61,46,28,382,74,456,16.228070175438596
6706,330240305050104,22,35,51,43,45,34,18,31,230,49,279,17.56272401433692
6707,330240305050105,36,47,56,34,41,19,14,16,233,30,263,11.406844106463879
6708,330240305050106,39,52,74,53,58,68,49,49,344,98,442,22.171945701357465
6709,330240305050107,20,20,51,41,18,37,39,49,187,88,275,32.0
6710,330240305050108,14,26,44,35,27,33,18,24,179,42,221,19.004524886877828
6711,330240305050109,18,17,34,32,31,22,21,29,154,50,204,24.50980392156863
6712,330240305050110,14,17,31,22,24,24,10,16,132,26,158,16.455696202531644
6713,330240305050111,36,32,55,52,54,50,24,30,279,54,333,16.216216216216218
6714,330240305050112,26,33,35,34,44,27,15,14,199,29,228,12.719298245614034
6715,330240305050113,23,33,60,50,45,55,34,42,266,76,342,22.22222222222222
6716,330240305050114,86,98,136,117,110,88,46,26,635,72,707,10.183875530410184
6717,330240305050115,51,61,76,75,79,42,42,27,384,69,453,15.2317880794702
6718,330240305050116,85,63,80,126,81,46,35,24,481,59,540,10.925925925925926
6719,330240305050117,38,51,52,45,48,39,25,31,273,56,329,17.02127659574468
6720,330240305050118,16,26,30,19,45,32,18,27,168,45,213,21.12676056338028
6721,330240305050119,33,34,47,60,35,34,10,15,243,25,268,9.328358208955224
6722,330240305050120,34,41,62,52,28,35,30,17,252,47,299,15.719063545150501
6723,330240305050121,65,93,112,84,97,45,26,25,496,51,547,9.323583180987203
6724,330240305050122,36,45,62,45,59,29,14,19,276,33,309,10.679611650485437
6725,330240305050123,47,43,68,51,48,50,39,33,307,72,379,18.99736147757256
6726,330240305050124,54,54,114,70,76,85,48,45,453,93,546,17.032967032967033
6727,330240305050125,45,72,67,58,76,64,31,45,382,76,458,16.593886462882097
6728,330240305050126,50,78,107,84,75,59,45,26,453,71,524,13.549618320610687
6729,330240305050127,85,88,100,102,72,48,46,25,495,71,566,12.54416961130742
6730,330240305050128,60,61,77,77,53,44,21,12,372,33,405,8.148148148148149
6731,330240305050129,36,46,55,46,41,38,26,22,262,48,310,15.483870967741936
6732,330240305050130,23,45,48,36,41,30,34,21,223,55,278,19.784172661870503
6733,330240305050131,50,55,99,70,62,45,17,29,381,46,427,10.772833723653395
6734,330240305050132,50,50,81,57,60,49,18,27,347,45,392,11.479591836734693
6735,330240305050133,51,66,88,71,69,44,26,15,389,41,430,9.534883720930232
6736,330240305050134,56,78,92,74,69,58,17,12,427,29,456,6.359649122807017
6737,330240305050135,58,66,86,61,66,53,22,10,390,32,422,7.5829383886255926
6738,330240305050136,84,94,130,108,82,70,23,12,568,35,603,5.804311774461028
6739,330240305050137,38,55,104,62,42,62,21,12,363,33,396,8.333333333333334
6740,330240305050138,49,74,118,79,87,31,13,11,438,24,462,5.194805194805195
6741,330240305050139,94,96,158,118,101,78,35,23,645,58,703,8.250355618776672
6742,330240305050140,46,85,115,69,87,90,26,25,492,51,543,9.392265193370166
6743,330240305050141,43,53,106,69,56,73,36,33,400,69,469,14.712153518123667
6744,330240305050142,22,41,63,52,44,66,28,10,288,38,326,11.656441717791411
6745,330240305050143,75,75,70,73,58,34,23,12,385,35,420,8.333333333333334
6746,330240305050144,65,84,130,85,81,64,19,27,509,46,555,8.288288288288289
6747,330240305050145,62,51,86,74,47,44,14,11,364,25,389,6.426735218508997
6748,330240305050146,62,70,97,73,69,57,16,6,428,22,450,4.888888888888889
6749,330240305050147,54,66,103,82,65,59,27,12,429,39,468,8.333333333333334
6750,330240305050148,121,105,143,183,123,62,29,10,737,39,776,5.025773195876289
6751,330240305050149,90,73,129,96,95,47,17,11,530,28,558,5.017921146953405
6752,330240305050150,321,338,393,324,181,111,31,12,1668,43,1711,2.5131502045587375
6753,330240305050151,30,65,99,69,74,41,15,3,378,18,396,4.545454545454546
6754,330240305050152,81,66,153,128,100,57,32,13,585,45,630,7.142857142857143
6755,330240305050153,88,147,123,109,93,63,31,21,623,52,675,7.703703703703703
6757,330240305050155,88,112,157,116,83,63,30,16,619,46,665,6.917293233082707
6758,330240305050156,78,105,170,126,123,85,31,28,687,59,746,7.908847184986596
6759,330240305050157,65,89,81,91,67,56,36,27,449,63,512,12.3046875
6760,330240305050158,85,126,136,93,104,44,28,26,588,54,642,8.411214953271028
6761,330240305050159,63,98,92,90,66,53,27,12,462,39,501,7.7844311377245505
6762,330240305050160,59,51,91,56,55,32,20,9,344,29,373,7.774798927613941
6763,330240305050161,71,91,88,84,71,50,20,17,455,37,492,7.520325203252033
6764,330240305050162,91,111,108,93,75,41,35,12,519,47,566,8.303886925795053
6765,330240305050163,90,118,163,123,94,57,25,15,645,40,685,5.839416058394161
6766,330240305050164,60,58,67,40,30,16,13,1,271,14,285,4.912280701754386
6767,330240305050165,77,63,83,51,44,22,8,1,340,9,349,2.5787965616045847
6768,330240305050166,107,119,134,95,80,45,17,11,580,28,608,4.605263157894737
6769,330240305050167,186,154,176,157,78,56,22,10,807,32,839,3.8140643623361146
6770,330240305050168,101,102,82,71,57,33,10,7,446,17,463,3.67170626349892
6771,330240305050169,79,91,79,65,61,33,10,4,408,14,422,3.3175355450236967
6772,330240305050170,81,61,106,115,71,28,17,9,462,26,488,5.327868852459017
6773,330240305060001,179,179,165,144,99,76,37,30,842,67,909,7.370737073707371
6774,330240305060002,7,13,2,8,4,2,0,2,36,2,38,5.2631578947368425
6775,330240305060003,2,8,9,4,2,5,1,0,30,1,31,3.225806451612903
6776,330240305060004,11,12,10,9,17,4,0,1,63,1,64,1.5625
6777,330240305060005,196,131,214,302,123,55,24,8,1021,32,1053,3.038936372269706
6778,330240315000001,16,24,20,27,20,16,9,14,123,23,146,15.753424657534246
6779,330240315000002,19,21,19,24,29,21,9,13,133,22,155,14.193548387096774
6780,330240315000003,31,33,25,35,21,28,20,15,173,35,208,16.826923076923077
6781,330240315000004,39,57,44,52,55,40,28,19,287,47,334,14.071856287425149
6782,330240315000005,33,49,31,39,51,41,36,21,244,57,301,18.93687707641196
6783,330240315000006,20,32,17,19,28,31,17,11,147,28,175,16.0
6784,330240325000001,165,201,213,168,136,77,38,35,960,73,1033,7.066795740561472
6785,330240325000002,131,158,172,137,139,88,37,39,825,76,901,8.435072142064373
6786,330240325000003,140,177,161,149,119,77,46,46,823,92,915,10.05464480874317
6787,330240325000004,99,117,98,109,94,41,38,30,558,68,626,10.86261980830671
6788,330240325000005,51,45,39,44,44,30,15,15,253,30,283,10.60070671378092
6791,330240327000001,49,59,72,71,62,55,35,50,368,85,453,18.763796909492275
6792,330240327000002,75,98,105,92,78,66,37,29,514,66,580,11.379310344827585
6793,330240327000003,30,40,30,29,28,30,13,10,187,23,210,10.952380952380953
6794,330240327000004,21,26,14,25,16,23,8,14,125,22,147,14.965986394557824
6795,330240330000001,65,101,98,80,87,79,38,46,510,84,594,14.141414141414142
6796,330240330000002,44,68,62,49,68,37,29,31,328,60,388,15.463917525773196
6797,330240330000003,5,14,14,17,11,14,11,9,75,20,95,21.05263157894737
6798,330240330000004,40,56,48,51,50,30,30,31,275,61,336,18.154761904761905
6799,330240330000005,82,103,110,102,88,62,31,44,547,75,622,12.057877813504824
6800,330240330000006,49,75,68,87,50,43,32,25,372,57,429,13.286713286713287
6801,330240330000007,13,14,14,9,12,13,10,5,75,15,90,16.666666666666668
6802,330240330000008,28,15,18,21,25,21,9,2,128,11,139,7.913669064748201
6803,330240330000009,12,8,16,15,16,17,10,10,84,20,104,19.23076923076923
6804,330240340000001,77,75,80,86,82,50,38,30,450,68,518,13.127413127413128
6805,330240340000002,35,42,23,29,35,21,14,9,185,23,208,11.057692307692308
6806,330240340000003,28,20,21,27,11,15,6,9,122,15,137,10.94890510948905
6807,330240340000004,9,20,18,25,13,21,9,10,106,19,125,15.2
6808,330240340000005,3,5,5,4,7,12,3,3,36,6,42,14.285714285714286
6809,330240340000006,23,40,28,26,37,24,23,24,178,47,225,20.88888888888889
6810,330240340000007,31,42,36,49,47,38,25,25,243,50,293,17.064846416382252
6811,330245205000001,85,110,108,84,88,59,46,32,534,78,612,12.745098039215685
6812,330245205000002,176,162,180,170,141,117,87,69,946,156,1102,14.156079854809438
6813,330245205000003,164,168,167,140,130,81,90,34,850,124,974,12.731006160164272
6814,330245205000004,156,156,152,139,116,86,66,39,805,105,910,11.538461538461538
6815,330245205000005,111,133,102,102,88,56,40,44,592,84,676,12.42603550295858
6816,330245205000006,102,104,124,118,104,101,83,72,653,155,808,19.183168316831683
6817,330245205000007,25,19,39,26,15,36,17,10,160,27,187,14.438502673796792
6818,330250205000001,36,57,43,45,34,44,18,16,259,34,293,11.604095563139932
6819,330250205000002,72,78,91,86,76,69,42,26,472,68,540,12.592592592592593
6820,330250205000003,117,119,144,114,139,88,67,45,721,112,833,13.445378151260504
6821,330250205000004,60,54,61,58,50,34,25,22,317,47,364,12.912087912087912
6822,330250205000005,184,222,203,168,159,130,59,37,1066,96,1162,8.261617900172118
6823,330250205000006,56,66,49,61,46,29,13,8,307,21,328,6.402439024390244
6824,330250205000007,82,117,94,80,81,48,41,10,502,51,553,9.22242314647378
6825,330250205000008,46,55,66,47,56,40,23,41,310,64,374,17.112299465240643
6826,330250205000009,94,140,112,117,109,86,47,34,658,81,739,10.960757780784844
6827,330250205000010,128,156,160,135,117,112,48,34,808,82,890,9.213483146067416
6828,330250205000011,106,141,128,139,153,103,71,47,770,118,888,13.288288288288289
6829,330250205000012,86,92,109,66,106,86,50,24,545,74,619,11.954765751211632
6830,330250205000013,20,37,34,24,25,26,5,11,166,16,182,8.791208791208792
6831,330250205000014,35,59,40,26,35,14,10,1,209,11,220,5.0
6832,330250205000015,40,71,63,75,51,65,41,36,365,77,442,17.420814479638008
6833,330250205000016,176,232,215,209,207,166,114,76,1205,190,1395,13.620071684587813
6834,330250205000017,113,166,188,151,140,120,59,66,878,125,1003,12.46261216350947
6835,330250205000018,37,38,51,38,60,50,28,27,274,55,329,16.717325227963524
6836,330250205000019,80,97,130,113,117,108,96,90,645,186,831,22.382671480144403
6837,330250205000020,137,162,168,168,152,123,83,43,910,126,1036,12.162162162162161
6838,330250205000021,91,122,137,113,153,103,73,68,719,141,860,16.3953488372093
6839,330250205000022,64,90,88,72,91,69,62,43,474,105,579,18.134715025906736
6840,330250205000023,134,187,179,148,147,89,46,32,884,78,962,8.108108108108109
6841,330250205000024,172,221,175,142,118,88,36,31,916,67,983,6.8158697863682605
6842,330250205000025,40,60,37,37,33,24,5,11,231,16,247,6.477732793522267
6843,330250205000026,62,74,66,53,56,27,12,8,338,20,358,5.58659217877095
6844,330250205000027,75,75,83,53,44,39,25,19,369,44,413,10.653753026634382
6845,330250205000028,158,199,142,152,141,90,67,27,882,94,976,9.631147540983607
6846,330250205000029,43,68,60,49,52,39,16,20,311,36,347,10.37463976945245
6847,330250205000030,168,231,198,181,129,106,77,38,1013,115,1128,10.195035460992909
6848,330250205000031,137,184,135,143,102,92,51,42,793,93,886,10.496613995485328
6850,330250205000033,65,70,87,120,85,46,19,21,473,40,513,7.797270955165692
6851,330250205000034,252,266,231,213,174,138,63,45,1274,108,1382,7.814761215629522
6852,330250205000035,74,83,80,89,49,66,29,16,441,45,486,9.25925925925926
6853,330250205000036,24,49,40,50,25,33,17,16,221,33,254,12.992125984251969
6854,330250205000037,234,304,301,206,206,117,66,40,1368,106,1474,7.191316146540027
6855,330250205000038,202,213,185,180,153,96,54,41,1029,95,1124,8.451957295373665
6856,330250205000039,88,145,151,119,123,109,62,39,735,101,836,12.08133971291866
6857,330250205000040,165,185,187,161,141,121,73,49,960,122,1082,11.275415896487985
6858,330250205000041,57,82,52,39,44,14,12,15,288,27,315,8.571428571428571
6859,330250205000042,146,212,190,170,143,100,58,38,961,96,1057,9.082308420056764
6860,330250205000043,0,0,0,0,0,0,5,36,0,41,41,100.0
6862,330250205000045,19,21,13,18,10,15,10,7,96,17,113,15.044247787610619
6863,330250205000046,179,226,170,148,147,119,65,56,989,121,1110,10.9009009009009
6864,330250205000047,49,80,44,52,56,33,37,26,314,63,377,16.71087533156499
6865,330250205000048,110,114,94,96,79,47,30,25,540,55,595,9.243697478991596
6866,330250205000049,183,251,224,212,192,147,110,62,1209,172,1381,12.454742939898624
6867,330250205000050,90,96,87,80,84,43,36,27,480,63,543,11.602209944751381
6868,330250205000051,137,141,120,106,83,79,35,36,666,71,737,9.633649932157395
6869,330250205000052,148,179,162,167,113,112,46,43,881,89,970,9.175257731958762
6870,330250205000053,105,106,119,89,73,62,27,30,554,57,611,9.328968903436989
6871,330250205000054,102,162,105,135,110,73,37,34,687,71,758,9.366754617414248
6872,330250205000055,20,42,29,20,24,17,5,4,152,9,161,5.590062111801243
6873,330250205000056,165,184,159,98,95,57,36,38,758,74,832,8.89423076923077
6874,330250205000057,89,109,61,68,53,25,25,17,405,42,447,9.395973154362416
6875,330250205000058,297,361,297,276,226,115,99,61,1572,160,1732,9.237875288683602
6876,330250205000059,0,0,2,15,4,2,0,0,23,0,23,0.0
6877,330250205000060,0,0,1,1,0,0,0,0,2,0,2,0.0
6878,330250205000061,124,160,155,146,122,80,61,31,787,92,879,10.466439135381115
6879,330250205000062,82,61,85,71,61,50,24,13,410,37,447,8.277404921700224
6880,330250205000063,13,27,29,12,14,12,8,3,107,11,118,9.322033898305085
6881,330250205000064,93,168,167,149,121,91,53,31,789,84,873,9.621993127147766
6882,330250205000065,111,102,119,107,83,74,27,27,596,54,650,8.307692307692308
6883,330250205000066,214,234,270,226,189,151,101,65,1284,166,1450,11.448275862068966
6884,330250205000067,35,54,26,34,28,21,20,20,198,40,238,16.80672268907563
6885,330250205000068,28,69,46,39,32,17,15,16,231,31,262,11.83206106870229
6886,330250205000069,6,16,5,11,10,8,5,5,56,10,66,15.151515151515152
6887,330250205000070,13,20,14,13,18,10,7,5,88,12,100,12.0
6888,330250205000072,25,25,22,13,14,10,6,4,109,10,119,8.403361344537815
6889,330250205000074,77,94,122,96,94,70,53,42,553,95,648,14.660493827160494
6890,330250205000075,59,67,72,60,60,40,30,24,358,54,412,13.106796116504855
6891,330250205000076,103,118,112,83,85,51,30,17,552,47,599,7.846410684474123
6892,330250205000077,132,172,121,108,108,51,43,14,692,57,749,7.610146862483311
6893,330250205000078,119,158,184,121,141,121,66,52,844,118,962,12.266112266112266
6894,330250205000079,146,202,186,140,179,115,61,40,968,101,1069,9.448082319925163
6895,330250205000080,90,116,105,97,106,91,57,48,605,105,710,14.788732394366198
6896,330250205000081,47,70,79,65,54,47,24,25,362,49,411,11.922141119221411
6897,330250205000082,14,18,5,18,13,6,4,1,74,5,79,6.329113924050633
6898,330250205000083,116,108,117,92,74,63,24,19,570,43,613,7.014681892332789
6899,330250205000084,86,98,69,71,61,57,38,24,442,62,504,12.301587301587302
6900,330250205000085,30,25,22,31,21,18,17,7,147,24,171,14.035087719298245
6901,330250205000086,116,163,150,143,126,86,62,50,784,112,896,12.5
6902,330250205000087,84,93,86,84,79,49,17,7,475,24,499,4.809619238476954
6903,330250205000088,276,226,210,202,158,130,69,69,1202,138,1340,10.298507462686567
6904,330250205000089,99,99,114,80,90,72,30,17,554,47,601,7.820299500831947
6905,330250205000090,107,111,90,83,71,62,15,23,524,38,562,6.761565836298932
6906,330250205000091,99,142,93,104,55,35,37,19,528,56,584,9.58904109589041
6907,330250215000001,52,79,51,51,63,69,58,36,365,94,459,20.47930283224401
6908,330250215000002,71,115,111,76,93,120,55,43,586,98,684,14.32748538011696
6909,330250215000003,225,224,171,165,145,139,134,90,1069,224,1293,17.324052590873936
6910,330250215000004,152,135,150,115,116,81,73,49,749,122,871,14.006888633754306
6911,330250215000005,101,107,104,69,71,65,52,32,517,84,601,13.976705490848586
6912,330250215000006,137,145,108,128,116,98,86,65,732,151,883,17.10079275198188
6913,330250215000007,113,134,112,131,84,112,72,60,686,132,818,16.13691931540342
6914,330250215000008,111,130,79,97,62,75,53,43,554,96,650,14.76923076923077
6915,330250215000009,145,130,117,124,106,96,58,51,718,109,827,13.180169286577993
6916,330250215000010,161,182,128,146,133,118,86,66,868,152,1020,14.901960784313726
6917,330250215000011,160,179,134,161,157,121,77,65,912,142,1054,13.472485768500949
6918,330250215000012,151,173,123,138,91,103,60,48,779,108,887,12.17587373167982
6919,330250215000013,42,57,33,35,46,33,32,15,246,47,293,16.040955631399317
6920,330250215000014,26,28,21,29,16,12,11,9,132,20,152,13.157894736842104
6921,330250215000015,47,43,51,39,42,38,27,14,260,41,301,13.621262458471762
6922,330250215000016,59,75,65,36,53,60,34,31,348,65,413,15.738498789346247
6923,330250215000017,102,136,109,108,82,94,62,49,631,111,742,14.959568733153638
6924,330250215000018,117,127,113,134,106,103,85,89,700,174,874,19.908466819221967
6925,330250215000019,86,125,216,141,197,124,62,31,889,93,982,9.470468431771893
6926,330250215000020,179,301,246,220,230,111,95,85,1287,180,1467,12.269938650306749
6927,330250215000021,89,109,211,144,153,140,89,48,846,137,983,13.936927772126145
6928,330250215000022,163,227,178,221,146,174,146,89,1109,235,1344,17.485119047619047
6929,330250215000023,34,56,59,43,38,46,33,26,276,59,335,17.611940298507463
6930,330250215000024,30,29,35,25,28,27,21,26,174,47,221,21.266968325791854
6931,330250215000025,113,126,98,92,102,89,74,37,620,111,731,15.184678522571819
6932,330250215000026,181,224,144,155,136,127,60,42,967,102,1069,9.541627689429374
6933,330250215000027,64,76,89,66,73,53,31,27,421,58,479,12.108559498956158
6934,330250215000028,80,80,80,74,80,70,52,39,464,91,555,16.396396396396398
6935,330250215000029,80,95,80,94,77,63,60,50,489,110,599,18.363939899833056
6936,330250215000030,106,127,119,123,106,107,89,68,688,157,845,18.579881656804734
6937,330250215000031,35,39,46,39,56,51,48,29,266,77,343,22.448979591836736
6938,330250215000032,55,86,46,63,37,50,34,30,337,64,401,15.960099750623442
6939,330250215000033,20,29,15,15,8,18,9,5,105,14,119,11.764705882352942
6940,330250215000034,14,17,15,8,13,6,3,5,73,8,81,9.876543209876543
6941,330250215000035,25,38,25,24,20,24,12,17,156,29,185,15.675675675675675
6942,330250215000036,84,94,56,65,51,42,31,26,392,57,449,12.694877505567929
6943,330250215000037,84,99,75,57,61,55,51,21,431,72,503,14.314115308151093
6944,330250215000038,31,45,36,47,31,33,17,15,223,32,255,12.549019607843137
6945,330250215000039,57,61,54,56,51,49,22,14,328,36,364,9.89010989010989
6946,330250220000001,107,159,126,183,140,63,45,26,778,71,849,8.362779740871614
6947,330250220000002,99,102,107,109,73,66,40,20,556,60,616,9.74025974025974
6948,330250220000003,106,144,128,139,101,98,58,25,716,83,799,10.387984981226532
6949,330250220000004,72,62,70,80,58,45,21,20,387,41,428,9.57943925233645
6950,330250220000005,168,195,142,140,105,69,44,23,819,67,886,7.562076749435666
6951,330250220000006,183,243,186,214,168,111,61,60,1105,121,1226,9.869494290375204
6952,330250220000007,142,191,124,157,157,75,60,33,846,93,939,9.904153354632587
6953,330250220000008,69,85,83,79,72,51,30,27,439,57,496,11.491935483870968
6954,330250220000009,61,83,66,59,77,57,30,30,403,60,463,12.958963282937365
6955,330250220000010,19,31,33,24,35,15,13,9,157,22,179,12.29050279329609
6956,330250220000011,46,89,75,72,62,63,39,25,407,64,471,13.588110403397028
6957,330250220000012,158,213,188,177,141,116,64,53,993,117,1110,10.54054054054054
6958,330250220000013,99,110,127,81,107,59,45,38,583,83,666,12.462462462462462
6959,330250220000014,19,27,28,28,23,20,12,19,145,31,176,17.613636363636363
6960,330250220000015,69,73,77,49,56,38,22,11,362,33,395,8.354430379746836
6961,330250220000016,103,120,106,67,77,61,28,17,534,45,579,7.772020725388601
6962,330250220000017,31,21,31,28,17,18,11,3,146,14,160,8.75
6963,330250220000018,127,143,154,124,97,85,42,40,730,82,812,10.098522167487685
6964,330250220000019,106,125,96,111,88,56,46,26,582,72,654,11.009174311926605
6965,330250220000020,105,147,134,151,118,83,55,36,738,91,829,10.97708082026538
6966,330250220000021,94,122,86,114,87,69,56,27,572,83,655,12.67175572519084
6967,330250220000022,61,110,87,78,99,66,56,34,501,90,591,15.228426395939087
6968,330250220000023,62,105,109,76,112,112,59,60,576,119,695,17.12230215827338
6969,330250220000024,138,176,143,121,149,93,49,41,820,90,910,9.89010989010989
6970,330250220000025,126,169,150,117,112,74,45,38,748,83,831,9.987966305655837
6971,330250220000026,108,129,117,93,84,45,37,22,576,59,635,9.291338582677165
6972,330250220000027,82,104,79,104,54,60,29,21,483,50,533,9.380863039399625
6973,330250220000028,133,178,153,153,147,136,73,73,900,146,1046,13.957934990439771
6974,330250220000029,32,75,81,56,62,63,33,30,369,63,432,14.583333333333334
6975,330250220000030,95,145,123,139,118,101,72,42,721,114,835,13.652694610778443
6976,330250220000031,77,128,100,121,95,81,55,34,602,89,691,12.879884225759769
6977,330250220000032,96,174,126,116,155,101,58,41,768,99,867,11.418685121107266
6978,330250220000033,303,307,267,290,251,174,106,84,1592,190,1782,10.662177328843995
6979,330250220000034,106,151,129,99,127,77,31,13,689,44,733,6.002728512960436
6980,330250220000035,112,178,151,137,172,115,103,105,865,208,1073,19.384902143522833
6981,330250220000036,56,75,70,54,73,36,20,27,364,47,411,11.435523114355231
6982,330250220000037,118,165,135,107,99,85,32,21,709,53,762,6.955380577427822
6983,330250220000038,187,285,208,205,217,111,75,68,1213,143,1356,10.545722713864306
6984,330250220000039,113,126,111,99,122,57,31,21,628,52,680,7.647058823529412
6985,330250220000040,87,163,124,115,130,81,57,39,700,96,796,12.06030150753769
6986,330250220000041,74,85,99,73,77,71,43,37,479,80,559,14.311270125223613
6987,330250220000042,64,83,89,87,83,55,38,31,461,69,530,13.018867924528301
6988,330250220000043,125,160,205,172,169,115,91,47,946,138,1084,12.730627306273062
6989,330250220000044,181,254,218,196,165,119,62,37,1133,99,1232,8.035714285714286
6990,330250220000045,100,141,105,106,104,75,47,40,631,87,718,12.116991643454039
6991,330250220000046,103,134,115,100,95,66,51,32,613,83,696,11.925287356321839
6992,330250220000047,185,240,176,190,133,106,53,38,1030,91,1121,8.117752007136485
6993,330250220000048,105,132,106,105,59,72,36,20,579,56,635,8.818897637795276
6994,330250220000049,107,136,124,104,79,70,43,27,620,70,690,10.144927536231885
6995,330250220000050,96,109,102,102,81,55,51,32,545,83,628,13.21656050955414
6996,330250220000051,74,88,80,91,84,69,42,37,486,79,565,13.982300884955752
6997,330250220000052,109,103,112,101,84,48,46,29,557,75,632,11.867088607594937
6998,330250220000053,110,165,123,154,118,76,57,19,746,76,822,9.245742092457421
6999,330250220000054,141,207,125,160,115,75,69,30,823,99,922,10.737527114967461
7000,330250220000055,83,89,108,94,59,71,43,16,504,59,563,10.479573712255773
7001,330250220000056,74,85,91,93,68,59,48,12,470,60,530,11.320754716981131
7002,330250220000057,80,89,111,80,96,61,40,35,517,75,592,12.66891891891892
7003,330250220000058,88,97,96,89,91,42,44,32,503,76,579,13.12607944732297
7004,330250220000059,249,282,213,225,159,111,65,34,1239,99,1338,7.3991031390134525
7005,330250220000060,144,199,167,157,122,89,46,43,878,89,967,9.20372285418821
7006,330250220000061,104,147,126,119,92,56,42,29,644,71,715,9.93006993006993
7007,330250220000062,39,70,55,34,37,40,18,12,275,30,305,9.836065573770492
7008,330250220000063,160,210,179,155,179,111,46,36,994,82,1076,7.620817843866171
7009,330250220000064,124,171,120,133,135,88,51,35,771,86,857,10.035005834305718
7010,330250220000065,84,82,96,87,59,40,27,15,448,42,490,8.571428571428571
7011,330250220000066,84,115,103,83,67,42,17,15,494,32,526,6.083650190114068
7012,330250220000067,147,144,123,103,92,66,21,15,675,36,711,5.063291139240507
7013,330250220000068,128,146,114,99,82,70,41,27,639,68,707,9.618104667609618
7014,330250220000069,213,247,199,192,148,126,59,32,1125,91,1216,7.483552631578948
7015,330250220000070,178,211,157,174,122,93,45,27,935,72,1007,7.149950347567031
7016,330250220000071,141,200,142,157,132,92,56,49,864,105,969,10.8359133126935
7017,330250220000072,82,132,83,98,73,48,28,21,516,49,565,8.672566371681416
7018,330250220000073,88,110,105,110,81,72,40,22,566,62,628,9.872611464968152
7019,330250220000074,66,111,105,83,95,79,37,31,539,68,607,11.202635914332784
7020,330250220000075,180,225,178,184,160,109,48,31,1036,79,1115,7.085201793721973
7021,330250220000076,191,225,176,220,158,110,109,41,1080,150,1230,12.195121951219512
7022,330250220000077,98,157,70,89,63,46,23,30,523,53,576,9.20138888888889
7023,330250220000078,142,180,129,136,112,69,42,34,768,76,844,9.004739336492891
7024,330250220000079,116,180,126,125,101,59,44,18,707,62,769,8.062418725617686
7025,330250220000080,168,190,147,136,116,91,39,38,848,77,925,8.324324324324325
7026,330250220000081,133,163,145,131,108,70,56,31,750,87,837,10.394265232974911
7027,330250220000082,189,225,180,156,135,77,46,39,962,85,1047,8.118433619866284
7028,330250220000083,138,186,156,111,99,91,52,34,781,86,867,9.91926182237601
7029,330250220000084,208,217,215,184,147,98,51,27,1069,78,1147,6.800348735832607
7030,330250220000085,245,268,200,171,109,106,46,36,1099,82,1181,6.943268416596105
7031,330250220000086,137,166,146,131,98,57,39,16,735,55,790,6.962025316455696
7032,330250220000087,212,255,163,147,118,90,43,30,985,73,1058,6.8998109640831755
7033,330250220000088,32,50,38,25,26,26,26,10,197,36,233,15.450643776824034
7034,330250220000089,169,211,175,181,79,85,31,43,900,74,974,7.597535934291581
7035,330250220000090,308,322,246,190,140,143,57,50,1349,107,1456,7.3489010989010985
7036,330250220000091,111,147,94,99,67,41,34,19,559,53,612,8.660130718954248
7037,330250220000092,277,293,267,201,164,78,54,41,1280,95,1375,6.909090909090909
7038,330250220000093,129,161,130,120,102,90,49,36,732,85,817,10.40391676866585
7039,330250220000094,104,113,85,106,72,49,40,40,529,80,609,13.136288998357964
7040,330250220000095,102,120,74,81,59,54,28,15,490,43,533,8.067542213883677
7041,330250220000096,98,106,103,78,76,46,23,14,507,37,544,6.801470588235294
7042,330250220000097,84,136,118,112,100,102,69,35,652,104,756,13.756613756613756
7043,330250220000098,90,119,82,99,111,61,28,35,562,63,625,10.08
7044,330250220000099,83,120,116,134,90,94,71,30,637,101,738,13.685636856368564
7045,330250220000100,187,194,173,148,146,89,51,43,937,94,1031,9.117361784675072
7046,330250220000101,142,196,162,147,127,97,34,24,871,58,929,6.243272335844995
7047,330250220000102,156,154,168,141,123,124,47,32,866,79,945,8.359788359788359
7048,330250220000103,91,145,91,111,85,62,40,19,585,59,644,9.161490683229813
7049,330250220000104,109,142,115,86,99,88,35,31,639,66,705,9.361702127659575
7050,330250220000105,132,173,132,141,117,60,35,30,755,65,820,7.926829268292683
7051,330250220000106,157,207,132,145,113,76,42,25,830,67,897,7.469342251950947
7052,330250220000107,121,154,134,111,97,57,39,22,674,61,735,8.299319727891156
7053,330250220000108,141,193,134,160,127,76,50,34,831,84,915,9.180327868852459
7054,330250220000109,181,155,185,137,112,94,43,32,864,75,939,7.987220447284345
7055,330250220000110,159,190,138,152,124,92,38,34,855,72,927,7.766990291262136
7056,330250220000111,136,161,152,121,109,72,39,25,751,64,815,7.852760736196319
7057,330250220000112,75,126,96,106,121,57,50,30,581,80,661,12.10287443267776
7058,330250220000113,170,176,139,113,106,70,27,33,774,60,834,7.194244604316546
7059,330250220000114,179,212,173,158,133,84,51,42,939,93,1032,9.011627906976743
7060,330250220000115,64,79,51,77,61,35,26,22,367,48,415,11.566265060240964
7061,330250220000116,53,48,37,30,23,17,20,8,208,28,236,11.864406779661017
7062,330250220000117,11,13,7,16,9,5,6,1,61,7,68,10.294117647058824
7063,330250220000118,22,27,8,13,4,7,2,1,81,3,84,3.5714285714285716
7064,330250220000119,26,51,56,60,32,52,34,25,277,59,336,17.55952380952381
7065,330250220000120,65,73,91,69,61,50,42,17,409,59,468,12.606837606837606
7066,330250220000121,39,43,37,43,26,35,15,7,223,22,245,8.979591836734693
7067,330250220000122,52,85,114,101,75,96,62,46,523,108,631,17.11568938193344
7068,330250220000123,50,68,63,81,52,45,27,16,359,43,402,10.696517412935323
7069,330250220000124,53,51,52,47,49,35,23,14,287,37,324,11.419753086419753
7070,330250220000125,73,121,101,117,92,47,40,21,551,61,612,9.967320261437909
7071,330250220000126,52,95,74,72,75,46,21,37,414,58,472,12.288135593220339
7072,330250220000127,64,82,68,58,58,41,19,23,371,42,413,10.169491525423728
7073,330250220000128,44,54,72,58,48,37,30,25,313,55,368,14.945652173913043
7074,330250220000129,42,63,79,45,74,51,25,21,354,46,400,11.5
7075,330250220000130,33,39,38,54,32,31,11,7,227,18,245,7.346938775510204
7076,330250220000131,134,135,131,118,101,55,39,36,674,75,749,10.013351134846461
7077,330250220000132,20,21,43,24,31,36,10,10,175,20,195,10.256410256410257
7078,330250220000133,43,46,70,42,47,45,33,21,293,54,347,15.561959654178674
7079,330250220000134,95,127,94,104,72,53,41,22,545,63,608,10.361842105263158
7080,330250220000135,105,126,110,123,76,67,48,29,607,77,684,11.257309941520468
7081,330250220000136,88,130,104,125,101,57,37,34,605,71,676,10.502958579881657
7082,330250220000137,133,157,158,144,119,78,44,38,789,82,871,9.41446613088404
7083,330250220000138,86,105,86,85,86,73,38,18,521,56,577,9.705372616984402
7084,330250220000139,55,76,75,62,66,60,27,23,394,50,444,11.26126126126126
7085,330250220000140,63,91,66,75,70,39,25,19,404,44,448,9.821428571428571
7086,330250220000141,138,202,173,185,163,110,51,37,971,88,1059,8.309726156751653
7087,330250220000142,133,161,142,127,111,70,47,44,744,91,835,10.89820359281437
7088,330250220000143,88,118,77,70,67,30,25,15,450,40,490,8.16326530612245
7089,330250220000144,40,63,44,57,31,27,18,14,262,32,294,10.884353741496598
7090,330250220000145,122,144,116,106,89,72,45,25,649,70,719,9.735744089012517
7091,330250220000146,75,88,81,81,79,45,20,26,449,46,495,9.292929292929292
7092,330250220000147,52,38,59,52,34,30,32,11,265,43,308,13.96103896103896
7093,330250220000148,156,186,131,144,126,79,38,32,822,70,892,7.8475336322869955
7094,330250220000149,108,111,118,103,65,49,26,20,554,46,600,7.666666666666667
7095,330250220000150,173,156,119,128,81,52,39,29,709,68,777,8.751608751608751
7096,330250220000151,110,131,81,104,52,56,25,11,534,36,570,6.315789473684211
7097,330250220000152,173,180,170,162,103,60,55,42,848,97,945,10.264550264550264
7098,330250220000153,125,131,103,70,88,66,26,30,583,56,639,8.763693270735525
7099,330250220000154,96,105,85,82,57,43,30,16,468,46,514,8.949416342412452
7100,330250220000155,150,112,120,137,86,62,46,25,667,71,738,9.620596205962059
7101,330250220000156,88,93,91,91,93,73,67,51,529,118,647,18.238021638330757
7102,330250220000157,42,47,65,72,37,59,32,20,322,52,374,13.903743315508022
7103,330250220000158,87,117,90,77,63,59,22,5,493,27,520,5.1923076923076925
7104,330250220000159,105,122,153,129,104,83,51,27,696,78,774,10.077519379844961
7105,330250220000160,92,115,79,104,77,55,37,22,522,59,581,10.154905335628227
7106,330250220000161,35,21,25,15,12,10,6,2,118,8,126,6.349206349206349
7107,330250220000162,154,200,171,126,136,69,31,32,856,63,919,6.855277475516866
7108,330250225000001,55,101,66,83,76,67,52,28,448,80,528,15.151515151515152
7109,330250225000002,238,342,323,293,282,241,126,114,1719,240,1959,12.251148545176111
7110,330250225000003,84,131,129,99,116,103,64,42,662,106,768,13.802083333333334
7111,330250225000004,52,95,67,60,61,66,38,27,401,65,466,13.948497854077253
7112,330250225000005,78,105,86,69,77,54,45,18,469,63,532,11.842105263157896
7113,330250225000006,100,130,130,116,96,100,65,36,672,101,773,13.065976714100906
7114,330250225000007,88,151,152,137,143,115,110,56,786,166,952,17.436974789915965
7115,330250225000008,51,87,66,79,81,90,49,41,454,90,544,16.544117647058822
7116,330250225000009,67,83,127,85,110,97,77,66,569,143,712,20.084269662921347
7117,330250225000010,82,122,141,125,122,144,106,50,736,156,892,17.48878923766816
7118,330250225000011,110,166,148,103,152,107,71,45,786,116,902,12.86031042128603
7119,330250225000012,95,138,88,101,118,63,47,42,603,89,692,12.861271676300579
7120,330250225000013,44,68,63,58,74,65,50,31,372,81,453,17.880794701986755
7121,330250225000014,75,78,72,91,72,96,64,65,484,129,613,21.04404567699837
7122,330250225000015,29,47,29,25,41,21,13,10,192,23,215,10.69767441860465
7123,330250225000016,77,115,86,95,91,90,37,35,554,72,626,11.501597444089457
7126,330250225000019,17,26,13,18,25,7,7,5,106,12,118,10.169491525423728
7127,330250230000001,223,294,244,189,170,118,64,30,1238,94,1332,7.057057057057057
7128,330250230000002,34,44,33,32,36,30,19,11,209,30,239,12.552301255230125
7129,330250230000003,140,179,131,111,83,62,34,29,706,63,769,8.192457737321197
7130,330250230000004,177,248,137,175,117,81,51,39,935,90,1025,8.78048780487805
7131,330250230000005,175,154,165,145,108,71,36,22,818,58,876,6.621004566210046
7132,330250230000006,68,84,67,53,40,36,20,11,348,31,379,8.179419525065963
7133,330250230000007,74,96,77,105,59,48,34,18,459,52,511,10.176125244618396
7134,330250230000008,81,72,81,119,64,39,14,5,456,19,475,4.0
7135,330250230000009,67,90,47,48,40,23,11,8,315,19,334,5.688622754491018
7136,330250230000010,156,186,160,124,153,74,55,57,853,112,965,11.606217616580311
7137,330250230000011,134,162,134,103,99,47,21,15,679,36,715,5.034965034965035
7138,330250230000012,110,145,114,114,96,49,40,19,628,59,687,8.58806404657933
7139,330250230000013,95,120,93,74,72,54,35,21,508,56,564,9.929078014184396
7140,330250230000014,68,107,89,97,94,48,43,23,503,66,569,11.599297012302285
7141,330250230000015,74,103,83,82,76,43,47,17,461,64,525,12.19047619047619
7142,330250230000016,71,99,50,65,52,37,14,14,374,28,402,6.965174129353234
7143,330250230000017,104,128,114,101,87,47,36,26,581,62,643,9.64230171073095
7144,330250230000018,48,56,56,61,39,62,13,30,322,43,365,11.780821917808218
7145,330250230000019,40,50,32,26,21,20,5,5,189,10,199,5.025125628140704
7146,330250230000020,98,127,108,93,84,49,30,23,559,53,612,8.660130718954248
7147,330250230000021,12,15,17,20,12,14,10,6,90,16,106,15.09433962264151
7148,330250230000022,18,19,19,16,17,14,10,7,103,17,120,14.166666666666666
7149,330250230000023,35,35,32,18,9,14,8,7,143,15,158,9.49367088607595
7150,330250230000024,73,101,69,69,52,46,17,18,410,35,445,7.865168539325842
7151,330250230000025,8,6,8,11,6,9,4,1,48,5,53,9.433962264150944
7152,330250230000026,114,124,120,102,83,55,33,44,598,77,675,11.407407407407407
7153,330250230000027,19,27,20,21,14,9,3,7,110,10,120,8.333333333333334
7154,330250230000028,227,268,210,201,181,128,77,70,1215,147,1362,10.79295154185022
7155,330250230000029,22,16,18,13,5,6,5,6,80,11,91,12.087912087912088
7156,330250230000030,186,214,154,162,124,122,72,51,962,123,1085,11.336405529953916
7157,330250230000031,17,19,14,16,12,24,6,4,102,10,112,8.928571428571429
7158,330250230000032,66,72,62,58,45,46,21,26,349,47,396,11.868686868686869
7159,330250230000033,111,158,137,129,104,84,59,38,723,97,820,11.829268292682928
7160,330250230000034,138,156,162,137,129,82,55,31,804,86,890,9.662921348314606
7161,330250230000035,61,43,58,50,43,40,32,14,295,46,341,13.489736070381232
7162,330260105000001,72,98,101,81,104,75,51,56,531,107,638,16.771159874608152
7163,330260105000002,22,38,39,36,38,26,20,30,199,50,249,20.080321285140563
7164,330260105000003,114,163,134,125,129,79,48,29,744,77,821,9.378806333739343
7165,330260105000004,82,104,89,67,73,62,35,28,477,63,540,11.666666666666666
7166,330260105000006,14,20,25,41,50,23,19,10,173,29,202,14.356435643564357
7167,330260105000007,48,70,83,90,109,42,29,17,442,46,488,9.426229508196721
7168,330260105000008,26,42,39,51,29,46,37,29,233,66,299,22.073578595317727
7169,330260105000009,84,124,110,97,108,63,46,29,586,75,661,11.346444780635402
7170,330260105000011,1,1,8,0,5,8,4,0,23,4,27,14.814814814814815
7171,330260105000012,22,39,28,32,35,41,21,21,197,42,239,17.573221757322177
7172,330260105000013,25,24,28,27,20,14,9,6,138,15,153,9.803921568627452
7173,330260105000014,150,125,129,152,99,58,32,22,713,54,767,7.040417209908735
7174,330260105000015,12,18,20,21,14,26,14,8,111,22,133,16.541353383458645
7175,330260105000016,36,78,71,54,75,54,32,22,368,54,422,12.796208530805687
7176,330260105000017,46,43,75,32,44,34,23,14,274,37,311,11.897106109324758
7177,330260105000018,29,29,36,38,44,37,36,11,213,47,260,18.076923076923077
7178,330260105000019,51,79,75,59,69,46,52,26,379,78,457,17.067833698030636
7179,330260105000020,64,102,92,80,75,76,37,22,489,59,548,10.766423357664234
7180,330260105000021,33,52,55,62,52,46,22,26,300,48,348,13.793103448275861
7181,330260105000022,44,36,45,51,36,36,24,24,248,48,296,16.216216216216218
7182,330260105000023,30,43,39,25,36,11,3,4,184,7,191,3.6649214659685865
7183,330260105000024,111,114,138,116,95,65,41,18,639,59,698,8.45272206303725
7184,330260105000025,129,180,229,178,173,100,73,55,989,128,1117,11.459265890778871
7185,330260105000026,75,106,88,100,75,68,32,23,512,55,567,9.700176366843033
7186,330260105000028,15,27,66,63,33,14,4,3,218,7,225,3.111111111111111
7187,330260105000033,66,114,75,83,92,46,36,17,476,53,529,10.01890359168242
7188,330260105000034,59,54,55,65,66,44,25,11,343,36,379,9.49868073878628
7189,330260105000035,30,39,32,23,18,27,15,5,169,20,189,10.582010582010582
7190,330260105000036,91,86,110,79,64,59,34,23,489,57,546,10.43956043956044
7191,330260105000037,34,31,27,19,19,16,6,9,146,15,161,9.316770186335404
7192,330260105000038,134,141,103,148,95,84,41,20,705,61,766,7.9634464751958225
7193,330260105000039,32,35,27,34,20,12,6,10,160,16,176,9.090909090909092
7194,330260105000040,9,36,42,22,18,7,5,3,134,8,142,5.633802816901408
7195,330260105000041,26,27,19,26,24,27,17,9,149,26,175,14.857142857142858
7196,330260105000042,35,58,39,50,31,25,10,9,238,19,257,7.392996108949417
7197,330260105000043,7,6,6,5,5,0,0,0,29,0,29,0.0
7198,330260105000044,31,28,19,35,29,19,16,5,161,21,182,11.538461538461538
7199,330260105000045,98,108,126,115,96,54,26,20,597,46,643,7.153965785381026
7200,330260105000046,33,33,26,26,19,21,8,5,158,13,171,7.60233918128655
7201,330260105000047,146,190,132,169,138,92,42,21,867,63,930,6.774193548387097
7202,330260105000048,44,65,65,66,38,27,15,5,305,20,325,6.153846153846154
7203,330260110000001,73,85,94,92,125,56,76,22,525,98,623,15.730337078651685
7204,330260110000002,37,56,40,41,39,21,8,12,234,20,254,7.874015748031496
7205,330260110000003,36,25,50,43,42,30,31,19,226,50,276,18.115942028985508
7207,330260110000005,21,58,26,33,58,33,8,10,229,18,247,7.287449392712551
7208,330260110000006,104,108,115,126,63,51,38,12,567,50,617,8.103727714748784
7209,330260110000007,134,152,145,123,112,89,41,23,755,64,819,7.814407814407814
7210,330260110000008,19,17,11,18,5,4,5,2,74,7,81,8.641975308641975
7212,330260110000011,87,115,87,123,67,65,32,10,544,42,586,7.167235494880546
7213,330260110000012,97,129,74,101,68,55,24,19,524,43,567,7.583774250440917
7214,330260115000001,14,19,25,16,16,19,18,16,109,34,143,23.776223776223777
7215,330260115000002,29,35,31,43,28,41,33,18,207,51,258,19.767441860465116
7216,330260115000003,35,68,57,53,65,55,33,18,333,51,384,13.28125
7217,330260115000004,14,24,26,18,35,41,33,31,158,64,222,28.82882882882883
7218,330260115000005,38,59,59,43,50,63,20,25,312,45,357,12.605042016806722
7219,330260115000006,18,18,25,12,30,28,18,23,131,41,172,23.837209302325583
7220,330260115000007,22,42,36,45,38,41,31,28,224,59,283,20.848056537102472
7221,330260115000008,98,126,136,116,98,107,44,35,681,79,760,10.394736842105264
7222,330260115000009,19,30,15,23,23,20,22,14,130,36,166,21.686746987951807
7223,330260115000010,23,20,39,32,27,25,15,4,166,19,185,10.27027027027027
7224,330260115000011,153,210,190,165,166,131,77,42,1015,119,1134,10.493827160493828
7225,330260115000012,46,51,44,36,46,32,19,13,255,32,287,11.149825783972126
7226,330260115000014,20,26,17,18,14,16,13,10,111,23,134,17.16417910447761
7227,330260115000015,78,103,88,96,66,49,37,20,480,57,537,10.614525139664805
7228,330260115000016,6,17,9,10,21,15,17,11,78,28,106,26.41509433962264
7229,330260115000017,1,4,6,2,5,6,4,1,24,5,29,17.24137931034483
7230,330260115000018,35,38,30,42,45,37,27,8,227,35,262,13.358778625954198
7231,330260115000019,55,84,68,57,65,45,23,28,374,51,425,12.0
7232,330260120000001,12,18,10,17,19,23,32,30,99,62,161,38.50931677018634
7233,330260120000002,7,9,18,5,11,18,11,13,68,24,92,26.08695652173913
7234,330260120000003,10,14,13,15,15,16,24,12,83,36,119,30.252100840336134
7235,330260120000004,18,39,26,30,58,56,75,32,227,107,334,32.035928143712574
7236,330260120000005,31,42,36,47,34,28,26,9,218,35,253,13.83399209486166
7237,330260120000006,13,18,29,69,24,22,20,14,175,34,209,16.267942583732058
7238,330260120000007,22,26,30,25,31,25,26,23,159,49,208,23.557692307692307
7239,330260120000008,19,19,11,12,21,25,11,13,107,24,131,18.3206106870229
7240,330260120000009,7,15,16,12,23,19,18,16,92,34,126,26.984126984126984
7241,330260120000010,5,8,4,5,11,15,13,19,48,32,80,40.0
7242,330260120000011,20,25,19,9,22,31,24,12,126,36,162,22.22222222222222
7243,330260120000012,16,13,16,15,9,16,13,6,85,19,104,18.26923076923077
7244,330260120000013,21,31,31,29,35,36,26,17,183,43,226,19.02654867256637
7245,330260120000014,21,28,20,21,21,19,25,20,130,45,175,25.714285714285715
7246,330260120000015,75,106,96,77,97,81,55,29,532,84,616,13.636363636363637
7247,330260120000016,34,55,39,48,39,34,23,16,249,39,288,13.541666666666666
7248,330260120000017,23,27,28,25,24,19,8,9,146,17,163,10.429447852760736
7249,330260120000019,13,30,22,24,32,26,17,16,147,33,180,18.333333333333332
7250,330260120000020,12,12,9,13,11,15,10,11,72,21,93,22.580645161290324
7251,330260120000021,74,107,76,86,77,50,37,18,470,55,525,10.476190476190476
7252,330260120000022,42,33,41,37,20,40,17,10,213,27,240,11.25
7253,330260120000023,53,76,69,48,68,45,30,22,359,52,411,12.652068126520682
7254,330260120000024,62,75,66,77,74,46,40,22,400,62,462,13.41991341991342
7255,330260120000025,36,41,39,53,34,32,26,14,235,40,275,14.545454545454545
7256,330260120000026,59,61,39,58,45,42,36,19,304,55,359,15.32033426183844
7257,330260120000027,64,102,73,68,59,65,43,26,431,69,500,13.8
7258,330260120000028,76,85,92,69,73,71,29,13,466,42,508,8.26771653543307
7259,330260120000029,57,68,67,70,67,50,35,36,379,71,450,15.777777777777779
7260,330260120000030,31,42,27,54,30,17,16,12,201,28,229,12.22707423580786
7261,330260120000031,18,29,26,23,20,11,11,2,127,13,140,9.285714285714286
7262,330260120000032,113,155,115,108,85,54,31,16,630,47,677,6.942392909896602
7263,330260120000033,13,14,21,12,13,8,4,6,81,10,91,10.989010989010989
7264,330260120000035,14,26,20,36,17,20,12,8,133,20,153,13.071895424836601
7265,330260120000036,133,135,130,98,93,67,37,25,656,62,718,8.635097493036211
7266,330260120000037,19,33,29,73,17,19,10,11,190,21,211,9.95260663507109
7267,330260120000038,75,95,103,88,84,51,31,24,496,55,551,9.98185117967332
7268,330260120000039,3,1,2,2,3,5,2,3,16,5,21,23.80952380952381
7269,330270005000001,37,53,51,43,51,65,39,44,300,83,383,21.671018276762403
7270,330270005000002,80,142,90,95,120,110,61,67,637,128,765,16.73202614379085
7271,330270005000003,60,86,94,95,105,80,52,42,520,94,614,15.309446254071661
7272,330270005000004,34,65,69,66,59,68,57,62,361,119,480,24.791666666666668
7273,330270005000005,12,15,37,29,26,31,26,29,150,55,205,26.829268292682926
7274,330270005000006,26,38,53,38,58,60,48,41,273,89,362,24.585635359116022
7275,330270005000007,42,64,61,71,73,62,45,28,373,73,446,16.367713004484305
7276,330270005000008,21,21,25,37,31,38,33,30,173,63,236,26.694915254237287
7277,330270005000009,47,78,110,65,102,107,48,43,509,91,600,15.166666666666666
7278,330270005000010,45,61,71,56,47,73,54,44,353,98,451,21.72949002217295
7279,330270005000011,75,98,89,75,125,75,64,34,537,98,635,15.433070866141732
7280,330270005000012,74,72,94,87,78,80,47,39,485,86,571,15.061295971978984
7281,330270005000013,86,105,84,95,78,62,38,33,510,71,581,12.220309810671257
7282,330270005000014,96,147,101,130,106,111,46,31,691,77,768,10.026041666666666
7283,330270005000015,72,73,98,74,80,53,39,39,450,78,528,14.772727272727273
7284,330270005000016,149,179,168,199,182,126,71,44,1003,115,1118,10.286225402504472
7285,330270005000017,104,134,104,129,127,101,58,46,699,104,803,12.951432129514322
7286,330270005000018,49,64,59,79,62,50,38,22,363,60,423,14.184397163120567
7287,330270005000019,57,66,69,67,65,74,32,35,398,67,465,14.408602150537634
7288,330270005000020,22,13,18,21,24,26,16,11,124,27,151,17.880794701986755
7289,330270005000021,57,65,56,72,70,48,39,28,368,67,435,15.402298850574713
7290,330270005000022,63,79,60,75,64,64,33,22,405,55,460,11.956521739130435
7291,330270005000023,72,86,75,77,77,67,41,36,454,77,531,14.500941619585687
7292,330270005000024,53,55,40,57,59,50,41,28,314,69,383,18.01566579634465
7293,330270005000025,30,34,23,35,26,16,12,9,164,21,185,11.35135135135135
7294,330270005000026,53,65,47,64,69,74,41,28,372,69,441,15.646258503401361
7295,330270005000027,29,52,41,56,51,46,29,25,275,54,329,16.41337386018237
7296,330270005000028,22,43,34,38,21,26,18,9,184,27,211,12.796208530805687
7297,330270005000029,107,104,121,110,92,81,61,35,615,96,711,13.50210970464135
7298,330270005000030,86,139,117,111,116,89,41,55,658,96,754,12.73209549071618
7299,330270005000031,56,72,66,88,80,77,54,35,439,89,528,16.856060606060606
7300,330270005000032,53,80,93,81,84,80,68,63,471,131,602,21.760797342192692
7301,330270005000033,50,62,71,60,55,68,41,33,366,74,440,16.818181818181817
7302,330270005000034,68,107,92,68,76,43,42,27,454,69,523,13.193116634799235
7303,330270005000035,42,48,55,43,61,54,34,23,303,57,360,15.833333333333334
7304,330270005000036,34,57,62,51,68,74,63,44,346,107,453,23.620309050772626
7305,330270005000037,29,59,43,51,61,57,34,27,300,61,361,16.897506925207757
7306,330270005000038,8,5,4,10,5,11,8,6,43,14,57,24.56140350877193
7307,330270005000039,8,24,19,20,18,23,24,14,112,38,150,25.333333333333332
7308,330270005000040,22,20,13,25,24,18,21,21,122,42,164,25.609756097560975
7309,330270005000041,17,24,23,32,27,27,18,22,150,40,190,21.05263157894737
7310,330270005000042,12,37,31,25,48,36,25,31,189,56,245,22.857142857142858
7311,330270005000043,27,39,34,55,50,44,43,18,249,61,310,19.677419354838708
7312,330270005000044,16,18,12,13,16,9,6,5,84,11,95,11.578947368421053
7313,330270005000045,40,64,43,54,53,38,26,27,292,53,345,15.36231884057971
7314,330270005000046,60,60,65,65,68,63,35,29,381,64,445,14.382022471910112
7315,330270005000047,53,60,47,43,40,37,30,14,280,44,324,13.580246913580247
7316,330270005000048,35,45,49,40,46,45,14,16,260,30,290,10.344827586206897
7317,330270005000049,38,50,69,53,56,60,54,49,326,103,429,24.009324009324008
7318,330270005000050,34,45,55,48,48,53,37,34,283,71,354,20.056497175141242
7319,330270005000051,46,76,77,81,79,71,47,31,430,78,508,15.354330708661417
7320,330270005000052,17,44,34,37,44,37,26,18,213,44,257,17.120622568093385
7321,330270005000053,110,182,161,172,168,121,99,50,914,149,1063,14.016933207902163
7322,330270005000054,58,92,81,60,95,49,34,36,435,70,505,13.861386138613861
7323,330270005000055,75,67,85,83,71,43,26,15,424,41,465,8.817204301075268
7324,330270005000056,41,51,50,51,46,42,28,21,281,49,330,14.848484848484848
7325,330270005000057,39,51,74,55,73,54,28,43,346,71,417,17.026378896882495
7326,330270005000058,56,67,52,80,78,66,37,28,399,65,464,14.008620689655173
7327,330270005000059,84,69,99,106,91,68,48,38,517,86,603,14.262023217247098
7328,330270005000060,84,89,98,81,70,72,40,24,494,64,558,11.469534050179211
7329,330270005000061,70,74,80,78,53,55,37,25,410,62,472,13.135593220338983
7330,330270005000062,40,53,32,43,38,31,21,34,237,55,292,18.835616438356166
7331,330270005000063,97,106,88,143,107,89,35,26,630,61,691,8.827785817655572
7332,330270005000064,93,98,117,116,87,73,51,24,584,75,659,11.380880121396055
7333,330270005000065,96,126,142,127,95,87,72,33,673,105,778,13.496143958868895
7334,330270005000066,73,114,88,95,87,58,36,22,515,58,573,10.122164048865619
7335,330270005000067,40,56,47,55,48,33,23,18,279,41,320,12.8125
7336,330270005000068,13,23,25,22,22,18,18,13,123,31,154,20.12987012987013
7337,330270005000069,131,129,119,120,86,66,36,33,651,69,720,9.583333333333334
7338,330270005000070,39,52,41,55,54,37,21,13,278,34,312,10.897435897435898
7339,330270005000071,16,22,18,19,22,19,16,4,116,20,136,14.705882352941176
7340,330270005000072,12,5,10,16,5,15,8,9,63,17,80,21.25
7341,330270005000073,19,31,21,23,11,9,4,3,114,7,121,5.785123966942149
7342,330270005000074,27,26,23,22,23,16,4,6,137,10,147,6.802721088435374
7343,330270005000075,37,53,36,44,39,43,23,20,252,43,295,14.576271186440678
7344,330270005000076,31,65,57,42,65,63,27,20,323,47,370,12.702702702702704
7345,330270005000077,26,36,25,49,29,36,25,19,201,44,245,17.959183673469386
7346,330270005000078,63,87,62,90,89,98,49,34,489,83,572,14.51048951048951
7347,330270005000079,26,33,31,29,34,29,16,23,182,39,221,17.647058823529413
7348,330270005000080,34,61,58,35,32,42,15,13,262,28,290,9.655172413793103
7349,330270005000081,51,82,73,71,75,58,30,21,410,51,461,11.062906724511931
7350,330270005000082,72,79,58,45,43,37,20,13,334,33,367,8.991825613079019
7351,330270005000083,70,112,107,102,100,98,41,41,589,82,671,12.220566318926975
7352,330270005000084,49,76,84,96,75,77,57,52,457,109,566,19.257950530035334
7353,330270005000085,56,91,82,75,90,63,27,34,457,61,518,11.776061776061775
7354,330270005000086,47,78,51,65,48,48,24,19,337,43,380,11.31578947368421
7355,330270005000087,77,79,102,98,84,68,45,30,508,75,583,12.864493996569468
7356,330270005000088,37,55,46,54,33,33,20,4,258,24,282,8.51063829787234
7357,330270005000089,71,91,82,75,58,45,31,25,422,56,478,11.715481171548117
7358,330270005000090,65,64,48,58,40,17,14,10,292,24,316,7.594936708860759
7359,330270005000091,64,86,76,71,59,48,28,21,404,49,453,10.816777041942604
7360,330270005000092,100,124,105,117,86,61,28,23,593,51,644,7.919254658385094
7361,330270005000093,64,68,62,74,33,33,16,10,334,26,360,7.222222222222222
7362,330270005000094,49,71,38,52,34,27,19,24,271,43,314,13.694267515923567
7363,330270010000001,78,119,98,110,114,79,74,30,598,104,702,14.814814814814815
7364,330270010000002,270,251,227,229,165,137,65,40,1279,105,1384,7.586705202312139
7365,330270010000003,90,113,126,111,96,65,36,24,601,60,661,9.07715582450832
7366,330270010000004,56,78,46,58,44,27,23,15,309,38,347,10.951008645533141
7367,330270010000005,87,112,119,109,99,95,45,23,621,68,689,9.869375907111756
7368,330270010000006,48,64,54,54,69,47,44,20,336,64,400,16.0
7369,330270010000007,158,176,143,137,119,80,37,20,813,57,870,6.551724137931035
7370,330270010000008,130,162,138,145,93,79,50,28,747,78,825,9.454545454545455
7371,330270010000009,45,77,45,59,47,17,8,15,290,23,313,7.348242811501597
7372,330270010000010,138,141,121,139,127,75,51,39,741,90,831,10.830324909747292
7373,330270010000011,116,132,132,123,73,44,20,10,620,30,650,4.615384615384615
7374,330270010000012,60,56,64,96,98,68,40,16,442,56,498,11.244979919678714
7375,330270010000013,106,178,130,117,102,43,26,21,676,47,723,6.500691562932227
7376,330270010000014,57,106,83,68,78,50,32,28,442,60,502,11.952191235059761
7377,330270010000015,53,65,52,55,55,36,20,14,316,34,350,9.714285714285714
7378,330270010000016,73,102,114,107,89,65,41,36,550,77,627,12.280701754385966
7379,330270010000017,54,96,61,66,65,75,35,24,417,59,476,12.394957983193278
7380,330270010000018,73,64,79,81,64,77,50,36,438,86,524,16.412213740458014
7381,330270010000019,139,125,122,105,105,122,64,44,718,108,826,13.075060532687651
7382,330270010000020,85,126,79,91,107,66,48,23,554,71,625,11.36
7383,330270010000021,57,76,72,93,70,58,36,24,426,60,486,12.345679012345679
7384,330270010000022,95,124,120,103,94,66,42,25,602,67,669,10.014947683109119
7385,330270010000023,38,50,40,56,43,29,13,10,256,23,279,8.243727598566307
7386,330270010000024,81,76,97,96,58,57,40,24,465,64,529,12.098298676748582
7387,330270010000025,23,30,30,37,26,24,14,9,170,23,193,11.917098445595855
7388,330270010000026,93,92,106,102,94,73,48,33,560,81,641,12.636505460218409
7389,330270010000027,20,24,24,31,25,13,13,6,137,19,156,12.179487179487179
7390,330270010000028,74,101,141,146,152,95,68,33,709,101,810,12.469135802469136
7391,330270010000029,71,62,92,111,70,72,47,36,478,83,561,14.795008912655971
7392,330270010000030,78,97,92,93,63,56,53,23,479,76,555,13.693693693693694
7393,330270010000031,72,64,93,98,55,63,70,29,445,99,544,18.198529411764707
7394,330270010000032,144,155,127,113,94,68,43,14,701,57,758,7.519788918205805
7395,330270010000033,46,66,63,59,62,55,30,15,351,45,396,11.363636363636363
7396,330270010000034,28,31,36,29,26,25,29,22,175,51,226,22.56637168141593
7397,330270010000035,37,43,47,36,61,71,37,25,295,62,357,17.366946778711483
7398,330270010000036,38,44,51,53,35,60,31,21,281,52,333,15.615615615615615
7399,330270010000037,127,129,112,168,118,96,63,38,750,101,851,11.868390129259694
7400,330270010000038,48,61,78,101,70,65,58,23,423,81,504,16.071428571428573
7401,330270010000039,51,87,107,135,83,91,48,21,554,69,623,11.075441412520064
7402,330270010000040,28,52,52,40,38,53,30,33,263,63,326,19.32515337423313
7403,330270010000041,101,99,106,148,74,83,66,44,611,110,721,15.256588072122053
7404,330270010000042,43,63,58,44,57,42,28,12,307,40,347,11.527377521613833
7405,330270010000043,50,67,82,61,53,63,39,25,376,64,440,14.545454545454545
7406,330270010000044,72,105,114,105,79,56,54,25,531,79,610,12.950819672131148
7407,330270010000045,21,41,43,38,38,36,23,15,217,38,255,14.901960784313726
7408,330270010000046,70,67,120,82,75,70,42,24,484,66,550,12.0
7409,330270010000047,55,90,59,71,75,63,51,31,413,82,495,16.565656565656564
7410,330270010000048,13,31,50,59,44,38,27,9,235,36,271,13.284132841328413
7411,330270010000049,36,65,52,62,65,77,70,38,357,108,465,23.225806451612904
7412,330270010000050,26,43,24,44,42,43,36,32,222,68,290,23.448275862068964
7413,330270010000051,35,57,59,74,84,60,39,28,369,67,436,15.36697247706422
7414,330270010000052,51,66,51,58,69,52,29,30,347,59,406,14.532019704433498
7415,330270010000053,105,125,190,149,132,97,63,50,798,113,911,12.403951701427003
7416,330270010000054,61,49,81,76,57,45,26,13,369,39,408,9.558823529411764
7417,330270010000055,43,51,72,90,87,85,44,37,428,81,509,15.913555992141454
7418,330270010000056,26,33,36,43,36,38,33,9,212,42,254,16.53543307086614
7419,330270010000057,34,106,64,67,88,54,31,14,413,45,458,9.825327510917031
7420,330270010000058,20,21,15,27,17,26,36,14,126,50,176,28.40909090909091
7421,330270010000059,31,32,36,53,44,35,30,25,231,55,286,19.23076923076923
7422,330270010000060,66,127,143,150,125,107,42,12,718,54,772,6.994818652849741
7423,330270010000061,53,65,53,78,50,45,25,15,344,40,384,10.416666666666666
7424,330270010000062,49,71,48,52,55,49,16,11,324,27,351,7.6923076923076925
7425,330270010000063,93,99,145,142,98,84,64,42,661,106,767,13.820078226857888
7426,330270010000064,26,31,25,29,36,43,17,11,190,28,218,12.844036697247706
7427,330270010000065,48,54,45,73,35,22,14,9,277,23,300,7.666666666666667
7428,330270010000066,20,18,25,24,36,30,29,9,153,38,191,19.895287958115183
7429,330270010000067,42,47,63,80,74,69,31,25,375,56,431,12.993039443155453
7430,330270010000068,65,66,126,103,73,88,39,23,521,62,583,10.634648370497427
7431,330270010000069,74,81,146,122,101,69,45,25,593,70,663,10.558069381598793
7432,330270010000070,38,55,60,77,64,42,17,16,336,33,369,8.94308943089431
7433,330270010000071,75,97,62,103,73,54,35,23,464,58,522,11.11111111111111
7434,330270010000072,75,73,82,116,93,100,47,22,539,69,608,11.348684210526315
7435,330270010000073,116,140,177,167,143,100,81,32,843,113,956,11.820083682008368
7436,330270010000074,128,134,215,156,165,108,58,26,906,84,990,8.484848484848484
7437,330270010000075,22,21,27,41,24,36,33,12,171,45,216,20.833333333333332
7438,330270010000076,42,43,50,66,69,65,34,30,335,64,399,16.040100250626566
7439,330270010000077,37,28,40,59,47,42,30,9,253,39,292,13.356164383561644
7440,330270010000078,47,64,79,97,101,96,46,33,484,79,563,14.031971580817052
7441,330270010000079,57,85,80,87,83,73,40,33,465,73,538,13.568773234200744
7442,330270010000080,37,72,50,53,72,53,30,23,337,53,390,13.58974358974359
7443,330270010000081,76,67,95,87,101,89,53,45,515,98,613,15.986949429037521
7444,330270010000082,46,57,71,57,87,51,42,39,369,81,450,18.0
7445,330270010000083,82,154,94,103,84,31,16,11,548,27,575,4.695652173913044
7446,330270010000084,86,87,86,137,103,85,41,31,584,72,656,10.975609756097562
7447,330270010000085,62,82,114,128,103,107,61,34,596,95,691,13.748191027496382
7448,330270010000086,128,167,156,185,132,120,37,29,888,66,954,6.918238993710692
7449,330270010000087,54,56,80,103,70,63,35,25,426,60,486,12.345679012345679
7450,330270010000088,49,56,82,92,71,44,28,19,394,47,441,10.657596371882086
7451,330270010000089,59,65,55,54,46,38,27,13,317,40,357,11.204481792717086
7452,330270010000090,95,86,110,113,77,67,42,22,548,64,612,10.457516339869281
7453,330270010000091,48,51,61,73,63,64,42,16,360,58,418,13.875598086124402
7454,330270010000092,93,73,110,86,76,83,58,31,521,89,610,14.59016393442623
7455,330270010000093,32,35,43,41,43,38,25,19,232,44,276,15.942028985507246
7456,330270010000094,76,93,109,100,112,81,44,42,571,86,657,13.089802130898022
7457,330270010000095,42,45,97,69,64,41,25,18,358,43,401,10.723192019950124
7458,330270010000096,124,139,131,140,134,98,61,63,766,124,890,13.932584269662922
7459,330270010000097,80,102,88,119,121,49,25,15,559,40,599,6.67779632721202
7460,330270010000098,13,28,37,20,19,19,11,3,136,14,150,9.333333333333334
7461,330270010000099,0,2,2,3,3,4,1,2,14,3,17,17.647058823529413
7462,330270010000100,6,10,9,5,4,3,2,7,37,9,46,19.565217391304348
7463,330270010000101,1,6,8,12,7,3,7,5,37,12,49,24.489795918367346
7464,330270010000102,0,3,1,6,5,2,0,2,17,2,19,10.526315789473685
7465,330270010000103,90,106,96,139,132,94,53,32,657,85,742,11.455525606469003
7466,330270010000104,82,122,109,133,94,91,45,35,631,80,711,11.251758087201125
7467,330270010000105,91,83,82,122,97,73,29,21,548,50,598,8.361204013377927
7468,330270010000106,84,134,134,143,131,123,62,46,749,108,857,12.602100350058343
7469,330270010000107,49,62,50,61,55,53,34,12,330,46,376,12.23404255319149
7470,330270010000108,71,66,79,68,75,50,32,12,409,44,453,9.713024282560706
7471,330270010000109,68,77,110,104,77,66,41,24,502,65,567,11.46384479717813
7472,330270010000110,114,102,120,153,111,104,71,34,704,105,809,12.978986402966626
7473,330270010000111,70,67,99,95,70,71,64,24,472,88,560,15.714285714285714
7474,330270010000112,43,83,129,111,95,67,21,7,528,28,556,5.0359712230215825
7475,330270010000113,19,32,37,33,21,48,28,16,190,44,234,18.803418803418804
7476,330270010000114,11,21,42,39,28,39,24,20,180,44,224,19.642857142857142
7477,330270010000115,76,66,111,115,72,72,61,29,512,90,602,14.950166112956811
7478,330270010000116,94,125,93,116,66,52,28,22,546,50,596,8.389261744966444
7479,330270010000117,35,27,48,47,34,23,14,1,214,15,229,6.550218340611353
7480,330270010000118,83,121,129,131,112,69,40,13,645,53,698,7.593123209169055
7481,330270010000119,63,45,57,92,58,61,34,30,376,64,440,14.545454545454545
7482,330270010000120,81,118,96,119,126,87,57,28,627,85,712,11.938202247191011
7483,330270010000121,66,69,133,106,107,65,35,25,546,60,606,9.900990099009901
7484,330270010000122,56,75,58,85,83,91,42,36,448,78,526,14.828897338403042
7485,330270010000123,74,65,75,114,77,60,37,26,465,63,528,11.931818181818182
7486,330270010000124,39,76,94,116,86,92,36,25,503,61,564,10.815602836879433
7487,330270010000125,69,78,94,119,100,81,52,18,541,70,611,11.456628477905074
7488,330270010000126,45,61,61,93,86,53,54,32,399,86,485,17.7319587628866
7489,330270010000127,116,120,123,113,79,64,40,12,615,52,667,7.796101949025488
7490,330270010000128,114,107,153,152,140,88,43,29,754,72,826,8.716707021791768
7491,330270010000129,48,46,56,55,74,40,42,16,319,58,377,15.384615384615385
7492,330270010000130,99,130,95,109,104,56,30,10,593,40,633,6.3191153238546605
7493,330270010000131,82,91,126,88,61,66,38,8,514,46,560,8.214285714285714
7494,330270010000132,32,42,38,45,33,43,16,16,233,32,265,12.075471698113208
7495,330270010000133,112,134,103,130,110,83,45,28,672,73,745,9.798657718120806
7496,330270010000134,33,52,52,48,59,34,16,15,278,31,309,10.032362459546926
7497,330270010000135,37,39,32,47,29,26,20,14,210,34,244,13.934426229508198
7498,330270010000136,71,77,85,85,79,60,27,17,457,44,501,8.782435129740518
7499,330270010000138,28,33,27,24,25,16,8,11,153,19,172,11.046511627906977
7500,330270010000139,0,4,2,5,3,0,3,0,14,3,17,17.647058823529413
7501,330270010000140,42,43,40,32,33,15,8,10,205,18,223,8.071748878923767
7502,330270010000141,59,54,57,48,25,19,16,10,262,26,288,9.027777777777779
7503,330270010000142,18,44,35,25,29,11,18,8,162,26,188,13.829787234042554
7504,330270010000143,63,77,70,54,30,24,17,7,318,24,342,7.017543859649122
7505,330270010000144,50,52,69,68,54,61,31,6,354,37,391,9.462915601023019
7506,330270010000145,54,53,52,54,63,43,27,9,319,36,355,10.140845070422536
7507,330270015000001,45,59,51,54,45,58,35,25,312,60,372,16.129032258064516
7508,330270015000002,9,9,11,12,12,13,7,4,66,11,77,14.285714285714286
7509,330270015000003,9,10,4,16,5,3,2,4,47,6,53,11.320754716981131
7510,330270015000004,5,6,10,2,5,9,3,5,37,8,45,17.77777777777778
7511,330270015000005,23,37,29,28,32,39,30,14,188,44,232,18.96551724137931
7512,330270015000006,44,67,48,57,40,33,28,20,289,48,337,14.243323442136498
7513,330270015000007,28,38,28,33,50,33,20,18,210,38,248,15.32258064516129
7514,330270015000008,37,36,42,37,31,41,11,17,224,28,252,11.11111111111111
7515,330270015000009,44,56,39,51,39,30,14,13,259,27,286,9.44055944055944
7516,330270015000010,28,37,21,21,16,12,7,5,135,12,147,8.16326530612245
7517,330270015000011,37,33,25,34,29,31,17,9,189,26,215,12.093023255813954
7518,330270015000012,19,10,14,10,7,22,10,6,82,16,98,16.3265306122449
7519,330270015000013,30,20,24,25,16,14,10,10,129,20,149,13.422818791946309
7520,330270015000014,26,36,40,57,52,38,35,11,249,46,295,15.59322033898305
7521,330270015000015,45,40,44,51,43,33,26,24,256,50,306,16.33986928104575
7522,330270015000016,26,46,37,34,45,49,17,17,237,34,271,12.546125461254613
7523,330270015000017,29,46,42,52,38,49,29,21,256,50,306,16.33986928104575
7524,330270015000018,23,28,36,38,55,45,22,18,225,40,265,15.09433962264151
7525,330270015000019,21,41,17,32,26,30,15,8,167,23,190,12.105263157894736
7526,330270015000020,15,20,14,20,19,23,12,8,111,20,131,15.267175572519085
7527,330270015000021,47,47,39,32,35,32,20,9,232,29,261,11.11111111111111
7528,330270015000022,16,23,15,19,24,26,15,10,123,25,148,16.89189189189189
7529,330270015000023,9,16,12,11,14,20,16,10,82,26,108,24.074074074074073
7530,330270015000024,20,32,19,20,32,27,21,13,150,34,184,18.47826086956522
7531,330270015000025,41,48,34,36,43,36,30,16,238,46,284,16.197183098591548
7532,330270015000026,17,14,14,16,26,28,8,14,115,22,137,16.05839416058394
7533,330270015000027,47,96,65,76,86,85,41,34,455,75,530,14.150943396226415
7534,330270015000028,60,68,57,60,52,45,23,17,342,40,382,10.471204188481675
7535,330270015000029,33,39,35,33,35,29,16,25,204,41,245,16.73469387755102
7536,330270015000030,5,14,8,7,19,8,6,8,61,14,75,18.666666666666668
7537,330270015000031,28,44,28,33,39,21,11,18,193,29,222,13.063063063063064
7538,330270015000032,25,20,22,11,19,26,13,13,123,26,149,17.449664429530202
7539,330270015000033,15,22,18,12,15,13,1,4,95,5,100,5.0
7540,330270015000034,34,42,34,31,23,34,23,20,198,43,241,17.842323651452283
7541,330270015000035,10,18,10,14,19,18,12,5,89,17,106,16.037735849056602
7542,330270015000036,13,14,22,20,19,20,13,16,108,29,137,21.16788321167883
7543,330270015000037,12,16,20,9,17,26,15,15,100,30,130,23.076923076923077
7544,330270015000038,11,16,8,17,17,19,15,9,88,24,112,21.428571428571427
7545,330270015000039,19,25,24,27,34,44,15,16,173,31,204,15.196078431372548
7546,330270015000040,9,11,14,20,12,17,14,10,83,24,107,22.429906542056074
7547,330270015000041,34,22,32,37,46,50,20,18,221,38,259,14.671814671814673
7548,330270015000042,49,70,75,78,74,65,35,40,411,75,486,15.432098765432098
7549,330270015000043,45,67,58,74,59,50,47,22,353,69,422,16.350710900473935
7550,330270015000044,56,46,45,44,31,30,20,13,252,33,285,11.578947368421053
7551,330270015000045,17,23,18,18,21,18,11,5,115,16,131,12.213740458015268
7552,330270015000046,89,111,102,140,139,107,65,50,688,115,803,14.321295143212952
7553,330270015000047,62,105,84,85,104,68,30,20,508,50,558,8.960573476702509
7554,330270015000048,51,97,83,65,98,94,66,40,488,106,594,17.845117845117844
7555,330270015000049,28,35,25,27,32,36,22,14,183,36,219,16.438356164383563
7556,330270015000050,7,3,7,1,5,9,5,1,32,6,38,15.789473684210526
7557,330270015000051,19,17,7,16,20,6,11,6,85,17,102,16.666666666666668
7558,330270015000052,7,11,5,7,11,6,4,1,47,5,52,9.615384615384615
7559,330270015000053,8,2,3,3,12,8,2,4,36,6,42,14.285714285714286
7560,330270015000054,83,109,103,116,80,65,48,55,556,103,659,15.629742033383915
7561,330270015000055,14,25,22,28,18,21,18,7,128,25,153,16.33986928104575
7562,330270015000056,8,6,8,13,8,10,5,6,53,11,64,17.1875
7563,330270015000057,12,12,12,7,16,7,8,3,66,11,77,14.285714285714286
7564,330270015000058,40,47,44,52,52,53,30,13,288,43,331,12.990936555891238
7565,330270015000059,18,14,27,16,25,17,16,17,117,33,150,22.0
7566,330270015000060,25,37,26,30,28,43,27,17,189,44,233,18.88412017167382
7567,330270015000061,15,26,23,24,43,39,29,22,170,51,221,23.076923076923077
7568,330270015000062,20,45,29,43,43,44,25,18,224,43,267,16.10486891385768
7569,330270015000063,10,32,11,14,36,23,9,13,126,22,148,14.864864864864865
7570,330270015000064,5,4,5,5,12,3,6,4,34,10,44,22.727272727272727
7571,330270015000065,37,47,45,57,32,35,22,18,253,40,293,13.651877133105803
7572,330270015000066,17,17,20,10,8,6,3,3,78,6,84,7.142857142857143
7573,330270015000067,7,19,10,10,12,11,7,4,69,11,80,13.75
7574,330270015000068,9,9,11,7,10,13,3,1,59,4,63,6.349206349206349
7575,330280905000001,70,106,110,95,108,84,38,34,573,72,645,11.162790697674419
7576,330280905000002,24,47,37,48,59,71,40,61,286,101,387,26.098191214470283
7577,330280905000003,34,32,25,47,33,35,26,26,206,52,258,20.155038759689923
7578,330280905000004,87,106,82,106,96,82,48,40,559,88,647,13.601236476043276
7579,330280905000005,67,76,118,94,86,102,42,48,543,90,633,14.218009478672986
7580,330280905000006,74,120,115,105,130,98,76,73,642,149,791,18.83691529709229
7581,330280905000007,78,132,110,122,143,128,67,52,713,119,832,14.302884615384615
7582,330280905000008,64,78,85,96,103,87,65,66,513,131,644,20.341614906832298
7583,330280905000009,44,48,78,53,56,66,35,28,345,63,408,15.441176470588236
7584,330280905000010,109,106,128,102,106,80,51,21,631,72,703,10.241820768136558
7585,330280905000011,63,92,71,78,82,60,23,28,446,51,497,10.261569416498993
7586,330280905000012,81,76,99,95,74,72,58,55,497,113,610,18.524590163934427
7587,330280905000013,84,100,89,122,104,71,61,31,570,92,662,13.897280966767372
7588,330280905000014,56,93,94,89,90,64,41,25,486,66,552,11.956521739130435
7589,330280905000015,33,66,47,54,72,74,34,19,346,53,399,13.283208020050125
7590,330280905000016,88,114,133,105,125,102,59,56,667,115,782,14.705882352941176
7591,330280905000017,63,51,62,80,72,65,44,47,393,91,484,18.801652892561982
7592,330280905000018,47,70,67,67,83,54,43,30,388,73,461,15.835140997830802
7593,330280905000019,32,50,50,47,52,52,30,29,283,59,342,17.251461988304094
7594,330280905000020,101,116,110,106,111,102,42,41,646,83,729,11.385459533607682
7595,330280905000021,72,134,104,123,125,87,51,43,645,94,739,12.719891745602165
7596,330280905000022,52,39,44,53,38,39,15,6,265,21,286,7.3426573426573425
7597,330280905000023,66,92,78,69,92,45,37,19,442,56,498,11.244979919678714
7598,330280905000024,52,61,57,62,57,46,26,28,335,54,389,13.881748071979434
7599,330280905000025,66,85,90,59,74,62,35,34,436,69,505,13.663366336633663
7600,330280905000026,63,71,76,75,80,79,65,55,444,120,564,21.27659574468085
7601,330280905000027,38,44,35,30,48,13,15,11,208,26,234,11.11111111111111
7602,330280905000028,39,74,69,59,84,95,46,75,420,121,541,22.36598890942699
7603,330280905000029,43,91,74,73,82,53,31,25,416,56,472,11.864406779661017
7604,330280905000030,88,122,88,107,97,52,31,23,554,54,608,8.881578947368421
7605,330280905000031,59,82,89,86,103,98,49,45,517,94,611,15.384615384615385
7606,330280905000032,120,169,121,149,135,115,68,82,809,150,959,15.641293013555787
7608,330280905000034,4,8,6,5,10,10,0,4,43,4,47,8.51063829787234
7610,330285805000001,55,49,62,68,53,54,28,21,341,49,390,12.564102564102564
7611,330285805000002,62,70,95,93,79,58,46,31,457,77,534,14.41947565543071
7612,330285805000003,31,53,63,56,67,65,26,33,335,59,394,14.974619289340101
7613,330285805000004,30,33,46,38,45,37,25,21,229,46,275,16.727272727272727
7614,330285805000005,36,47,38,67,45,44,37,31,277,68,345,19.71014492753623
7615,330285805000006,74,94,85,73,61,56,28,15,443,43,486,8.847736625514404
7616,330285805000007,183,226,179,184,136,94,54,34,1002,88,1090,8.073394495412844
7617,330285805000008,36,42,30,36,52,29,15,6,225,21,246,8.536585365853659
7618,330285805000009,19,29,23,14,26,29,13,13,140,26,166,15.662650602409638
7619,330285805000010,21,28,23,26,15,10,11,6,123,17,140,12.142857142857142
7620,330285805000011,65,75,102,89,100,59,44,65,490,109,599,18.196994991652755
7621,330285805000012,36,31,56,41,28,55,31,17,247,48,295,16.271186440677965
7622,330285805000013,96,119,94,105,86,91,30,53,591,83,674,12.31454005934718
7623,330285805000014,101,147,146,142,140,110,72,63,786,135,921,14.657980456026058
7624,330285805000015,69,86,108,105,90,68,57,42,526,99,625,15.84
7625,330285805000016,43,61,37,50,48,36,31,31,275,62,337,18.397626112759642
7626,330285805000017,60,84,71,60,62,66,40,34,403,74,477,15.51362683438155
7627,330285805000018,99,130,140,137,131,128,104,93,765,197,962,20.47817047817048
7628,330285805000019,34,48,62,49,48,39,40,28,280,68,348,19.54022988505747
7629,330285805000020,67,81,120,88,106,103,50,62,565,112,677,16.54357459379616
7630,330285805000021,43,63,77,78,62,60,57,27,383,84,467,17.987152034261243
7631,330285805000022,75,79,106,102,103,80,58,48,545,106,651,16.282642089093702
7632,330285805000023,73,101,73,73,84,55,23,25,459,48,507,9.467455621301776
7633,330285805000024,56,95,78,79,71,48,37,26,427,63,490,12.857142857142858
7634,330285805000025,42,56,58,79,49,61,46,38,345,84,429,19.58041958041958
7635,330285805000026,51,54,52,64,66,50,29,41,337,70,407,17.1990171990172
7636,330285805000027,84,70,101,85,79,72,50,28,491,78,569,13.708260105448154
7637,330285805000028,42,43,74,48,67,48,44,40,322,84,406,20.689655172413794
7638,330285805000029,93,144,116,128,132,102,60,47,715,107,822,13.017031630170317
7639,330285805000030,82,123,116,142,117,100,83,66,680,149,829,17.973462002412546
7640,330285805000031,89,123,89,92,80,77,52,38,550,90,640,14.0625
7641,330285805000032,78,101,101,102,93,56,72,36,531,108,639,16.901408450704224
7642,330285805000033,107,137,143,120,110,97,51,46,714,97,811,11.960542540073982
7643,330285805000034,107,138,131,121,132,103,82,54,732,136,868,15.668202764976959
7644,330285805000035,52,91,82,85,75,71,46,36,456,82,538,15.241635687732343
7645,330285805000036,115,150,167,124,134,110,72,54,800,126,926,13.606911447084233
7646,330285805000037,113,162,163,151,128,111,70,47,828,117,945,12.380952380952381
7647,330285805000038,44,53,48,55,48,46,27,20,294,47,341,13.782991202346041
7648,330285805000039,68,92,103,103,85,88,50,52,539,102,641,15.912636505460219
7649,330285805000040,45,58,73,50,75,64,37,25,365,62,427,14.519906323185012
7650,330285805000041,77,97,116,87,88,78,48,41,543,89,632,14.082278481012658
7651,330285805000042,88,118,97,83,89,76,34,27,551,61,612,9.967320261437909
7652,330285805000043,61,62,73,64,42,59,50,15,361,65,426,15.258215962441314
7653,330285805000044,122,149,154,120,122,85,68,44,752,112,864,12.962962962962964
7654,330285805000045,128,164,123,147,151,93,73,48,806,121,927,13.052858683926646
7655,330285805000046,58,92,70,60,95,60,43,34,435,77,512,15.0390625
7656,330285805000047,103,117,131,129,131,82,51,41,693,92,785,11.719745222929935
7657,330285805000048,131,136,115,128,106,68,49,32,684,81,765,10.588235294117647
7658,330285805000049,73,87,92,100,82,60,39,39,494,78,572,13.636363636363637
7659,330285805000050,49,66,59,76,78,61,52,32,389,84,473,17.758985200845665
7660,330285805000051,66,98,85,63,83,70,46,28,465,74,539,13.729128014842301
7661,330285805000052,59,60,71,61,74,56,45,23,381,68,449,15.144766146993318
7662,330285805000053,96,97,110,105,78,73,28,28,559,56,615,9.105691056910569
7663,330285805000054,74,102,103,88,84,79,50,47,530,97,627,15.470494417862838
7664,330285805000055,146,181,148,163,148,103,75,54,889,129,1018,12.671905697445972
7665,330285805000056,148,177,153,147,128,91,47,39,844,86,930,9.24731182795699
7666,330285805000057,104,130,104,100,90,82,52,33,610,85,695,12.23021582733813
7667,330285805000058,88,119,131,92,90,76,52,39,596,91,687,13.24599708879185
7668,330285805000059,78,104,95,89,88,83,34,25,537,59,596,9.899328859060402
7669,330285805000060,112,148,135,130,120,91,69,42,736,111,847,13.105076741440378
7670,330285805000061,73,73,97,82,56,62,48,25,443,73,516,14.147286821705427
7671,330285805000062,49,64,56,55,54,35,38,28,313,66,379,17.41424802110818
7672,330285805000063,112,124,98,98,97,68,54,32,597,86,683,12.591508052708638
7673,330285805000064,67,81,79,58,65,43,16,15,393,31,424,7.311320754716981
7674,330285805000065,141,183,164,174,167,142,73,66,971,139,1110,12.522522522522523
7675,330285805000066,52,69,78,39,59,58,33,38,355,71,426,16.666666666666668
7676,330285805000067,105,142,114,120,105,89,46,38,675,84,759,11.067193675889328
7677,330285805000068,124,134,177,118,123,95,37,40,771,77,848,9.080188679245284
7678,330285805000069,156,193,142,168,113,108,80,30,880,110,990,11.11111111111111
7679,330285805000070,54,82,69,66,75,55,42,46,401,88,489,17.995910020449898
7680,330285805000071,109,102,130,111,109,80,75,43,641,118,759,15.5467720685112
7681,330285805000072,208,224,156,340,252,97,50,20,1277,70,1347,5.196733481811433
7682,330285805000073,61,78,124,83,105,123,49,27,574,76,650,11.692307692307692
7683,330285805000074,100,206,175,121,214,180,73,43,996,116,1112,10.431654676258994
7684,330285805000075,81,102,99,106,90,88,33,22,566,55,621,8.856682769726248
7685,330285805000076,85,102,117,114,87,102,35,17,607,52,659,7.890743550834598
7686,330285805000077,75,113,57,94,134,64,25,18,537,43,580,7.413793103448276
7687,330285805000078,77,93,62,86,103,50,22,9,471,31,502,6.175298804780876
7688,330285805000079,63,100,97,107,70,99,48,25,536,73,609,11.986863711001641
7689,330285805000080,46,86,106,85,95,120,71,33,538,104,642,16.1993769470405
7690,330285805000081,64,89,117,86,94,109,41,32,559,73,632,11.550632911392405
7691,330285805000082,63,89,101,93,76,92,50,21,514,71,585,12.136752136752136
7692,330285805000083,145,170,228,206,200,97,45,32,1046,77,1123,6.8566340160284955
7693,330285805000084,168,206,162,156,128,87,58,19,907,77,984,7.82520325203252
7694,330285805000085,157,190,156,147,105,109,50,24,864,74,938,7.889125799573561
7695,330285805000086,67,85,74,88,62,49,38,26,425,64,489,13.087934560327199
7696,330285805000087,94,106,122,103,99,101,49,38,625,87,712,12.219101123595506
7697,330285805000088,59,80,81,87,78,61,33,31,446,64,510,12.549019607843137
7698,330285805000089,87,119,98,130,112,79,53,49,625,102,727,14.030261348005501
7699,330285805000090,32,62,52,43,54,60,28,35,303,63,366,17.21311475409836
7700,330285805000091,69,83,91,76,78,64,39,22,461,61,522,11.685823754789272
7701,330285805000092,68,97,109,83,108,77,42,35,542,77,619,12.439418416801292
7702,330285805000093,76,102,101,96,106,62,33,44,543,77,620,12.419354838709678
7703,330285805000094,83,114,99,81,85,79,60,22,541,82,623,13.162118780096309
7704,330285805000095,141,133,125,112,123,108,50,38,742,88,830,10.602409638554217
7705,330285805000096,108,136,99,115,94,68,53,25,620,78,698,11.174785100286533
7706,330285805000097,120,152,116,107,121,68,53,44,684,97,781,12.419974391805377
7707,330285805000098,105,133,139,99,111,60,26,20,647,46,693,6.637806637806638
7708,330285805000099,57,84,59,64,73,36,25,15,373,40,413,9.685230024213075
7709,330285805000100,93,130,95,98,70,56,27,17,542,44,586,7.508532423208191
7710,330285805000101,12,18,6,19,11,7,2,3,73,5,78,6.410256410256411
7711,330285805000102,69,82,75,65,70,62,40,22,423,62,485,12.783505154639176
7712,330285805000103,60,58,64,52,47,40,33,18,321,51,372,13.709677419354838
7713,330285805000104,48,72,82,68,76,64,33,27,410,60,470,12.76595744680851
7714,330285805000105,134,175,140,134,110,90,71,31,783,102,885,11.525423728813559
7715,330285805000106,116,147,130,117,121,106,59,41,737,100,837,11.947431302270012
7716,330285805000107,88,106,104,107,75,79,40,32,559,72,631,11.410459587955627
7717,330285805000108,72,131,91,99,75,47,29,23,515,52,567,9.171075837742505
7718,330285805000109,48,68,58,65,51,48,24,22,338,46,384,11.979166666666666
7719,330285805000110,55,107,88,72,85,68,38,25,475,63,538,11.71003717472119
7720,330285805000111,51,81,67,51,74,45,34,23,369,57,426,13.380281690140846
7721,330285805000112,106,155,130,125,113,107,64,35,736,99,835,11.8562874251497
7722,330285805000113,128,147,125,102,101,49,19,12,652,31,683,4.538799414348462
7724,330285805000115,88,105,111,78,86,48,27,20,516,47,563,8.348134991119005
7725,330285805000116,43,84,62,79,62,66,17,13,396,30,426,7.042253521126761
7726,330285805000117,71,92,90,59,82,53,21,9,447,30,477,6.289308176100629
7727,330285805000118,55,99,74,58,69,38,26,15,393,41,434,9.44700460829493
7728,330285805000119,212,237,167,178,147,83,41,19,1024,60,1084,5.535055350553505
7729,330285805000120,86,90,86,100,51,68,36,26,481,62,543,11.41804788213628
7730,330285805000121,93,118,121,101,101,83,48,32,617,80,697,11.477761836441895
7731,330285805000122,51,77,81,56,76,54,21,32,395,53,448,11.830357142857142
7732,330285805000123,106,132,138,145,126,100,59,45,747,104,851,12.220916568742656
7733,330285805000124,168,246,265,242,200,171,104,44,1292,148,1440,10.277777777777779
7734,330285805000125,76,79,86,95,55,47,40,18,438,58,496,11.693548387096774
7735,330285805000126,47,62,49,79,45,51,47,19,333,66,399,16.541353383458645
7736,330285805000127,45,75,64,66,68,52,39,28,370,67,437,15.331807780320366
7737,330285805000128,71,117,120,119,110,95,70,64,632,134,766,17.4934725848564
7738,330285805000129,62,88,96,102,102,92,63,57,542,120,662,18.12688821752266
7739,330285805000130,66,91,78,80,104,81,58,46,500,104,604,17.218543046357617
7740,330285805000131,54,54,43,56,32,14,17,9,253,26,279,9.31899641577061
7741,330285805000132,214,201,136,123,111,67,23,30,852,53,905,5.856353591160221
7742,330285805000133,61,67,59,48,44,29,9,8,308,17,325,5.230769230769231
7743,330285805000134,83,103,83,106,100,74,42,27,549,69,618,11.16504854368932
7744,330285805000135,66,73,97,75,88,62,27,25,461,52,513,10.1364522417154
7745,330285805000136,55,70,78,72,80,56,31,37,411,68,479,14.19624217118998
7746,330285805000137,76,80,85,74,70,52,18,18,437,36,473,7.6109936575052854
7747,330285805000138,70,99,98,108,65,60,32,25,500,57,557,10.23339317773788
7748,330285805000139,120,133,155,161,118,112,60,36,799,96,895,10.726256983240223
7749,330285805000140,99,92,98,82,85,47,30,23,503,53,556,9.532374100719425
7750,330285805000141,90,101,114,78,83,64,29,25,530,54,584,9.246575342465754
7751,330285805000142,82,117,104,120,105,67,46,27,595,73,668,10.928143712574851
7752,330285805000143,124,152,105,113,124,61,32,22,679,54,733,7.3669849931787175
7753,330285805000144,65,90,107,69,60,47,31,15,438,46,484,9.50413223140496
7754,330285805000145,132,178,147,163,122,109,76,45,851,121,972,12.448559670781894
7755,330285805000146,145,178,159,138,153,107,54,44,880,98,978,10.020449897750511
7756,330285805000147,79,106,87,72,80,48,26,17,472,43,515,8.349514563106796
7757,330285805000148,80,107,95,92,99,78,36,36,551,72,623,11.556982343499197
7758,330285805000149,96,141,141,119,124,65,42,41,686,83,769,10.793237971391417
7759,330285805000150,75,92,103,70,72,57,31,25,469,56,525,10.666666666666666
7760,330285805000151,119,155,142,123,102,85,68,28,726,96,822,11.678832116788321
7761,330285805000152,76,75,70,80,59,48,40,24,408,64,472,13.559322033898304
7762,330285805000153,103,119,116,107,98,83,34,34,626,68,694,9.798270893371757
7763,330285805000154,144,163,186,144,143,116,56,30,896,86,982,8.75763747454175
7764,330285805000155,146,179,162,150,120,91,56,49,848,105,953,11.017838405036725
7765,330285805000156,84,79,107,83,78,59,41,28,490,69,559,12.343470483005367
7766,330285805000157,85,94,111,89,92,67,32,33,538,65,603,10.779436152570481
7767,330285805000158,97,87,95,97,70,62,26,27,508,53,561,9.44741532976827
7768,330285805000159,134,140,179,128,112,75,66,28,768,94,862,10.904872389791183
7769,330285805000160,96,98,82,96,76,43,19,23,491,42,533,7.879924953095685
7770,330285805000161,121,159,141,155,105,93,50,29,774,79,853,9.261430246189917
7771,330285805000162,150,199,153,170,160,95,62,41,927,103,1030,10.0
7772,330285805000163,76,94,79,71,68,50,22,20,438,42,480,8.75
7773,330285805000164,50,105,83,67,76,61,23,21,442,44,486,9.053497942386832
7774,330285805000165,96,121,96,117,87,79,46,35,596,81,677,11.964549483013293
7775,330285805000166,136,167,141,99,134,90,30,28,767,58,825,7.03030303030303
7776,330285805000167,18,24,31,20,23,21,15,4,137,19,156,12.179487179487179
7777,330285805000168,141,172,143,116,147,85,33,29,804,62,866,7.159353348729792
7778,330285805000169,122,151,75,132,93,60,30,39,633,69,702,9.82905982905983
7779,330285805000170,121,115,88,79,60,74,31,22,537,53,590,8.983050847457626
7780,330285805000171,84,108,79,96,82,54,31,34,503,65,568,11.443661971830986
7781,330285805000172,98,120,102,97,79,64,23,25,560,48,608,7.894736842105263
7782,330285805000174,148,173,143,154,107,97,41,28,822,69,891,7.744107744107744
7783,330285805000175,139,118,127,121,96,62,38,27,663,65,728,8.928571428571429
7784,330285805000176,111,121,122,145,95,86,44,36,680,80,760,10.526315789473685
7785,330285805000177,118,141,111,90,90,68,27,27,618,54,672,8.035714285714286
7787,330285805000179,47,33,42,44,38,20,15,9,224,24,248,9.67741935483871
7788,330285805000180,41,57,39,41,58,35,25,27,271,52,323,16.09907120743034
7789,330285805000181,40,60,54,52,55,41,31,20,302,51,353,14.44759206798867
7790,330285805000182,17,26,48,41,43,45,31,36,220,67,287,23.34494773519164
7791,330285805000183,20,28,20,32,12,10,6,7,122,13,135,9.62962962962963
7792,330285805000184,25,36,17,31,38,14,23,11,161,34,195,17.435897435897434
7793,330285805000185,59,72,64,87,68,61,51,28,411,79,490,16.122448979591837
7794,330285805000186,66,120,107,92,91,83,45,48,559,93,652,14.263803680981596
7795,330285805000187,2,5,4,2,7,3,2,4,23,6,29,20.689655172413794
7796,330285805000188,59,61,70,50,77,63,37,38,380,75,455,16.483516483516482
7797,330285805000189,52,62,59,78,65,44,50,42,360,92,452,20.353982300884955
7799,330285805000191,61,56,82,50,57,39,32,32,345,64,409,15.647921760391197
7800,330285805000192,80,87,106,93,102,75,34,50,543,84,627,13.397129186602871
7801,330285805000193,38,38,45,79,52,48,38,36,300,74,374,19.78609625668449
7802,330285805000194,35,44,53,54,50,47,32,30,283,62,345,17.971014492753625
7803,330285805000195,60,99,110,107,108,86,35,35,570,70,640,10.9375
7804,330285805000196,39,57,76,58,60,54,44,26,344,70,414,16.908212560386474
7805,330285805000197,93,109,90,105,83,68,34,31,548,65,613,10.603588907014682
7806,330285805000198,0,2,5,2,3,1,1,3,13,4,17,23.529411764705884
7807,330285805000199,7,11,13,12,11,14,16,10,68,26,94,27.659574468085108
7808,330285805000200,3,6,5,2,5,3,5,6,24,11,35,31.428571428571427
7809,330285805000201,25,30,28,33,15,26,20,14,157,34,191,17.801047120418847
7810,330285805000202,12,14,30,30,12,28,16,14,126,30,156,19.23076923076923
7811,330285805000203,57,43,59,83,67,62,45,39,371,84,455,18.46153846153846
7812,330285805000204,27,24,43,22,25,18,13,8,159,21,180,11.666666666666666
7813,330285805000205,45,51,70,71,66,82,58,33,385,91,476,19.11764705882353
7814,330285805000206,54,68,84,72,60,48,50,22,386,72,458,15.720524017467248
7815,330285805000207,51,51,81,55,67,59,32,27,364,59,423,13.947990543735225
7816,330285805000208,57,77,65,87,72,59,54,27,417,81,498,16.265060240963855
7817,330285805000209,54,85,62,74,78,51,35,24,404,59,463,12.742980561555076
7818,330285805000210,69,74,73,70,88,43,36,18,417,54,471,11.464968152866241
7819,330285805000211,58,91,86,94,89,86,66,38,504,104,608,17.105263157894736
7820,330285805000212,33,34,43,22,28,20,9,4,180,13,193,6.7357512953367875
7821,330285805000213,11,27,16,20,18,14,9,13,106,22,128,17.1875
7822,330285805000214,54,80,57,67,67,53,26,13,378,39,417,9.352517985611511
7823,330285805000215,62,96,90,77,109,60,47,47,494,94,588,15.986394557823129
7824,330285805000216,79,88,80,71,60,63,25,19,441,44,485,9.072164948453608
7825,330285805000217,49,90,82,60,63,55,37,40,399,77,476,16.176470588235293
7826,330285805000218,146,179,147,146,125,64,52,30,807,82,889,9.22384701912261
7827,330285805000219,38,30,32,38,39,23,9,8,200,17,217,7.8341013824884795
7828,330285805000220,79,117,106,84,87,83,46,30,556,76,632,12.025316455696203
7829,330285805000221,58,84,53,64,62,42,26,19,363,45,408,11.029411764705882
7830,330285805000222,11,14,23,12,16,22,5,8,98,13,111,11.711711711711711
7831,330285805000223,57,95,62,67,66,50,41,23,397,64,461,13.882863340563992
7832,330285805000224,33,54,65,49,48,48,33,34,297,67,364,18.406593406593405
7833,330285805000225,52,94,82,70,73,69,49,18,440,67,507,13.214990138067062
7834,330285805000226,44,64,63,56,60,39,34,15,326,49,375,13.066666666666666
7835,330285805000227,98,103,124,96,80,63,38,27,564,65,629,10.333863275039745
7836,330285805000228,82,107,107,72,76,62,20,22,506,42,548,7.664233576642336
7837,330285805000229,64,82,71,64,65,75,16,30,421,46,467,9.850107066381156
7838,330285805000230,86,69,84,78,54,43,28,11,414,39,453,8.609271523178808
7839,330285805000231,11,5,14,7,8,4,15,2,49,17,66,25.757575757575758
7840,330285805000232,7,14,11,15,6,7,6,5,60,11,71,15.492957746478874
7841,330285805000233,82,112,95,77,89,51,21,12,506,33,539,6.122448979591836
7842,330285805000234,35,70,62,70,62,39,26,15,338,41,379,10.817941952506596
7843,330285805000235,46,57,46,45,43,36,11,19,273,30,303,9.900990099009901
7844,330285805000236,47,60,48,47,39,36,19,17,277,36,313,11.501597444089457
7845,330285805000237,42,57,54,49,60,46,24,20,308,44,352,12.5
7846,330285805000238,16,11,15,20,8,10,10,5,80,15,95,15.789473684210526
7847,330285805000239,3,6,9,2,4,2,2,1,26,3,29,10.344827586206897
7848,330285805000240,178,189,137,151,113,67,35,28,835,63,898,7.015590200445434
7849,330285805000241,169,187,184,185,130,117,52,36,972,88,1060,8.30188679245283
7850,330285805000242,126,150,114,87,100,49,33,14,626,47,673,6.983655274888559
7851,330285805000243,50,65,68,71,61,66,22,28,381,50,431,11.600928074245939
7852,330285805000244,108,136,106,110,104,58,37,18,622,55,677,8.124076809453472
7853,330285805000245,112,133,114,112,106,75,47,46,652,93,745,12.483221476510067
7854,330285805000246,50,84,76,69,70,75,41,28,424,69,493,13.995943204868155
7855,330285805000247,179,170,192,237,151,79,42,25,1008,67,1075,6.232558139534884
7856,330285805000248,50,67,62,53,51,45,22,33,328,55,383,14.360313315926893
7857,330285805000249,37,56,57,74,52,56,24,29,332,53,385,13.766233766233766
7858,330285805000250,68,113,102,73,87,60,34,35,503,69,572,12.062937062937063
7859,330285805000251,57,70,56,44,43,31,21,5,301,26,327,7.951070336391437
7860,330285805000252,5,6,4,4,1,2,2,0,22,2,24,8.333333333333334
7861,330285805000253,79,58,101,88,40,59,34,10,425,44,469,9.381663113006397
7862,330285805000254,55,56,44,68,40,39,29,18,302,47,349,13.46704871060172
7863,330285805000255,49,90,90,75,65,73,54,29,442,83,525,15.80952380952381
7864,330285805000256,64,81,74,86,91,71,40,25,467,65,532,12.218045112781954
7865,330285805000257,73,85,82,107,67,63,38,19,477,57,534,10.674157303370787
7866,330285805000258,69,104,90,99,86,76,49,40,524,89,613,14.518760195758565
7867,330285805000259,88,100,114,102,77,83,61,36,564,97,661,14.674735249621785
7868,330285805000260,91,107,72,95,75,50,27,20,490,47,537,8.752327746741155
7869,330285805000261,126,149,126,144,119,87,65,55,751,120,871,13.777267508610793
7870,330285805000262,68,53,68,65,50,41,24,16,345,40,385,10.38961038961039
7871,330285805000263,44,42,55,59,42,48,26,23,290,49,339,14.454277286135694
7872,330285805000264,53,52,75,71,60,60,34,23,371,57,428,13.317757009345794
7873,330285805000265,77,99,99,86,103,56,37,30,520,67,587,11.41396933560477
7874,330285805000266,72,119,108,81,67,52,35,17,499,52,551,9.437386569872958
7875,330285805000267,78,68,91,71,60,55,31,29,423,60,483,12.422360248447205
7876,330285805000268,67,96,89,84,66,70,39,26,472,65,537,12.104283054003725
7877,330285805000269,115,153,145,112,136,91,43,33,752,76,828,9.178743961352657
7878,330285805000270,158,248,156,194,130,107,56,58,993,114,1107,10.29810298102981
7879,330285805000271,88,130,84,102,89,50,27,19,543,46,589,7.809847198641766
7880,330285805000272,47,77,78,65,55,38,16,12,360,28,388,7.216494845360825
7881,330285805000273,97,117,119,84,93,93,41,31,603,72,675,10.666666666666666
7882,330285805000274,153,154,122,105,101,76,24,24,711,48,759,6.324110671936759
7883,330285805000275,91,101,83,80,67,35,26,19,457,45,502,8.96414342629482
7884,330285805000276,81,87,81,78,54,54,17,17,435,34,469,7.249466950959488
7885,330285805000277,80,95,98,106,65,50,43,17,494,60,554,10.830324909747292
7886,330285805000278,19,32,20,34,14,22,8,3,141,11,152,7.2368421052631575
7887,330285805000279,110,115,120,105,83,69,42,23,602,65,667,9.745127436281859
7888,330285805000280,98,133,108,90,100,70,29,28,599,57,656,8.689024390243903
7889,330285805000281,110,121,110,99,71,52,40,19,563,59,622,9.485530546623794
7890,330285805000282,104,105,106,115,74,80,39,15,584,54,638,8.463949843260188
7891,330285805000283,90,120,98,93,76,56,33,24,533,57,590,9.661016949152541
7892,330285805000284,174,176,180,144,120,83,52,18,877,70,947,7.391763463569165
7893,330285805000285,77,112,91,86,62,59,30,26,487,56,543,10.313075506445673
7894,330285805000286,91,123,92,92,92,71,26,35,561,61,622,9.807073954983922
7895,330285805000287,122,126,118,117,70,59,45,24,612,69,681,10.13215859030837
7896,330285805000288,64,83,73,65,70,51,32,22,406,54,460,11.73913043478261
7897,330285805000289,59,80,66,71,55,42,27,17,373,44,417,10.551558752997602
7898,330285805000290,58,81,51,63,44,35,25,17,332,42,374,11.229946524064172
7899,330285805000291,91,111,105,76,76,38,32,18,497,50,547,9.140767824497258
7900,330285805000292,69,72,149,145,85,50,19,3,570,22,592,3.7162162162162162
7901,330285805000293,4,2,3,6,4,0,2,2,19,4,23,17.391304347826086
7902,330285805000294,22,20,19,19,21,10,9,7,111,16,127,12.598425196850394
7904,330285805000296,39,34,37,30,29,21,9,7,190,16,206,7.766990291262136
7905,330285805000297,16,28,25,19,26,14,8,6,128,14,142,9.859154929577464
7906,330285805000298,76,69,70,54,46,25,19,11,340,30,370,8.108108108108109
7907,330285805000299,14,23,15,24,21,18,11,14,115,25,140,17.857142857142858
7908,330285805000300,16,26,17,22,23,14,6,9,118,15,133,11.278195488721805
7909,330285805000301,37,40,34,38,36,25,12,8,210,20,230,8.695652173913043
7910,330285805000302,13,17,20,14,22,14,4,3,100,7,107,6.542056074766355
7911,330285805000303,25,30,42,30,24,27,19,9,178,28,206,13.592233009708737
7912,330285805000304,4,6,10,5,7,7,2,0,39,2,41,4.878048780487805
7913,330285805000305,10,7,8,14,7,12,9,2,58,11,69,15.942028985507246
7914,330285805000306,3,4,4,4,0,2,3,1,17,4,21,19.047619047619047
7915,330285805000307,16,21,33,22,24,33,16,9,149,25,174,14.367816091954023
7916,330285805000309,39,31,28,29,18,13,11,5,158,16,174,9.195402298850574
7917,330285805000310,27,22,18,14,18,11,4,1,110,5,115,4.3478260869565215
7918,330285805000311,45,74,49,43,57,39,18,17,307,35,342,10.23391812865497
7919,330285805000312,7,17,6,12,9,15,6,3,66,9,75,12.0
7920,330285805000313,11,9,7,15,6,9,6,2,57,8,65,12.307692307692308
7921,330285805000314,21,32,17,32,22,12,7,5,136,12,148,8.108108108108109
7922,330285805000315,9,6,10,6,6,10,3,7,47,10,57,17.54385964912281
7923,330285805000317,4,10,5,8,15,5,7,6,47,13,60,21.666666666666668
7924,330285805000318,2,5,5,4,3,4,2,1,23,3,26,11.538461538461538
7925,330285805000319,12,24,33,25,31,27,17,14,152,31,183,16.939890710382514
7926,330285805000320,146,162,157,132,119,69,39,27,785,66,851,7.755581668625147
7927,330285805000321,42,78,48,44,37,23,23,13,272,36,308,11.688311688311689
7928,330290805000001,31,51,39,53,61,52,53,54,287,107,394,27.15736040609137
7929,330290805000002,22,30,31,29,31,35,42,63,178,105,283,37.102473498233216
7930,330290805000003,45,66,68,69,84,104,68,90,436,158,594,26.5993265993266
7931,330290805000004,27,44,21,48,53,49,37,36,242,73,315,23.174603174603174
7932,330290805000005,25,36,31,36,48,37,25,31,213,56,269,20.817843866171003
7933,330290805000006,95,125,120,107,134,111,64,75,692,139,831,16.726835138387486
7934,330290805000007,87,135,105,126,127,105,68,61,685,129,814,15.847665847665848
7935,330290805000008,39,66,43,55,44,29,23,30,276,53,329,16.109422492401215
7936,330290805000009,33,46,42,46,50,40,44,40,257,84,341,24.633431085043988
7937,330290805000010,44,57,48,69,55,55,50,70,328,120,448,26.785714285714285
7938,330290805000011,28,46,67,35,50,57,53,47,283,100,383,26.109660574412533
7939,330290805000012,42,48,59,61,59,59,48,46,328,94,422,22.274881516587676
7940,330290805000013,87,95,79,80,75,71,52,37,487,89,576,15.45138888888889
7941,330290805000014,104,143,95,107,123,76,56,38,648,94,742,12.668463611859838
7942,330290805000015,81,93,75,104,64,40,35,18,457,53,510,10.392156862745098
7943,330290805000016,97,144,136,108,129,84,58,51,698,109,807,13.506815365551425
7944,330290805000017,55,92,69,79,78,52,38,27,425,65,490,13.26530612244898
7945,330290805000018,39,57,46,60,58,76,41,34,336,75,411,18.248175182481752
7946,330290805000019,40,50,37,56,63,59,42,47,305,89,394,22.588832487309645
7947,330290805000020,44,83,57,70,90,74,54,56,418,110,528,20.833333333333332
7948,330290805000021,54,72,33,49,29,28,10,15,265,25,290,8.620689655172415
7949,330290805000022,77,101,79,66,69,59,37,20,451,57,508,11.220472440944881
7950,330290805000023,105,100,101,76,59,58,32,26,499,58,557,10.412926391382406
7951,330290805000024,14,33,29,24,24,20,5,10,144,15,159,9.433962264150944
7952,330290805000025,39,58,47,58,46,37,30,7,285,37,322,11.490683229813664
7953,330290805000026,40,48,41,50,37,48,33,35,264,68,332,20.481927710843372
7954,330290805000027,32,47,53,57,64,56,26,31,309,57,366,15.573770491803279
7955,330290805000028,50,53,56,48,75,57,34,28,339,62,401,15.46134663341646
7956,330290805000029,31,57,56,53,48,33,45,20,278,65,343,18.950437317784257
7957,330290805000030,26,54,42,39,44,30,32,27,235,59,294,20.068027210884352
7958,330290805000031,70,89,86,93,77,80,55,47,495,102,597,17.08542713567839
7959,330290805000032,12,28,14,16,21,27,17,18,118,35,153,22.875816993464053
7960,330290805000033,169,246,199,159,148,115,57,49,1036,106,1142,9.281961471103328
7961,330290807000001,127,161,136,125,131,122,64,64,802,128,930,13.763440860215054
7962,330290807000002,80,95,99,82,101,77,57,52,534,109,643,16.951788491446344
7963,330290807000003,61,72,57,45,57,33,23,23,325,46,371,12.398921832884097
7964,330290807000004,4,11,9,2,5,2,2,4,33,6,39,15.384615384615385
7965,330290810000001,64,80,87,66,89,73,39,44,459,83,542,15.313653136531366
7966,330290810000002,72,85,95,89,87,76,59,50,504,109,613,17.781402936378466
7967,330290810000003,39,59,53,40,59,45,33,26,295,59,354,16.666666666666668
7968,330290810000004,128,132,134,122,135,116,67,51,767,118,885,13.333333333333334
7969,330290810000005,27,47,25,27,50,31,24,33,207,57,264,21.59090909090909
7970,330290810000006,16,38,32,40,42,21,22,8,189,30,219,13.698630136986301
7971,330290810000007,46,64,54,51,48,41,15,9,304,24,328,7.317073170731708
7972,330290810000008,60,92,65,65,99,79,53,52,460,105,565,18.58407079646018
7973,330290810000009,51,62,55,56,61,63,55,47,348,102,450,22.666666666666668
7974,330290810000010,150,217,184,188,183,157,125,99,1079,224,1303,17.191097467382964
7975,330290810000011,61,80,65,43,77,43,24,32,369,56,425,13.176470588235293
7976,330290810000012,53,50,49,34,35,37,17,18,258,35,293,11.945392491467576
7977,330290810000013,25,34,33,22,29,20,10,4,163,14,177,7.909604519774011
7978,330290810000014,45,38,44,54,34,47,38,33,262,71,333,21.32132132132132
7979,330290810000015,64,88,78,82,83,75,54,39,470,93,563,16.518650088809945
7980,330300505000001,73,124,101,70,100,87,61,79,555,140,695,20.14388489208633
7981,330300505000002,148,152,184,141,107,85,52,35,817,87,904,9.623893805309734
7982,330300505000003,44,68,52,55,67,79,84,99,365,183,548,33.394160583941606
7983,330300505000004,10,34,30,16,30,32,35,34,152,69,221,31.221719457013574
7984,330300505000005,27,37,31,42,40,27,28,31,204,59,263,22.433460076045627
7985,330300505000006,96,120,119,131,132,110,74,82,708,156,864,18.055555555555557
7986,330300505000007,30,38,32,43,35,15,10,14,193,24,217,11.059907834101383
7987,330300505000008,98,132,112,108,118,89,43,49,657,92,749,12.283044058744993
7988,330300505000009,158,177,169,148,170,129,54,65,951,119,1070,11.121495327102803
7989,330300505000010,68,104,82,96,98,71,44,58,519,102,621,16.42512077294686
7990,330300505000011,44,50,35,45,63,42,37,23,279,60,339,17.699115044247787
7991,330300505000012,87,106,107,122,128,87,75,64,637,139,776,17.912371134020617
7992,330300505000013,78,105,115,100,99,121,77,85,618,162,780,20.76923076923077
7993,330300505000014,128,151,129,116,95,83,52,34,702,86,788,10.913705583756345
7994,330300505000015,139,140,132,131,97,70,53,49,709,102,811,12.577065351418003
7995,330300505000016,198,191,188,149,114,75,54,31,915,85,1000,8.5
7996,330300505000017,130,162,149,85,95,65,20,33,686,53,739,7.171853856562923
7997,330300505000018,168,175,111,121,58,50,34,12,683,46,729,6.310013717421125
7998,330300505000019,116,124,107,114,73,71,34,26,605,60,665,9.022556390977444
7999,330300505000020,114,136,129,117,133,95,47,79,724,126,850,14.823529411764707
8000,330300505000021,121,156,170,120,109,96,42,49,772,91,863,10.544611819235225
8001,330300505000022,125,165,130,128,100,78,56,46,726,102,828,12.318840579710145
8002,330300505000023,106,126,132,101,108,80,56,52,653,108,761,14.19185282522996
8003,330300505000024,115,91,98,90,63,55,23,33,512,56,568,9.859154929577464
8004,330300505000025,167,181,153,144,133,103,40,37,881,77,958,8.037578288100208
8005,330300505000026,125,172,160,155,173,137,90,92,922,182,1104,16.485507246376812
8006,330300505000027,64,83,105,79,124,76,59,60,531,119,650,18.307692307692307
8007,330300505000028,74,97,84,71,73,63,43,33,462,76,538,14.12639405204461
8008,330300505000029,61,63,84,85,94,87,47,69,474,116,590,19.661016949152543
8009,330300505000030,97,150,119,117,118,78,74,53,679,127,806,15.75682382133995
8010,330300505000031,81,108,106,94,103,77,51,60,569,111,680,16.323529411764707
8011,330300505000032,82,118,83,103,65,77,51,58,528,109,637,17.111459968602826
8012,330300505000033,37,48,46,22,46,27,21,14,226,35,261,13.409961685823754
8013,330300505000034,4,8,10,3,9,13,5,3,47,8,55,14.545454545454545
8014,330300505000035,25,28,29,17,16,17,12,11,132,23,155,14.838709677419354
8015,330300505000036,14,23,20,16,32,21,9,4,126,13,139,9.352517985611511
8016,330300505000037,32,30,20,20,22,16,15,8,140,23,163,14.110429447852761
8017,330300505000038,39,64,28,46,46,23,22,10,246,32,278,11.510791366906474
8018,330300505000039,110,116,120,116,127,74,61,52,663,113,776,14.561855670103093
8019,330300510000001,64,112,70,83,79,56,49,59,464,108,572,18.88111888111888
8020,330300510000002,20,36,49,19,33,26,25,26,183,51,234,21.794871794871796
8021,330300510000003,87,140,98,91,83,75,59,34,574,93,667,13.943028485757122
8022,330300510000004,30,33,22,26,27,19,12,14,157,26,183,14.207650273224044
8023,330300515000001,71,90,63,73,84,54,49,63,435,112,547,20.47531992687386
8024,330300515000002,27,28,31,30,33,20,18,14,169,32,201,15.92039800995025
8025,330310405000001,29,49,37,26,56,48,31,59,245,90,335,26.865671641791046
8026,330310405000002,95,97,97,123,116,95,48,76,623,124,747,16.599732262382865
8027,330310405000003,110,105,126,133,117,112,72,98,703,170,873,19.47308132875143
8028,330310405000004,108,164,160,133,146,109,67,61,820,128,948,13.50210970464135
8029,330310405000005,141,198,174,158,135,113,58,34,919,92,1011,9.099901088031652
8030,330310405000006,48,74,82,73,82,61,54,75,420,129,549,23.497267759562842
8031,330310405000007,79,92,94,80,87,63,40,52,495,92,587,15.672913117546848
8032,330310405000008,108,139,114,96,97,80,62,65,634,127,761,16.68856767411301
8033,330310405000009,69,92,95,85,67,72,43,27,480,70,550,12.727272727272727
8034,330310405000010,86,133,108,100,127,101,49,76,655,125,780,16.025641025641026
8035,330310405000011,92,106,94,110,110,96,34,49,608,83,691,12.011577424023155
8036,330310405000012,179,177,168,133,103,87,59,37,847,96,943,10.180275715800637
8037,330310405000013,51,75,103,60,71,66,38,36,426,74,500,14.8
8038,330310405000014,74,95,97,93,101,88,70,66,548,136,684,19.883040935672515
8039,330310405000015,32,55,46,42,47,32,27,18,254,45,299,15.050167224080267
8040,330310405000016,57,72,69,62,56,63,33,27,379,60,439,13.66742596810934
8041,330310405000017,146,189,154,123,124,89,66,45,825,111,936,11.85897435897436
8042,330310405000018,45,59,41,43,38,22,14,8,248,22,270,8.148148148148149
8043,330310405000019,17,27,34,32,24,23,7,9,157,16,173,9.248554913294798
8044,330310405000020,37,52,44,59,62,51,37,35,305,72,377,19.09814323607427
8045,330310405000021,68,76,59,80,78,57,32,26,418,58,476,12.184873949579831
8046,330310407000001,23,35,28,27,36,42,19,32,191,51,242,21.074380165289256
8047,330310407000002,78,107,79,85,95,60,42,64,504,106,610,17.37704918032787
8048,330310407000003,16,47,25,18,39,26,21,16,171,37,208,17.78846153846154
8049,330310410000001,44,49,52,46,50,47,42,46,288,88,376,23.404255319148938
8050,330310410000002,40,64,43,48,51,48,41,48,294,89,383,23.237597911227155
8051,330310410000003,19,15,26,17,19,20,16,10,116,26,142,18.309859154929576
8052,330310410000004,28,32,23,37,22,27,10,13,169,23,192,11.979166666666666
8053,330320305000001,43,57,65,68,71,52,50,44,356,94,450,20.88888888888889
8054,330320305000002,44,62,49,62,68,54,32,30,339,62,401,15.46134663341646
8055,330320305000003,34,57,49,67,57,61,35,28,325,63,388,16.237113402061855
8056,330320305000004,23,34,36,49,40,61,45,36,243,81,324,25.0
8057,330320305000005,50,90,117,74,113,106,78,73,550,151,701,21.540656205420827
8058,330320305000006,42,55,83,65,81,78,36,27,404,63,467,13.490364025695932
8059,330320305000007,44,74,78,71,69,81,41,47,417,88,505,17.425742574257427
8060,330320305000008,76,105,109,102,106,96,63,61,594,124,718,17.270194986072422
8061,330320305000009,52,76,74,89,99,92,45,58,482,103,585,17.60683760683761
8062,330320305000010,60,96,106,96,93,89,54,49,540,103,643,16.018662519440124
8063,330320305000011,71,107,84,127,117,72,45,37,578,82,660,12.424242424242424
8064,330320305000012,98,130,130,149,139,89,59,52,735,111,846,13.120567375886525
8065,330320305000013,27,46,68,42,52,52,24,26,287,50,337,14.836795252225519
8066,330320305000014,46,109,106,76,109,98,55,54,544,109,653,16.69218989280245
8067,330320305000015,34,41,62,48,53,50,23,32,288,55,343,16.034985422740526
8068,330320305000016,29,51,60,60,59,69,48,44,328,92,420,21.904761904761905
8069,330320305000017,48,66,85,72,75,67,38,35,413,73,486,15.020576131687243
8070,330320305000018,30,47,58,78,39,77,46,35,329,81,410,19.75609756097561
8071,330320305000019,82,103,124,103,103,97,58,41,612,99,711,13.924050632911392
8072,330320305000020,54,75,76,72,85,76,50,47,438,97,535,18.130841121495326
8073,330320305000021,44,52,64,66,77,61,48,39,364,87,451,19.290465631929045
8074,330320305000022,40,56,66,53,73,64,58,61,352,119,471,25.265392781316347
8075,330320305000023,62,65,90,66,70,67,62,62,420,124,544,22.794117647058822
8076,330320305000024,32,31,76,46,48,48,27,37,281,64,345,18.55072463768116
8077,330320305000025,66,66,97,96,102,117,81,61,544,142,686,20.699708454810494
8078,330320305000026,37,73,99,92,84,103,54,49,488,103,591,17.42808798646362
8079,330320305000027,84,121,111,146,114,118,81,57,694,138,832,16.58653846153846
8080,330320305000028,38,44,60,60,48,58,44,32,308,76,384,19.791666666666668
8081,330320305000029,37,57,60,74,70,66,50,32,364,82,446,18.385650224215247
8082,330320305000030,79,75,116,75,62,71,47,20,478,67,545,12.293577981651376
8083,330320305000031,46,66,83,57,76,51,29,28,379,57,436,13.073394495412844
8084,330320305000032,67,82,105,90,83,77,59,27,504,86,590,14.576271186440678
8085,330320305000033,102,90,128,116,100,69,54,40,605,94,699,13.447782546494993
8086,330320305000034,54,80,91,71,67,71,52,29,434,81,515,15.728155339805825
8087,330320305000035,95,119,147,113,113,92,71,63,679,134,813,16.482164821648215
8088,330320305000036,51,74,79,70,72,81,37,26,427,63,490,12.857142857142858
8089,330320305000037,71,93,64,101,88,76,43,26,493,69,562,12.277580071174377
8090,330320305000038,82,93,109,123,102,82,62,38,591,100,691,14.47178002894356
8091,330320305000039,63,98,91,84,79,57,38,40,472,78,550,14.181818181818182
8092,330320305000040,56,73,63,70,48,53,25,15,363,40,403,9.925558312655086
8093,330320305000041,79,113,107,96,115,82,42,46,592,88,680,12.941176470588236
8094,330320305000042,74,106,99,95,89,51,32,17,514,49,563,8.703374777975133
8095,330320305000043,43,75,56,55,61,42,29,25,332,54,386,13.989637305699482
8096,330320305000044,63,104,132,116,106,74,38,37,595,75,670,11.194029850746269
8097,330320305000045,91,107,114,103,101,73,47,34,589,81,670,12.08955223880597
8098,330320305000046,42,51,73,64,60,57,50,36,347,86,433,19.861431870669747
8099,330320305000047,108,92,126,118,92,81,55,49,617,104,721,14.424410540915396
8100,330320305000048,86,92,107,109,78,71,47,36,543,83,626,13.258785942492013
8101,330320305000049,63,88,71,57,64,52,17,16,395,33,428,7.710280373831775
8102,330320305000050,167,214,216,166,153,119,71,41,1035,112,1147,9.76460331299041
8103,330320305000051,63,83,72,78,71,54,33,24,421,57,478,11.92468619246862
8104,330320305000052,148,192,157,167,107,72,38,20,843,58,901,6.437291897891232
8105,330320305000053,113,127,94,112,89,72,47,31,607,78,685,11.386861313868613
8106,330320305000054,124,123,133,135,94,84,49,31,693,80,773,10.349288486416558
8107,330320305000055,77,84,86,75,69,62,27,21,453,48,501,9.580838323353293
8108,330320305000056,32,37,39,38,53,35,35,23,234,58,292,19.863013698630137
8109,330320305000057,113,140,152,131,119,117,62,50,772,112,884,12.669683257918551
8110,330320305000058,89,129,119,84,96,69,36,47,586,83,669,12.406576980568012
8111,330320305000059,184,165,179,142,127,88,51,40,885,91,976,9.323770491803279
8112,330320305000060,67,119,122,99,77,84,41,40,568,81,649,12.480739599383668
8113,330320305000061,102,107,138,100,115,71,32,27,633,59,692,8.526011560693641
8114,330320305000062,128,118,153,146,109,93,59,33,747,92,839,10.96543504171633
8115,330320305000063,95,134,97,110,98,69,46,37,603,83,686,12.099125364431487
8116,330320305000064,128,168,155,142,148,127,72,52,868,124,992,12.5
8117,330320305000065,223,171,236,183,161,103,55,39,1077,94,1171,8.02732707087959
8118,330320305000066,158,171,149,130,135,110,51,52,853,103,956,10.774058577405858
8119,330320305000067,64,65,92,84,70,58,47,25,433,72,505,14.257425742574258
8120,330320305000068,71,119,113,101,100,77,59,49,581,108,689,15.67489114658926
8121,330320305000069,95,106,109,111,90,79,56,48,590,104,694,14.985590778097983
8122,330320305000070,63,80,85,74,65,63,36,25,430,61,491,12.423625254582484
8123,330320305000071,91,103,124,134,95,73,70,44,620,114,734,15.53133514986376
8124,330320305000072,66,95,97,108,103,111,57,41,580,98,678,14.454277286135694
8125,330320305000073,85,108,133,134,103,85,48,49,648,97,745,13.020134228187919
8126,330320305000074,102,132,164,145,105,129,82,64,777,146,923,15.817984832069339
8127,330320305000075,65,92,75,75,81,62,40,41,450,81,531,15.254237288135593
8128,330320305000076,84,99,90,111,105,107,56,55,596,111,707,15.700141442715701
8129,330320305000077,103,147,150,127,137,58,63,44,722,107,829,12.907117008443908
8130,330320305000078,72,98,124,108,105,88,37,32,595,69,664,10.391566265060241
8131,330320305000079,85,99,98,96,81,73,43,33,532,76,608,12.5
8132,330320305000080,70,92,94,93,71,65,54,36,485,90,575,15.652173913043478
8133,330320305000081,76,92,98,106,87,85,58,38,544,96,640,15.0
8134,330320305000082,53,64,68,65,62,93,31,29,405,60,465,12.903225806451612
8135,330320305000083,128,157,148,159,122,133,78,47,847,125,972,12.860082304526749
8136,330320305000084,27,45,66,47,81,54,36,26,320,62,382,16.230366492146597
8137,330320305000085,70,99,119,101,94,92,58,46,575,104,679,15.316642120765833
8138,330320305000086,63,68,73,78,74,67,43,25,423,68,491,13.84928716904277
8139,330320305000087,58,106,79,94,108,59,35,23,504,58,562,10.320284697508896
8140,330320305000088,109,114,122,133,87,75,60,39,640,99,739,13.396481732070365
8141,330320305000089,62,69,100,81,74,73,30,34,459,64,523,12.237093690248566
8142,330320305000090,63,63,71,75,67,57,34,20,396,54,450,12.0
8143,330320305000091,70,70,84,109,75,90,54,44,498,98,596,16.44295302013423
8144,330320305000092,43,78,71,83,84,84,57,62,443,119,562,21.17437722419929
8145,330320305000093,98,118,179,148,146,132,73,69,821,142,963,14.74558670820353
8146,330320305000094,56,75,58,58,79,52,41,23,378,64,442,14.479638009049774
8147,330320305000095,65,91,112,100,91,100,45,46,559,91,650,14.0
8148,330320305000096,53,67,74,70,70,59,28,28,393,56,449,12.47216035634744
8149,330320305000097,83,107,114,127,140,116,71,49,687,120,807,14.869888475836431
8150,330320305000098,41,59,82,67,63,102,45,36,414,81,495,16.363636363636363
8151,330320305000099,80,108,87,117,120,96,56,60,608,116,724,16.022099447513813
8152,330320305000100,129,121,103,133,112,109,77,54,707,131,838,15.632458233890215
8153,330320305000101,94,83,102,93,86,71,48,27,529,75,604,12.417218543046358
8154,330320305000102,61,78,111,83,80,98,48,53,511,101,612,16.50326797385621
8155,330320305000103,41,50,73,59,66,47,30,31,336,61,397,15.365239294710328
8156,330320305000104,103,123,116,154,119,111,83,50,726,133,859,15.48311990686845
8157,330320305000105,63,73,90,72,79,62,48,31,439,79,518,15.250965250965251
8158,330320305000106,135,139,150,163,164,128,81,78,879,159,1038,15.31791907514451
8159,330320305000107,58,77,113,94,74,83,44,27,499,71,570,12.456140350877194
8160,330320305000108,88,102,105,101,87,68,39,44,551,83,634,13.091482649842272
8161,330320305000109,85,77,86,89,74,66,34,33,477,67,544,12.316176470588236
8162,330320305000110,76,130,143,122,120,105,53,36,696,89,785,11.337579617834395
8163,330320305000111,81,121,109,118,118,69,46,36,616,82,698,11.74785100286533
8164,330320305000112,56,89,77,78,79,53,47,29,432,76,508,14.960629921259843
8165,330320305000113,52,71,80,70,47,67,25,17,387,42,429,9.79020979020979
8166,330320305000114,74,110,100,109,105,86,59,39,584,98,682,14.36950146627566
8167,330320305000115,116,117,156,143,109,111,74,59,752,133,885,15.028248587570621
8168,330320305000116,147,202,217,149,126,118,55,67,959,122,1081,11.285846438482887
8169,330320305000117,79,92,101,81,94,93,41,33,540,74,614,12.052117263843648
8170,330320305000118,63,73,77,86,83,63,32,35,445,67,512,13.0859375
8171,330320305000119,63,116,126,95,120,85,54,38,605,92,697,13.199426111908178
8172,330320305000120,104,125,120,127,110,89,69,44,675,113,788,14.34010152284264
8173,330320305000121,47,57,65,53,58,43,29,18,323,47,370,12.702702702702704
8174,330320305000122,103,130,142,114,116,119,64,43,724,107,831,12.876052948255115
8175,330320305000123,106,158,131,139,107,97,58,42,738,100,838,11.933174224343675
8176,330320305000124,80,72,78,86,63,77,36,19,456,55,511,10.76320939334638
8177,330320305000125,111,104,63,93,69,56,37,29,496,66,562,11.743772241992882
8178,330320305000126,69,86,86,82,86,66,42,19,475,61,536,11.380597014925373
8179,330320305000127,75,93,110,79,62,82,33,23,501,56,557,10.053859964093357
8180,330320305000128,73,114,89,90,99,78,48,35,543,83,626,13.258785942492013
8181,330320305000129,83,119,117,94,106,62,35,44,581,79,660,11.969696969696969
8182,330320305000130,69,79,79,74,58,77,26,34,436,60,496,12.096774193548388
8183,330320305000131,43,70,78,75,69,62,33,27,397,60,457,13.12910284463895
8184,330320305000132,75,98,126,117,92,99,33,39,607,72,679,10.603829160530191
8185,330320305000133,67,91,79,71,67,58,22,22,433,44,477,9.224318658280922
8186,330320305000134,68,86,96,72,74,65,37,28,461,65,526,12.357414448669202
8187,330320305000135,96,136,132,109,121,105,57,49,699,106,805,13.167701863354038
8188,330320305000136,80,89,99,94,72,66,38,24,500,62,562,11.03202846975089
8189,330320305000138,54,60,73,73,65,74,26,44,399,70,469,14.925373134328359
8190,330320305000139,63,64,83,76,80,69,38,38,435,76,511,14.87279843444227
8191,330320305000140,75,73,103,62,67,77,25,36,457,61,518,11.776061776061775
8192,330320305000141,64,77,91,62,81,59,19,22,434,41,475,8.631578947368421
8193,330320305000142,83,81,116,91,80,77,46,28,528,74,602,12.29235880398671
8194,330320305000143,66,84,86,74,81,58,42,34,449,76,525,14.476190476190476
8195,330320305000144,57,68,63,60,80,53,41,24,381,65,446,14.573991031390134
8196,330320305000145,92,94,95,96,98,55,39,26,530,65,595,10.92436974789916
8197,330320305000146,58,62,85,51,52,58,26,26,366,52,418,12.440191387559809
8198,330320305000147,57,67,68,58,65,37,24,22,352,46,398,11.557788944723619
8199,330320305000148,63,71,67,76,75,57,41,32,409,73,482,15.145228215767634
8200,330320305000149,73,105,98,90,101,79,27,17,546,44,590,7.4576271186440675
8201,330320305000150,45,57,53,56,55,41,34,19,307,53,360,14.722222222222221
8202,330320305000151,32,49,62,67,60,43,14,11,313,25,338,7.396449704142012
8203,330320305000152,24,37,43,34,44,32,27,35,214,62,276,22.463768115942027
8204,330320305000153,45,68,75,58,74,63,45,41,383,86,469,18.33688699360341
8205,330320305000154,36,51,55,66,63,69,45,37,340,82,422,19.43127962085308
8206,330320305000155,33,34,43,29,30,33,13,16,202,29,231,12.554112554112555
8207,330320305000156,50,60,60,61,52,44,29,29,327,58,385,15.064935064935066
8208,330320305000157,54,72,97,100,92,60,22,20,475,42,517,8.123791102514506
8209,330320305000158,66,70,56,61,56,39,23,23,348,46,394,11.6751269035533
8210,330320305000159,41,60,70,66,51,52,26,32,340,58,398,14.57286432160804
8211,330320305000160,69,93,104,80,84,88,39,34,518,73,591,12.351945854483926
8212,330320305000161,64,72,62,63,56,43,32,21,360,53,413,12.832929782082324
8213,330320305000162,34,46,68,59,61,48,40,20,316,60,376,15.957446808510639
8214,330320305000163,45,72,74,70,68,69,26,28,398,54,452,11.946902654867257
8215,330320305000164,67,72,71,92,58,90,47,30,450,77,527,14.61100569259962
8216,330320305000165,40,60,68,75,70,52,43,24,365,67,432,15.50925925925926
8217,330320305000166,51,98,85,79,73,56,45,35,442,80,522,15.32567049808429
8218,330320305000167,27,52,33,56,49,48,21,31,265,52,317,16.40378548895899
8219,330320305000168,36,54,41,45,50,46,29,19,272,48,320,15.0
8220,330320305000169,46,46,51,53,50,46,21,14,292,35,327,10.703363914373089
8221,330320305000170,57,80,108,94,83,72,49,25,494,74,568,13.028169014084508
8222,330320305000171,74,80,95,67,103,82,42,37,501,79,580,13.620689655172415
8223,330320305000172,101,117,91,91,83,52,31,21,535,52,587,8.858603066439523
8224,330320305000173,33,45,49,42,39,35,21,16,243,37,280,13.214285714285714
8225,330320305000174,85,88,76,96,65,66,49,26,476,75,551,13.611615245009075
8226,330320305000175,101,84,83,72,60,33,17,11,433,28,461,6.073752711496746
8227,330320310000001,22,38,46,37,52,43,37,31,238,68,306,22.22222222222222
8228,330320310000002,70,90,80,83,78,75,49,40,476,89,565,15.752212389380531
8229,330320310000003,56,50,68,56,41,47,26,24,318,50,368,13.58695652173913
8230,330320310000004,53,79,77,61,53,69,33,21,392,54,446,12.10762331838565
8231,330320310000005,35,35,51,45,46,46,38,32,258,70,328,21.341463414634145
8232,330320310000006,68,67,77,88,74,63,44,39,437,83,520,15.961538461538462
8233,330320310000007,72,98,77,82,77,58,31,24,464,55,519,10.597302504816955
8234,330320310000008,67,88,111,114,83,89,75,56,552,131,683,19.1800878477306
8235,330320310000009,87,72,61,68,35,26,16,11,349,27,376,7.180851063829787
8236,330320310000010,47,48,60,69,64,47,35,28,335,63,398,15.829145728643216
8237,330320310000011,69,76,79,82,75,72,46,39,453,85,538,15.799256505576208
8238,330320310000012,71,59,97,101,75,92,56,52,495,108,603,17.91044776119403
8239,330320310000013,53,60,78,67,71,60,53,51,389,104,493,21.095334685598377
8240,330320310000014,100,98,149,129,120,114,56,45,710,101,811,12.453760789149198
8241,330320310000015,100,105,113,114,86,106,80,34,624,114,738,15.447154471544716
8242,330320310000016,37,48,63,51,52,56,30,30,307,60,367,16.348773841961854
8243,330320310000017,73,82,92,92,85,93,61,54,517,115,632,18.196202531645568
8244,330320310000018,105,137,134,124,137,109,66,58,746,124,870,14.25287356321839
8245,330320310000019,68,56,97,81,76,60,30,23,438,53,491,10.79429735234216
8246,330320310000020,79,135,91,109,114,75,67,67,603,134,737,18.181818181818183
8247,330320310000021,63,78,81,53,58,54,21,24,387,45,432,10.416666666666666
8248,330320310000022,123,137,135,118,92,105,48,32,710,80,790,10.126582278481013
8249,330320310000023,97,109,113,131,84,92,54,47,626,101,727,13.89270976616231
8250,330320310000024,64,106,117,97,95,95,47,40,574,87,661,13.161875945537066
8251,330320310000025,69,85,89,94,91,68,42,37,496,79,575,13.73913043478261
8252,330320310000026,70,90,98,82,60,71,31,29,471,60,531,11.299435028248588
8253,330320310000027,167,214,126,157,121,91,51,36,876,87,963,9.034267912772586
8254,330320310000028,131,143,137,119,86,69,46,35,685,81,766,10.574412532637076
8255,330320310000029,275,306,257,189,139,96,56,23,1262,79,1341,5.891126025354214
8256,330320310000030,62,84,90,67,61,53,28,22,417,50,467,10.70663811563169
8257,330320310000031,127,134,117,124,110,104,46,49,716,95,811,11.713933415536374
8258,330320310000032,72,59,70,57,95,48,37,28,401,65,466,13.948497854077253
8259,330320310000033,95,116,117,110,74,72,32,30,584,62,646,9.597523219814242
8260,330320310000034,95,120,108,93,77,88,28,23,581,51,632,8.069620253164556
8261,330320310000035,135,167,127,134,140,84,53,50,787,103,890,11.573033707865168
8262,330320310000036,113,106,149,204,159,80,43,61,811,104,915,11.366120218579235
8263,330320310000037,135,175,174,168,144,110,59,26,906,85,991,8.577194752774975
8264,330320310000038,65,106,90,79,79,69,36,27,488,63,551,11.433756805807622
8265,330320310000039,109,117,138,110,92,94,40,22,660,62,722,8.587257617728532
8266,330320310000040,113,136,124,114,100,57,31,21,644,52,696,7.471264367816092
8267,330320310000041,119,141,131,111,81,50,30,14,633,44,677,6.499261447562777
8268,330320310000042,80,95,82,73,70,46,25,23,446,48,494,9.7165991902834
8269,330320310000043,108,171,165,166,155,84,44,41,849,85,934,9.100642398286938
8270,330320310000044,118,131,115,140,99,78,52,39,681,91,772,11.787564766839377
8271,330320310000045,59,91,85,98,84,54,33,38,471,71,542,13.099630996309964
8272,330320310000046,105,130,101,104,94,91,37,28,625,65,690,9.420289855072463
8273,330320310000047,98,115,144,155,97,100,66,49,709,115,824,13.95631067961165
8274,330320310000048,79,98,112,108,100,90,56,63,587,119,706,16.855524079320112
8275,330320310000049,80,100,92,96,99,59,32,30,526,62,588,10.54421768707483
8276,330320310000050,46,84,81,55,78,50,33,43,394,76,470,16.170212765957448
8277,330320310000051,69,117,91,80,76,66,36,36,499,72,571,12.609457092819614
8278,330320310000052,80,114,98,111,93,90,46,33,586,79,665,11.8796992481203
8279,330320310000053,105,79,93,92,77,56,36,18,502,54,556,9.712230215827338
8280,330320310000054,88,104,94,111,101,88,63,50,586,113,699,16.165951359084406
8281,330320310000055,92,105,90,120,88,73,37,28,568,65,633,10.268562401263823
8282,330320310000056,99,111,117,118,114,84,48,62,643,110,753,14.608233731739707
8283,330320310000057,54,85,89,94,82,77,60,48,481,108,589,18.33616298811545
8284,330320310000058,145,136,139,187,132,100,86,45,839,131,970,13.505154639175258
8285,330320310000059,51,35,67,65,45,29,24,24,292,48,340,14.117647058823529
8286,330320310000060,130,80,101,108,74,70,38,32,563,70,633,11.058451816745656
8287,330320310000061,74,98,119,118,121,75,64,55,605,119,724,16.43646408839779
8288,330320310000062,73,122,88,108,68,75,39,40,534,79,613,12.887438825448614
8289,330320310000063,72,74,78,90,61,74,42,26,449,68,517,13.152804642166345
8290,330320310000064,143,161,147,138,155,92,80,45,836,125,961,13.007284079084288
8291,330320310000065,28,58,61,63,50,23,16,9,283,25,308,8.116883116883116
8292,330320310000066,112,130,134,160,120,93,58,42,749,100,849,11.778563015312132
8293,330320310000067,116,178,112,156,180,84,44,37,826,81,907,8.930540242557884
8294,330320310000068,78,82,91,86,83,63,39,28,483,67,550,12.181818181818182
8295,330320310000069,69,97,89,99,71,89,48,33,514,81,595,13.61344537815126
8296,330320310000070,61,89,93,73,84,65,39,30,465,69,534,12.92134831460674
8297,330320310000072,46,53,43,68,38,49,38,32,297,70,367,19.07356948228883
8298,330320310000073,90,105,128,96,70,66,30,28,555,58,613,9.461663947797716
8299,330320310000074,91,80,81,91,65,55,46,17,463,63,526,11.977186311787072
8300,330320310000075,119,165,171,153,133,85,67,73,826,140,966,14.492753623188406
8301,330320310000076,50,66,75,81,87,64,36,32,423,68,491,13.84928716904277
8302,330320310000077,62,82,71,58,74,55,35,28,402,63,465,13.548387096774194
8303,330320310000078,66,66,66,80,48,45,27,25,371,52,423,12.293144208037825
8304,330320310000079,59,76,78,58,61,43,34,25,375,59,434,13.59447004608295
8305,330320310000080,81,78,80,81,59,50,38,17,429,55,484,11.363636363636363
8306,330320310000081,39,57,55,62,68,44,26,35,325,61,386,15.803108808290155
8307,330320310000082,45,80,64,62,77,52,26,15,380,41,421,9.738717339667458
8308,330320310000083,44,57,52,61,53,38,28,22,305,50,355,14.084507042253522
8309,330320310000084,67,52,90,59,74,62,35,35,404,70,474,14.767932489451477
8310,330320310000085,39,66,33,52,51,37,29,26,278,55,333,16.516516516516518
8311,330320310000086,53,102,59,67,68,44,26,27,393,53,446,11.883408071748878
8312,330320310000087,115,112,91,76,65,57,34,28,516,62,578,10.726643598615917
8313,330320310000088,77,85,88,76,48,53,24,5,427,29,456,6.359649122807017
8314,330320310000089,78,84,70,72,57,53,23,11,414,34,448,7.589285714285714
8315,330320310000090,38,53,53,76,58,61,34,31,339,65,404,16.08910891089109
8316,330320310000091,66,77,101,78,78,74,36,33,474,69,543,12.707182320441989
8317,330320310000092,40,64,70,53,55,52,25,25,334,50,384,13.020833333333334
8318,330320310000093,41,57,76,70,69,62,30,29,375,59,434,13.59447004608295
8319,330330205000001,212,218,206,204,107,96,48,25,1043,73,1116,6.541218637992832
8320,330330205000002,64,112,94,95,106,63,44,31,534,75,609,12.31527093596059
8321,330330205000003,49,67,93,71,72,53,38,24,405,62,467,13.276231263383298
8322,330330205000004,132,159,196,159,126,143,64,46,915,110,1025,10.731707317073171
8323,330330205000005,97,168,140,148,153,104,70,47,810,117,927,12.62135922330097
8324,330330205000006,141,181,171,166,136,98,54,34,893,88,981,8.970438328236494
8325,330330205000007,104,110,99,110,74,43,24,23,540,47,587,8.006814310051107
8326,330330205000008,192,188,214,167,158,105,48,29,1024,77,1101,6.9936421435059035
8327,330330205000009,154,159,166,147,141,80,65,34,847,99,946,10.465116279069768
8328,330330205000010,20,27,24,35,23,24,10,3,153,13,166,7.831325301204819
8330,330330205000013,145,142,160,163,157,114,83,80,881,163,1044,15.613026819923371
8331,330330205000014,68,72,79,74,58,47,28,20,398,48,446,10.762331838565023
8332,330330205000015,27,49,37,44,47,46,28,20,250,48,298,16.107382550335572
8333,330330205000016,44,21,39,18,4,8,5,5,134,10,144,6.944444444444445
8334,330330205000017,107,103,121,93,102,71,45,46,597,91,688,13.226744186046512
8335,330330205000018,56,56,67,42,54,69,29,27,344,56,400,14.0
8336,330330205000019,87,132,173,121,149,141,65,99,803,164,967,16.959669079627716
8337,330330205000020,55,74,67,85,67,64,32,26,412,58,470,12.340425531914894
8338,330330205000021,134,185,181,135,157,89,38,26,881,64,945,6.772486772486772
8339,330330205000022,25,17,17,15,16,9,6,2,99,8,107,7.4766355140186915
8340,330330205000023,100,144,107,94,88,89,40,25,622,65,687,9.461426491994178
8341,330330205000024,47,51,61,75,69,56,40,26,359,66,425,15.529411764705882
8342,330330205000025,30,57,63,57,46,58,29,24,311,53,364,14.56043956043956
8343,330330205000026,147,164,138,144,123,87,51,31,803,82,885,9.265536723163843
8344,330330205000027,11,9,15,10,4,8,11,9,57,20,77,25.974025974025974
8345,330330205000028,52,58,81,55,60,59,36,28,365,64,429,14.918414918414918
8346,330330205000029,63,86,81,73,46,50,38,24,399,62,461,13.449023861171366
8347,330330205000030,44,62,77,50,52,53,26,34,338,60,398,15.075376884422111
8348,330330205000031,113,154,112,142,121,99,55,36,741,91,832,10.9375
8349,330330205000032,51,84,78,65,64,43,26,30,385,56,441,12.698412698412698
8350,330330205000033,15,21,20,30,30,19,16,9,135,25,160,15.625
8351,330330205000034,65,90,75,86,68,71,39,30,455,69,524,13.16793893129771
8352,330330205000035,100,105,112,90,85,94,50,42,586,92,678,13.569321533923304
8353,330330205000036,32,48,32,35,30,28,16,14,205,30,235,12.76595744680851
8354,330330205000037,106,125,113,110,100,85,28,17,639,45,684,6.578947368421052
8355,330330205000038,80,139,113,117,101,85,52,23,635,75,710,10.56338028169014
8356,330330205000039,34,51,30,56,33,31,29,20,235,49,284,17.253521126760564
8357,330330205000040,136,163,193,171,170,153,98,69,986,167,1153,14.48395490026019
8358,330330205000041,71,98,97,96,112,87,71,69,561,140,701,19.971469329529246
8359,330330205000042,108,156,168,156,180,111,74,58,879,132,1011,13.056379821958457
8360,330330205000043,73,90,97,107,103,59,58,34,529,92,621,14.814814814814815
8361,330330205000044,92,107,134,106,119,83,51,55,641,106,747,14.190093708165998
8362,330330205000045,154,193,203,205,175,157,88,60,1087,148,1235,11.983805668016194
8363,330330205000046,77,94,84,98,96,76,48,39,525,87,612,14.215686274509803
8364,330330205000047,93,109,147,134,118,116,97,81,717,178,895,19.88826815642458
8365,330330205000048,26,46,45,36,52,47,17,22,252,39,291,13.402061855670103
8366,330330205000049,93,141,166,172,159,125,104,62,856,166,1022,16.2426614481409
8367,330330205000050,117,144,182,155,132,113,53,41,843,94,937,10.032017075773746
8368,330330205000051,54,63,69,62,65,58,47,18,371,65,436,14.908256880733944
8370,330330205000053,75,85,111,101,96,86,46,45,554,91,645,14.108527131782946
8371,330330205000054,47,67,71,68,54,31,10,9,338,19,357,5.322128851540616
8372,330330205000055,66,80,94,93,111,95,68,52,539,120,659,18.20940819423369
8373,330330205000056,112,121,139,137,166,157,69,49,832,118,950,12.421052631578947
8374,330330205000057,49,68,87,85,107,108,76,39,504,115,619,18.578352180936996
8375,330330205000058,112,172,123,145,167,168,79,71,887,150,1037,14.46480231436837
8376,330330205000059,141,164,140,191,152,96,53,42,884,95,979,9.703779366700715
8377,330330205000060,41,67,64,64,75,60,42,36,371,78,449,17.37193763919822
8378,330330205000061,128,156,166,174,158,119,82,63,901,145,1046,13.862332695984703
8379,330330205000062,135,182,167,154,151,97,62,49,886,111,997,11.133400200601805
8380,330330205000063,157,175,196,160,175,112,71,50,975,121,1096,11.040145985401459
8381,330330205000064,130,171,168,132,112,106,34,24,819,58,877,6.61345496009122
8382,330330205000065,187,187,201,165,155,96,60,28,991,88,1079,8.155699721964782
8383,330330205000066,48,62,69,73,74,69,43,42,395,85,480,17.708333333333332
8384,330330205000067,74,95,113,114,107,103,86,45,606,131,737,17.774762550881952
8385,330330205000068,114,137,192,120,142,140,69,41,845,110,955,11.518324607329843
8386,330330205000069,82,101,158,108,156,154,78,79,759,157,916,17.139737991266376
8387,330330205000070,61,101,124,82,97,119,60,38,584,98,682,14.36950146627566
8388,330330205000071,123,151,137,157,103,37,31,17,708,48,756,6.349206349206349
8389,330330205000072,146,189,169,274,155,123,65,31,1056,96,1152,8.333333333333334
8390,330330205000073,19,26,20,21,42,28,6,9,156,15,171,8.771929824561404
8391,330330205000074,82,101,136,134,124,84,44,18,661,62,723,8.575380359612724
8392,330330205000075,107,147,161,142,132,124,64,33,813,97,910,10.659340659340659
8393,330330205000076,110,136,128,134,81,47,32,14,636,46,682,6.744868035190616
8394,330330205000077,77,81,74,76,68,56,36,25,432,61,493,12.373225152129818
8395,330330205000078,67,81,84,81,81,62,30,21,456,51,507,10.059171597633137
8396,330330205000079,36,55,42,37,79,44,17,18,293,35,328,10.670731707317072
8397,330330205000080,83,110,113,124,107,85,49,34,622,83,705,11.77304964539007
8398,330330205000081,51,56,59,48,29,36,15,7,279,22,301,7.308970099667774
8399,330330205000082,49,35,45,62,35,53,22,17,279,39,318,12.264150943396226
8400,330330205000083,153,261,224,190,230,125,53,38,1183,91,1274,7.142857142857143
8401,330330205000084,123,117,132,157,103,91,57,34,723,91,814,11.17936117936118
8402,330330205000085,74,146,98,117,103,99,55,56,637,111,748,14.83957219251337
8403,330330205000086,99,133,111,96,86,80,23,25,605,48,653,7.3506891271056665
8404,330330205000087,66,83,90,80,76,82,47,41,477,88,565,15.575221238938052
8405,330330205000088,86,101,107,122,106,82,53,38,604,91,695,13.093525179856115
8406,330330205000089,12,14,14,16,20,9,6,7,85,13,98,13.26530612244898
8407,330330205000090,143,154,165,165,145,120,46,41,892,87,979,8.88661899897855
8408,330330205000091,88,90,75,62,37,23,9,2,375,11,386,2.849740932642487
8409,330330205000092,64,65,113,104,94,101,75,69,541,144,685,21.021897810218977
8410,330330205000093,54,96,90,98,93,112,47,47,543,94,637,14.756671899529042
8411,330330205000094,41,60,77,84,75,77,65,65,414,130,544,23.897058823529413
8412,330330205000095,90,140,102,106,80,61,29,22,579,51,630,8.095238095238095
8413,330330205000096,52,68,112,98,110,118,81,81,558,162,720,22.5
8414,330330205000097,64,76,145,122,145,142,118,114,694,232,926,25.053995680345572
8415,330330205000098,86,82,118,162,150,120,125,140,718,265,983,26.95829094608342
8416,330330205000099,51,84,100,84,102,96,68,54,517,122,639,19.092331768388107
8417,330330205000100,63,77,106,112,112,127,101,117,597,218,815,26.74846625766871
8418,330330205000101,32,65,114,60,77,73,56,61,421,117,538,21.74721189591078
8419,330330205000102,49,57,109,97,102,106,87,116,520,203,723,28.077455048409405
8420,330330205000103,28,41,59,39,77,55,50,62,299,112,411,27.25060827250608
8421,330330205000104,54,108,111,91,106,120,96,123,590,219,809,27.07045735475896
8422,330330205000105,63,103,126,128,157,135,95,165,712,260,972,26.74897119341564
8423,330330205000106,40,76,98,103,107,88,69,73,512,142,654,21.712538226299696
8424,330330205000107,92,111,157,138,124,140,84,84,762,168,930,18.06451612903226
8425,330330205000108,16,18,31,23,38,40,15,34,166,49,215,22.790697674418606
8426,330330205000109,70,101,98,94,97,61,42,26,521,68,589,11.544991511035654
8427,330330205000110,88,98,129,85,84,88,39,23,572,62,634,9.779179810725552
8428,330330205000111,133,187,137,112,120,77,45,28,766,73,839,8.700834326579262
8429,330330205000112,83,123,82,79,53,48,18,10,468,28,496,5.645161290322581
8430,330330205000113,37,60,43,47,39,17,17,9,243,26,269,9.66542750929368
8431,330330205000114,74,105,85,63,76,45,32,15,448,47,495,9.494949494949495
8432,330330205000115,66,93,93,80,87,62,44,24,481,68,549,12.386156648451731
8433,330330205000116,248,295,282,308,262,208,105,87,1603,192,1795,10.696378830083566
8434,330330205000117,60,74,103,83,116,78,75,45,514,120,634,18.92744479495268
8435,330330205000118,117,114,148,142,131,116,82,66,768,148,916,16.157205240174672
8436,330330205000119,56,105,87,85,117,79,52,40,529,92,621,14.814814814814815
8437,330330205000120,54,77,92,82,88,91,61,73,484,134,618,21.68284789644013
8438,330330205000121,83,106,91,92,68,41,29,18,481,47,528,8.901515151515152
8439,330330205000122,87,82,110,83,80,77,51,50,519,101,620,16.29032258064516
8440,330330205000123,88,159,123,136,130,100,81,55,736,136,872,15.596330275229358
8441,330330205000124,46,47,63,73,75,83,47,40,387,87,474,18.354430379746834
8442,330330205000125,139,209,184,174,149,75,37,19,930,56,986,5.679513184584178
8443,330330205000126,200,252,249,263,171,108,57,21,1243,78,1321,5.904617713853142
8444,330330205000127,338,405,442,278,244,153,64,46,1860,110,1970,5.583756345177665
8445,330330205000128,84,114,105,97,84,66,29,23,550,52,602,8.637873754152825
8446,330330205000129,107,137,117,115,75,62,31,21,613,52,665,7.819548872180451
8447,330330205000130,17,40,36,44,25,14,22,8,176,30,206,14.563106796116505
8448,330330205000131,48,38,52,85,66,30,19,8,319,27,346,7.803468208092486
8449,330330205000132,47,39,46,80,51,34,18,10,297,28,325,8.615384615384615
8450,330330205000133,19,21,62,37,33,41,29,24,213,53,266,19.924812030075188
8451,330330205000134,29,17,47,43,27,56,19,22,219,41,260,15.76923076923077
8452,330330205000135,1,8,7,3,2,12,4,2,33,6,39,15.384615384615385
8453,330330205000136,112,166,140,119,123,111,45,41,771,86,857,10.035005834305718
8454,330330205000137,30,37,41,38,45,50,21,32,241,53,294,18.027210884353742
8455,330330205000138,86,115,142,142,132,96,79,74,713,153,866,17.66743648960739
8456,330330205000139,25,48,63,49,51,36,25,33,272,58,330,17.575757575757574
8457,330330205000140,53,67,67,76,60,42,21,25,365,46,411,11.19221411192214
8458,330330205000141,77,121,132,130,165,117,69,63,742,132,874,15.102974828375286
8459,330330205000142,54,64,136,142,104,125,101,108,625,209,834,25.059952038369303
8460,330330205000143,50,75,127,88,104,133,83,57,577,140,717,19.525801952580196
8461,330330205000144,32,77,76,57,84,95,57,72,421,129,550,23.454545454545453
8462,330330205000145,34,63,115,109,94,103,74,113,518,187,705,26.52482269503546
8463,330330205000146,29,43,80,57,68,70,43,55,347,98,445,22.02247191011236
8464,330330205000147,91,138,143,138,176,141,87,66,827,153,980,15.612244897959183
8465,330330205000148,50,41,72,92,59,48,28,24,362,52,414,12.560386473429952
8466,330330205000149,40,54,123,77,66,88,39,24,448,63,511,12.32876712328767
8467,330330205000150,33,57,148,112,71,83,51,16,504,67,571,11.733800350262698
8468,330330205000151,60,84,112,123,100,121,86,75,600,161,761,21.156373193166885
8469,330330205000152,31,45,108,57,62,103,40,59,406,99,505,19.603960396039604
8470,330330205000153,72,60,77,102,96,72,67,68,479,135,614,21.98697068403909
8471,330330205000154,41,38,53,63,64,54,52,49,313,101,414,24.396135265700483
8472,330330205000155,86,77,149,111,129,132,73,65,684,138,822,16.78832116788321
8473,330330205000156,46,77,109,108,85,120,69,111,545,180,725,24.82758620689655
8474,330330205000157,91,78,97,146,115,134,58,65,661,123,784,15.688775510204081
8475,330330205000158,40,27,75,92,63,62,37,48,359,85,444,19.144144144144143
8476,330330205000159,14,31,40,29,36,40,19,29,190,48,238,20.168067226890756
8477,330330205000160,36,60,91,71,79,99,55,59,436,114,550,20.727272727272727
8478,330330205000161,101,86,113,156,138,106,77,76,700,153,853,17.936694021101992
8479,330330205000162,77,66,122,114,122,126,53,64,627,117,744,15.725806451612904
8480,330330205000163,131,123,129,177,161,114,79,49,835,128,963,13.291796469366563
8481,330330205000164,32,42,70,60,44,75,48,49,323,97,420,23.095238095238095
8482,330330205000165,205,220,182,251,153,94,100,57,1105,157,1262,12.440570522979398
8483,330330205000166,53,71,101,108,98,98,48,37,529,85,614,13.843648208469055
8484,330330205000167,87,167,98,109,108,71,29,15,640,44,684,6.432748538011696
8485,330330205000168,134,177,180,146,136,98,61,56,871,117,988,11.842105263157896
8486,330330205000169,27,47,77,69,72,80,63,75,372,138,510,27.058823529411764
8487,330330205000170,39,64,126,83,84,93,68,80,489,148,637,23.233908948194664
8488,330330205000171,33,38,39,23,20,12,6,3,165,9,174,5.172413793103448
8489,330330205000172,40,51,90,72,70,92,55,57,415,112,527,21.25237191650854
8490,330330205000173,21,38,93,66,69,77,59,77,364,136,500,27.2
8491,330330205000174,24,46,111,49,55,106,54,37,391,91,482,18.87966804979253
8492,330330205000175,77,61,141,151,94,116,80,62,640,142,782,18.15856777493606
8493,330330205000176,50,56,94,100,84,104,84,48,488,132,620,21.29032258064516
8494,330330205000177,49,72,131,98,114,125,118,100,589,218,807,27.01363073110285
8495,330330205000178,50,65,114,91,109,105,86,143,534,229,763,30.013106159895152
8496,330330205000179,95,101,148,163,140,151,107,117,798,224,1022,21.91780821917808
8497,330330205000180,12,15,82,37,31,58,46,52,235,98,333,29.42942942942943
8498,330330205000181,22,50,88,66,62,72,73,93,360,166,526,31.55893536121673
8499,330330205000182,12,26,32,33,25,39,48,77,167,125,292,42.80821917808219
8500,330330205000183,34,63,127,101,91,97,74,93,513,167,680,24.558823529411764
8501,330330205000184,36,49,105,86,77,119,78,159,472,237,709,33.42736248236953
8502,330330205000185,8,20,66,34,27,55,42,91,210,133,343,38.775510204081634
8503,330330205000186,41,66,116,81,100,102,109,123,506,232,738,31.43631436314363
8504,330330205000187,46,79,106,76,110,108,102,179,525,281,806,34.86352357320099
8505,330330205000188,39,55,116,60,75,114,77,120,459,197,656,30.03048780487805
8506,330330205000189,38,79,106,78,104,121,107,138,526,245,771,31.7769130998703
8507,330330205000190,40,69,132,80,109,125,107,167,555,274,829,33.0518697225573
8508,330330205000191,28,38,71,53,64,65,88,132,319,220,539,40.816326530612244
8509,330330205000192,34,64,101,58,82,105,113,154,444,267,711,37.552742616033754
8510,330330205000193,27,40,74,46,70,72,73,120,329,193,522,36.97318007662835
8511,330330205000194,39,68,99,79,87,107,107,156,479,263,742,35.44474393530997
8512,330330205000195,43,53,134,91,74,123,90,161,518,251,769,32.63979193758127
8513,330330205000196,30,47,44,51,62,28,25,46,262,71,333,21.32132132132132
8514,330330205000197,34,82,92,72,87,95,119,155,462,274,736,37.22826086956522
8515,330330205000198,40,58,102,75,100,108,111,210,483,321,804,39.92537313432836
8516,330330205000199,26,66,145,83,79,125,116,141,524,257,781,32.90653008962868
8517,330330205000200,30,50,83,47,44,76,53,74,330,127,457,27.789934354485776
8518,330330205000201,34,59,81,86,79,94,70,136,433,206,639,32.237871674491394
8519,330330205000202,50,77,78,82,88,124,49,67,499,116,615,18.86178861788618
8520,330330205000203,44,48,72,74,62,75,58,82,375,140,515,27.184466019417474
8521,330330205000204,19,32,61,46,33,55,34,42,246,76,322,23.60248447204969
8522,330330205000205,21,58,89,63,64,101,96,126,396,222,618,35.922330097087375
8523,330330205000206,48,53,72,50,62,91,68,68,376,136,512,26.5625
8524,330330205000207,41,43,83,60,66,74,38,51,367,89,456,19.517543859649123
8525,330330205000208,44,56,89,77,97,69,56,99,432,155,587,26.405451448040886
8526,330330205000209,64,121,131,82,127,129,68,100,654,168,822,20.437956204379564
8527,330330205000210,28,56,82,74,75,69,53,66,384,119,503,23.658051689860834
8528,330330205000211,27,33,83,43,35,83,60,67,304,127,431,29.466357308584687
8529,330330205000212,31,50,79,47,63,86,65,75,356,140,496,28.225806451612904
8530,330330205000213,23,52,110,81,70,85,100,118,421,218,639,34.11580594679186
8531,330330205000214,14,28,69,28,30,43,43,50,212,93,305,30.491803278688526
8532,330330205000215,51,74,151,96,89,122,99,131,583,230,813,28.290282902829027
8533,330330205000216,30,36,87,72,53,82,74,85,360,159,519,30.63583815028902
8534,330330205000217,20,45,68,53,63,61,70,98,310,168,478,35.14644351464435
8535,330330205000218,25,30,72,59,52,87,60,87,325,147,472,31.14406779661017
8536,330330205000219,26,32,68,60,62,49,60,126,297,186,483,38.50931677018634
8537,330330205000220,25,47,84,57,74,81,56,100,368,156,524,29.770992366412212
8538,330330205000221,33,47,80,51,60,85,75,140,356,215,571,37.65323992994746
8539,330330205000222,16,35,103,65,50,66,62,86,335,148,483,30.641821946169774
8540,330330205000223,37,64,111,62,97,123,80,148,494,228,722,31.57894736842105
8541,330330205000224,38,69,109,77,83,95,88,125,471,213,684,31.140350877192983
8542,330330205000225,7,13,60,27,45,58,30,37,210,67,277,24.187725631768952
8543,330330205000226,20,23,58,60,33,48,63,60,242,123,365,33.6986301369863
8544,330330205000227,38,64,109,78,58,113,92,105,460,197,657,29.984779299847794
8545,330330205000228,25,33,77,44,58,65,59,58,302,117,419,27.9236276849642
8546,330330205000229,44,57,125,103,86,119,90,94,534,184,718,25.62674094707521
8547,330330205000230,27,25,91,63,44,72,59,62,322,121,443,27.313769751693002
8548,330330205000231,56,58,123,103,103,93,82,71,536,153,689,22.206095791001452
8549,330330205000232,45,42,110,98,79,63,54,64,437,118,555,21.26126126126126
8550,330330205000233,47,42,87,108,75,73,76,69,432,145,577,25.12998266897747
8551,330330205000234,44,60,124,109,77,108,98,114,522,212,734,28.88283378746594
8552,330330205000235,18,32,57,35,43,63,38,52,248,90,338,26.62721893491124
8553,330330205000236,41,62,121,68,100,118,60,85,510,145,655,22.137404580152673
8554,330330205000237,45,46,77,93,74,80,56,51,415,107,522,20.49808429118774
8555,330330205000238,28,52,106,63,69,91,67,74,409,141,550,25.636363636363637
8556,330330205000239,18,28,60,38,41,49,35,45,234,80,314,25.477707006369428
8557,330330205000240,28,56,91,78,79,80,91,88,412,179,591,30.287648054145517
8558,330330205000241,19,27,56,53,41,62,71,83,258,154,412,37.37864077669903
8559,330330205000242,19,37,65,47,59,58,34,72,285,106,391,27.10997442455243
8560,330330205000243,36,55,87,59,59,79,48,52,375,100,475,21.05263157894737
8561,330330205000244,29,47,40,66,55,46,111,115,283,226,509,44.4007858546169
8562,330330205000245,26,28,66,49,54,65,50,84,288,134,422,31.753554502369667
8563,330330205000246,45,76,120,112,111,124,88,74,588,162,750,21.6
8564,330330205000247,31,64,93,78,67,71,70,76,404,146,550,26.545454545454547
8565,330330205000248,10,19,34,26,32,17,31,36,138,67,205,32.68292682926829
8566,330330205000249,43,62,98,90,85,83,93,110,461,203,664,30.572289156626507
8567,330330205000250,32,41,93,72,49,72,70,68,359,138,497,27.766599597585515
8568,330330205000251,29,57,83,59,76,50,51,86,354,137,491,27.90224032586558
8569,330330205000252,13,32,73,38,43,46,51,83,245,134,379,35.35620052770449
8570,330330205000253,53,86,97,86,105,104,63,90,531,153,684,22.36842105263158
8571,330330205000254,24,43,77,45,66,62,60,81,317,141,458,30.786026200873362
8572,330330205000255,55,61,85,85,76,79,61,57,441,118,559,21.10912343470483
8573,330330205000256,30,49,72,49,68,51,65,82,319,147,466,31.545064377682404
8574,330330205000257,32,60,102,92,81,80,89,124,447,213,660,32.27272727272727
8575,330330205000258,23,61,99,56,82,84,67,69,405,136,541,25.138632162661736
8576,330330205000259,5,14,42,26,30,42,31,58,159,89,248,35.88709677419355
8577,330330205000260,22,24,69,48,49,41,53,101,253,154,407,37.83783783783784
8578,330330205000261,15,29,41,40,44,39,45,66,208,111,319,34.79623824451411
8579,330330205000262,23,33,65,60,53,73,65,69,307,134,441,30.385487528344672
8580,330330205000263,47,62,94,79,77,99,69,84,458,153,611,25.04091653027823
8581,330330205000264,28,53,59,52,88,67,76,123,347,199,546,36.446886446886445
8582,330330205000265,45,47,109,75,66,115,83,96,457,179,636,28.144654088050313
8583,330330205000266,21,20,80,71,67,61,42,41,320,83,403,20.595533498759306
8584,330330205000267,89,106,126,138,113,136,80,87,708,167,875,19.085714285714285
8585,330330205000268,73,88,122,148,144,130,97,100,705,197,902,21.840354767184035
8586,330330205000269,66,98,67,88,64,38,22,14,421,36,457,7.87746170678337
8587,330330205000270,116,108,111,159,105,105,83,62,704,145,849,17.078916372202592
8588,330330205000271,68,91,52,66,37,26,18,18,340,36,376,9.574468085106384
8589,330330205000272,230,246,231,250,149,114,107,58,1220,165,1385,11.913357400722022
8590,330330205000273,56,61,56,58,57,39,23,23,327,46,373,12.332439678284182
8591,330330205000274,140,177,165,134,91,75,34,26,782,60,842,7.1258907363420425
8592,330330205000275,25,39,31,27,30,34,15,9,186,24,210,11.428571428571429
8593,330330205000276,198,231,218,177,159,110,75,44,1093,119,1212,9.818481848184819
8594,330330205000277,50,82,124,111,116,131,70,83,614,153,767,19.947848761408082
8595,330330205000278,32,53,70,78,66,64,47,45,363,92,455,20.21978021978022
8596,330330205000279,41,35,75,75,74,42,49,50,342,99,441,22.448979591836736
8597,330330205000280,114,132,132,238,152,120,68,62,888,130,1018,12.770137524557956
8598,330330205000281,26,44,62,63,51,65,44,32,311,76,387,19.638242894056848
8599,330330205000282,60,70,144,139,105,112,63,52,630,115,745,15.436241610738255
8600,330330205000283,61,66,104,114,83,88,45,41,516,86,602,14.285714285714286
8601,330330205000284,33,38,76,46,51,61,36,59,305,95,400,23.75
8602,330330205000285,58,82,114,136,120,108,61,62,618,123,741,16.59919028340081
8603,330330205000286,26,59,82,75,60,58,65,57,360,122,482,25.311203319502074
8604,330330205000287,39,78,67,92,117,66,48,59,459,107,566,18.90459363957597
8605,330330205000288,69,121,98,123,166,108,69,73,685,142,827,17.17049576783555
8606,330330205000289,62,91,124,95,118,114,65,59,604,124,728,17.032967032967033
8607,330330205000290,31,65,79,55,81,77,43,38,388,81,469,17.270788912579956
8608,330330205000291,35,48,61,73,57,53,31,33,327,64,391,16.36828644501279
8609,330330205000292,25,23,43,54,49,31,13,30,225,43,268,16.044776119402986
8610,330330205000293,31,30,78,64,55,82,56,63,340,119,459,25.925925925925927
8611,330330205000294,35,67,69,90,71,75,48,45,407,93,500,18.6
8612,330330205000295,61,61,112,123,122,110,58,66,589,124,713,17.391304347826086
8613,330330205000296,59,82,104,127,114,88,69,85,574,154,728,21.153846153846153
8614,330330205000297,27,25,72,48,49,74,53,81,295,134,429,31.235431235431236
8615,330330205000298,112,96,101,154,150,68,39,42,681,81,762,10.62992125984252
8616,330330205000299,96,116,133,198,189,92,49,39,824,88,912,9.649122807017545
8617,330330205000300,67,112,112,140,143,111,94,68,685,162,847,19.126328217237308
8618,330330205000301,52,94,174,126,115,112,96,73,673,169,842,20.071258907363422
8619,330330205000302,42,57,69,51,65,51,38,39,335,77,412,18.689320388349515
8620,330330205000303,70,107,137,187,141,114,89,77,756,166,922,18.004338394793926
8621,330330205000304,99,136,138,116,84,65,44,27,638,71,709,10.01410437235543
8622,330330205000305,35,60,76,97,76,93,54,44,437,98,535,18.317757009345794
8623,330330205000306,41,63,114,70,84,75,45,58,447,103,550,18.727272727272727
8624,330330205000307,34,40,65,70,50,55,30,29,314,59,373,15.817694369973191
8625,330330205000308,61,75,113,115,99,114,80,119,577,199,776,25.644329896907216
8626,330330205000309,40,51,52,57,84,51,46,60,335,106,441,24.03628117913832
8627,330330205000310,64,103,148,150,133,121,85,74,719,159,878,18.109339407744876
8628,330330205000311,24,31,22,31,37,16,11,7,161,18,179,10.05586592178771
8629,330330205000312,57,92,119,98,107,121,76,70,594,146,740,19.72972972972973
8630,330330205000313,74,76,114,145,125,105,62,32,639,94,733,12.824010914051842
8631,330330205000314,50,77,86,71,92,82,49,43,458,92,550,16.727272727272727
8632,330330205000315,36,43,66,71,73,75,53,74,364,127,491,25.865580448065174
8633,330330205000316,15,17,20,18,18,17,15,7,105,22,127,17.322834645669293
8634,330330205000317,44,64,76,79,57,72,30,46,392,76,468,16.23931623931624
8635,330330205000318,34,60,96,71,57,63,44,43,381,87,468,18.58974358974359
8636,330330205000319,25,51,80,66,73,75,32,61,370,93,463,20.086393088552917
8637,330330205000320,19,41,115,75,69,75,44,66,394,110,504,21.825396825396826
8638,330330205000321,14,34,80,60,35,68,42,33,291,75,366,20.491803278688526
8639,330330205000322,44,53,144,93,99,99,57,67,532,124,656,18.902439024390244
8640,330330205000323,30,47,96,83,67,52,36,34,375,70,445,15.730337078651685
8641,330330205000324,63,108,140,125,119,115,71,90,670,161,831,19.37424789410349
8642,330330205000325,46,53,55,38,35,29,13,4,256,17,273,6.227106227106227
8643,330330205000326,11,35,43,31,36,44,26,27,200,53,253,20.948616600790515
8644,330330205000327,99,112,121,116,87,58,46,12,593,58,651,8.90937019969278
8645,330330205000328,130,154,139,106,96,79,24,26,704,50,754,6.63129973474801
8646,330330205000329,174,215,210,210,145,91,56,28,1045,84,1129,7.440212577502215
8647,330330205000330,138,179,139,140,104,58,34,24,758,58,816,7.107843137254902
8648,330330205000331,36,34,65,67,52,47,27,52,301,79,380,20.789473684210527
8649,330330205000332,60,82,172,142,100,116,76,85,672,161,833,19.327731092436974
8650,330330205000333,41,51,117,100,93,68,69,95,470,164,634,25.86750788643533
8651,330330205000334,38,37,150,71,59,50,65,95,405,160,565,28.31858407079646
8652,330330205000335,44,62,131,66,75,101,47,35,479,82,561,14.616755793226382
8653,330330205000336,22,18,65,57,57,60,53,52,279,105,384,27.34375
8654,330330205000337,30,57,86,66,82,98,99,141,419,240,659,36.41881638846738
8655,330330205000338,10,15,87,31,22,44,54,54,209,108,317,34.06940063091483
8656,330330205000339,39,49,112,72,81,101,93,102,454,195,649,30.046224961479197
8657,330330205000340,26,32,56,42,57,56,52,76,269,128,397,32.241813602015114
8658,330330205000341,52,56,92,91,78,92,83,88,461,171,632,27.056962025316455
8659,330330205000342,187,202,191,177,129,72,39,14,958,53,1011,5.242334322453017
8660,330330205000343,156,169,165,130,110,58,32,20,788,52,840,6.190476190476191
8661,330330205000344,23,32,80,54,45,60,49,60,294,109,403,27.047146401985113
8662,330330205000345,49,75,158,89,89,87,75,51,547,126,673,18.7221396731055
8663,330330205000346,24,21,97,49,46,40,30,37,277,67,344,19.476744186046513
8664,330330205000347,22,40,134,65,54,64,37,51,379,88,467,18.843683083511777
8665,330330205000348,30,72,129,89,87,85,71,104,492,175,667,26.23688155922039
8666,330330205000349,62,62,134,136,93,94,66,39,581,105,686,15.306122448979592
8667,330330205000350,50,65,119,85,104,98,48,67,521,115,636,18.08176100628931
8668,330330205000351,27,43,59,50,36,61,49,23,276,72,348,20.689655172413794
8669,330330205000352,27,35,86,40,43,55,43,59,286,102,388,26.288659793814432
8670,330330205000353,14,16,85,45,35,68,25,58,263,83,346,23.98843930635838
8671,330330205000354,87,99,116,136,106,75,59,46,619,105,724,14.502762430939226
8672,330330205000355,51,78,146,99,107,97,76,87,578,163,741,21.997300944669366
8673,330330205000356,15,21,63,49,32,40,41,48,220,89,309,28.802588996763753
8674,330330205000357,49,53,102,80,95,78,70,111,457,181,638,28.369905956112852
8675,330330205000358,37,55,67,72,61,69,54,62,361,116,477,24.31865828092243
8676,330330205000359,41,48,97,78,80,94,52,84,438,136,574,23.693379790940767
8677,330330205000360,47,54,134,103,76,89,80,105,503,185,688,26.88953488372093
8678,330330205000361,14,20,43,28,40,37,27,40,182,67,249,26.907630522088354
8679,330330205000362,58,50,106,95,100,113,79,57,522,136,658,20.66869300911854
8680,330330205000363,38,20,113,83,82,82,59,43,418,102,520,19.615384615384617
8681,330330205000364,23,25,54,46,48,50,45,62,246,107,353,30.311614730878187
8682,330330205000365,44,48,94,87,92,80,67,45,445,112,557,20.107719928186714
8683,330330205000366,18,27,34,27,30,24,22,33,160,55,215,25.58139534883721
8684,330330205000367,22,29,95,55,49,70,47,81,320,128,448,28.571428571428573
8685,330330205000368,4,18,62,33,24,37,41,49,178,90,268,33.582089552238806
8686,330330205000369,9,32,104,18,30,38,36,64,231,100,331,30.211480362537763
8687,330330205000370,17,21,62,36,20,31,16,21,187,37,224,16.517857142857142
8688,330330205000371,7,16,44,38,28,21,34,22,154,56,210,26.666666666666668
8689,330330205000372,10,18,65,42,52,45,34,33,232,67,299,22.40802675585284
8690,330330205000373,26,23,55,33,21,32,29,19,190,48,238,20.168067226890756
8691,330330205000374,25,39,77,53,61,91,41,68,346,109,455,23.956043956043956
8692,330330205000375,27,52,99,49,68,80,50,85,375,135,510,26.470588235294116
8693,330330205000376,18,30,66,35,38,36,18,31,223,49,272,18.014705882352942
8694,330330205000377,29,69,124,74,71,117,79,89,484,168,652,25.766871165644172
8695,330330205000378,21,35,55,31,49,51,41,49,242,90,332,27.10843373493976
8696,330330205000379,32,52,102,70,67,54,30,36,377,66,443,14.89841986455982
8697,330330205000380,35,35,84,77,84,81,45,45,396,90,486,18.51851851851852
8699,330330205000382,30,67,71,63,86,71,60,65,388,125,513,24.366471734892787
8700,330330205000383,0,0,98,97,26,13,0,0,234,0,234,0.0
8701,330330205000384,41,57,75,51,67,83,53,62,374,115,489,23.517382413087933
8702,330330205000385,20,23,60,52,45,48,28,37,248,65,313,20.766773162939298
8703,330330205000386,26,61,108,76,80,105,47,78,456,125,581,21.514629948364888
8704,330330205000387,32,39,82,75,59,66,32,19,353,51,404,12.623762376237623
8705,330330205000388,29,40,82,76,58,82,57,39,367,96,463,20.734341252699785
8706,330330205000389,23,48,125,68,68,84,50,68,416,118,534,22.09737827715356
8707,330330205000390,33,49,116,77,74,72,42,52,421,94,515,18.25242718446602
8708,330330205000391,32,44,90,69,61,52,51,69,348,120,468,25.641025641025642
8709,330330205000392,167,162,189,168,99,71,32,18,856,50,906,5.518763796909492
8710,330330205000393,19,33,92,64,50,62,46,53,320,99,419,23.627684964200476
8711,330330205000394,66,67,120,140,89,54,32,20,536,52,588,8.843537414965986
8712,330330205000395,51,68,163,96,71,85,62,83,534,145,679,21.354933726067745
8713,330330205000396,20,39,46,34,50,33,21,47,222,68,290,23.448275862068964
8714,330330205000397,48,60,134,96,71,87,59,87,496,146,642,22.741433021806852
8715,330330205000398,9,23,73,37,43,40,25,53,225,78,303,25.742574257425744
8716,330330205000399,9,11,100,51,32,40,50,62,243,112,355,31.549295774647888
8717,330330205000400,9,21,42,34,32,46,30,12,184,42,226,18.58407079646018
8718,330330205000401,5,19,53,35,33,34,26,18,179,44,223,19.730941704035875
8719,330330205000402,4,18,55,31,46,32,31,44,186,75,261,28.735632183908045
8720,330330205000403,6,12,32,31,17,23,19,13,121,32,153,20.915032679738562
8721,330330205000404,39,46,77,72,77,80,73,63,391,136,527,25.806451612903224
8722,330330205000405,27,18,326,43,23,34,32,33,471,65,536,12.126865671641792
8723,330330205000406,17,29,89,51,44,57,56,59,287,115,402,28.606965174129353
8724,330330205000407,17,35,72,39,51,39,44,52,253,96,349,27.507163323782233
8725,330330205000408,14,20,33,26,31,25,29,29,149,58,207,28.019323671497585
8726,330330205000409,24,42,78,64,77,59,46,57,344,103,447,23.042505592841163
8727,330330205000410,24,35,78,52,51,81,46,64,321,110,431,25.52204176334107
8728,330330205000411,25,42,87,46,53,54,32,48,307,80,387,20.671834625322997
8729,330330205000412,19,36,105,85,80,65,63,55,390,118,508,23.228346456692915
8730,330330205000413,4,9,54,38,42,44,48,45,191,93,284,32.74647887323944
8731,330330205000414,119,140,170,163,140,107,47,40,839,87,926,9.39524838012959
8732,330330205000415,80,95,85,103,54,75,39,29,492,68,560,12.142857142857142
8733,330330205000416,143,160,165,123,112,73,44,36,776,80,856,9.345794392523365
8734,330330205000417,40,38,50,50,43,40,36,18,261,54,315,17.142857142857142
8735,330330205000418,52,81,91,71,97,92,50,59,484,109,593,18.381112984822934
8736,330330205000419,55,76,158,99,117,129,76,56,634,132,766,17.232375979112273
8737,330330205000420,38,43,94,71,67,45,37,44,358,81,439,18.451025056947607
8738,330330205000421,47,68,123,91,96,114,75,74,539,149,688,21.656976744186046
8739,330330205000422,20,49,80,63,60,41,44,34,313,78,391,19.948849104859335
8740,330330205000423,41,70,89,61,93,84,50,71,438,121,559,21.645796064400717
8741,330330205000424,67,77,138,108,110,129,100,115,629,215,844,25.473933649289098
8742,330330205000425,56,75,103,71,113,89,49,49,507,98,605,16.198347107438018
8743,330330205000426,190,214,261,183,157,107,50,23,1112,73,1185,6.160337552742616
8744,330330205000427,79,123,112,101,101,75,25,17,591,42,633,6.6350710900473935
8745,330330205000428,86,138,136,125,165,87,75,60,737,135,872,15.48165137614679
8746,330330205000429,66,74,102,84,90,113,50,56,529,106,635,16.69291338582677
8747,330330205000430,32,60,59,50,69,51,43,33,321,76,397,19.143576826196472
8748,330330205000431,49,80,98,71,115,107,73,57,520,130,650,20.0
8749,330330205000432,60,108,105,122,125,109,85,75,629,160,789,20.278833967046896
8750,330330205000433,166,157,208,192,167,116,78,45,1006,123,1129,10.894596988485386
8751,330330205000434,66,98,108,79,83,65,31,20,499,51,550,9.272727272727273
8752,330330205000435,84,97,100,69,92,63,34,27,505,61,566,10.777385159010601
8753,330330205000436,123,150,129,121,115,68,29,15,706,44,750,5.866666666666666
8754,330330205000437,37,42,63,49,45,41,26,23,277,49,326,15.030674846625766
8755,330330205000438,47,89,105,75,97,89,54,46,502,100,602,16.611295681063122
8756,330330205000439,26,34,68,41,56,65,51,54,290,105,395,26.582278481012658
8757,330330205000440,32,57,44,75,71,49,44,74,328,118,446,26.457399103139014
8758,330330205000441,0,16,15,0,0,0,0,0,31,0,31,0.0
8759,330330205000442,27,36,45,58,45,48,13,10,259,23,282,8.156028368794326
8760,330330205000443,58,70,90,91,97,90,65,64,496,129,625,20.64
8761,330330205000444,32,66,101,65,73,84,72,72,421,144,565,25.486725663716815
8762,330330205000445,58,88,114,109,113,110,51,78,592,129,721,17.891816920943135
8763,330330205000446,56,78,94,90,92,89,65,52,499,117,616,18.993506493506494
8764,330330205000447,40,62,90,99,65,80,52,56,436,108,544,19.852941176470587
8765,330330205000448,61,63,91,90,112,110,66,60,527,126,653,19.295558958652375
8766,330330205000449,33,54,76,78,66,49,35,64,356,99,455,21.75824175824176
8767,330330205000450,34,52,71,76,68,44,43,52,345,95,440,21.59090909090909
8768,330330205000451,11,29,42,27,33,46,26,34,188,60,248,24.193548387096776
8769,330330205000452,48,66,103,83,103,76,51,71,479,122,601,20.299500831946755
8770,330330205000453,38,65,75,55,61,56,46,40,350,86,436,19.724770642201836
8771,330330205000454,30,31,48,44,45,46,36,30,244,66,310,21.29032258064516
8772,330330205000455,114,129,141,154,125,120,103,69,783,172,955,18.01047120418848
8773,330330205000456,31,45,61,50,39,47,35,37,273,72,345,20.869565217391305
8774,330330205000457,37,56,64,68,83,71,76,64,379,140,519,26.97495183044316
8775,330330205000458,33,46,67,61,70,78,46,78,355,124,479,25.887265135699373
8776,330330205000459,38,57,75,64,69,80,37,70,383,107,490,21.836734693877553
8777,330330205000460,84,76,115,113,93,102,73,100,583,173,756,22.883597883597883
8778,330330205000461,48,53,56,48,40,32,12,16,277,28,305,9.180327868852459
8779,330330205000462,67,114,69,62,78,49,45,25,439,70,509,13.7524557956778
8780,330330205000463,110,111,112,84,97,51,44,33,565,77,642,11.993769470404985
8781,330330205000464,22,24,28,30,16,18,9,8,138,17,155,10.96774193548387
8782,330330205000465,94,127,108,118,132,60,39,14,639,53,692,7.658959537572255
8783,330330205000466,169,229,174,187,134,133,60,37,1026,97,1123,8.637577916295637
8784,330330205000467,160,230,158,143,130,104,59,44,925,103,1028,10.019455252918288
8785,330330205000468,97,107,101,110,82,67,74,28,564,102,666,15.315315315315315
8786,330330205000469,60,90,84,81,101,86,72,42,502,114,616,18.506493506493506
8787,330330205000470,61,108,97,109,96,93,61,52,564,113,677,16.691285081240768
8788,330330205000471,59,71,95,88,88,80,49,54,481,103,584,17.636986301369863
8789,330330205000472,77,74,86,99,89,76,51,58,501,109,610,17.868852459016395
8790,330330205000473,101,104,142,155,135,145,84,90,782,174,956,18.200836820083683
8791,330330205000474,72,109,112,124,117,91,81,88,625,169,794,21.28463476070529
8792,330330205000475,48,67,70,82,81,63,51,43,411,94,505,18.613861386138613
8793,330330205000476,56,64,85,84,62,73,48,40,424,88,512,17.1875
8794,330330205000477,45,69,87,72,102,70,51,59,445,110,555,19.81981981981982
8795,330330205000478,27,33,59,44,60,61,56,34,284,90,374,24.06417112299465
8796,330330205000479,21,43,24,34,31,15,14,6,168,20,188,10.638297872340425
8797,330330205000480,80,106,107,77,100,87,51,47,557,98,655,14.961832061068701
8798,330330205000481,86,114,150,117,96,110,58,51,673,109,782,13.938618925831202
8799,330330205000482,32,50,53,67,54,50,46,42,306,88,394,22.33502538071066
8800,330330205000483,25,29,26,38,25,22,31,17,165,48,213,22.535211267605632
8801,330330205000484,73,115,102,89,91,83,41,34,553,75,628,11.94267515923567
8802,330330205000485,24,26,27,32,36,33,24,20,178,44,222,19.81981981981982
8803,330330205000486,40,71,55,56,58,78,34,36,358,70,428,16.35514018691589
8804,330330205000487,80,86,78,94,67,70,50,27,475,77,552,13.94927536231884
8805,330330205000488,91,147,92,112,115,79,59,43,636,102,738,13.821138211382113
8806,330330205000489,47,77,103,93,85,92,60,73,497,133,630,21.11111111111111
8807,330330205000490,45,56,68,57,86,55,35,63,367,98,465,21.0752688172043
8808,330330205000491,45,91,83,85,133,113,105,81,550,186,736,25.27173913043478
8809,330330205000492,60,85,97,84,114,95,73,46,535,119,654,18.195718654434252
8810,330330205000493,46,80,70,61,46,65,41,26,368,67,435,15.402298850574713
8811,330330205000494,136,180,170,143,152,151,89,64,932,153,1085,14.101382488479263
8812,330330205000495,46,79,53,60,49,36,24,20,323,44,367,11.989100817438691
8813,330330205000496,94,144,124,114,139,97,54,51,712,105,817,12.851897184822521
8814,330330205000497,87,91,88,89,78,76,46,40,509,86,595,14.453781512605042
8815,330330205000498,34,57,83,62,58,75,51,34,369,85,454,18.722466960352424
8816,330330205000499,53,68,73,82,67,70,38,39,413,77,490,15.714285714285714
8817,330330205000500,31,60,72,83,78,86,66,79,410,145,555,26.126126126126128
8818,330330205000501,65,68,110,130,110,121,95,110,604,205,809,25.339925834363413
8819,330330205000502,31,63,47,65,63,70,53,51,339,104,443,23.47629796839729
8820,330330205000503,48,51,90,108,79,88,47,30,464,77,541,14.232902033271719
8821,330330205000504,46,53,117,80,83,83,50,45,462,95,557,17.0556552962298
8822,330330205000505,21,49,37,42,49,45,32,51,243,83,326,25.460122699386503
8823,330330205000506,33,34,60,45,58,54,34,37,284,71,355,20.0
8824,330330205000507,91,119,107,135,177,105,48,38,734,86,820,10.487804878048781
8825,330330205000508,22,56,54,61,69,52,57,58,314,115,429,26.806526806526808
8826,330330205000509,23,45,77,53,63,79,33,53,340,86,426,20.187793427230048
8827,330330205000510,54,46,72,81,54,75,61,72,382,133,515,25.825242718446603
8828,330330205000511,22,44,52,50,54,42,38,33,264,71,335,21.19402985074627
8829,330330205000512,28,37,60,42,46,56,42,36,269,78,347,22.478386167146976
8830,330330205000513,1,7,307,172,60,27,44,16,574,60,634,9.46372239747634
8831,330330205000514,38,61,69,56,51,59,41,34,334,75,409,18.337408312958434
8832,330330205000515,105,141,97,144,92,51,52,17,630,69,699,9.871244635193133
8834,330330205000517,35,83,89,94,99,112,73,74,512,147,659,22.306525037936268
8835,330330205000518,42,49,104,89,83,94,63,87,461,150,611,24.549918166939445
8836,330330205000519,62,65,154,134,98,115,70,101,628,171,799,21.401752190237797
8837,330330205000520,85,79,144,159,131,107,54,57,705,111,816,13.602941176470589
8838,330330205000521,46,48,88,99,73,48,44,24,402,68,470,14.46808510638298
8839,330330205000522,33,62,90,65,88,88,59,70,426,129,555,23.243243243243242
8840,330330205000523,70,152,120,118,173,153,63,50,786,113,899,12.56952169076752
8841,330330205000524,53,53,99,96,92,88,61,76,481,137,618,22.168284789644012
8842,330330205000525,5,9,7,7,7,15,12,17,50,29,79,36.70886075949367
8843,330330205000526,25,40,59,57,56,69,20,32,306,52,358,14.525139664804469
8844,330330205000527,46,66,133,102,88,99,81,64,534,145,679,21.354933726067745
8845,330330205000528,85,113,124,191,135,117,105,74,765,179,944,18.96186440677966
8846,330330205000529,99,109,118,106,118,92,57,47,642,104,746,13.941018766756033
8847,330330205000530,72,71,123,122,97,91,56,40,576,96,672,14.285714285714286
8848,330330205000531,46,68,79,84,75,56,25,16,408,41,449,9.131403118040089
8849,330330205000532,95,90,108,125,85,80,63,61,583,124,707,17.53889674681754
8850,330330205000533,95,108,124,106,72,63,34,29,568,63,631,9.984152139461173
8851,330330205000534,72,79,84,57,75,44,40,24,411,64,475,13.473684210526315
8852,330330205000535,160,194,151,153,123,82,54,38,863,92,955,9.633507853403142
8853,330330205000536,55,75,54,47,41,43,16,12,315,28,343,8.16326530612245
8854,330330205000537,57,64,77,81,68,76,43,47,423,90,513,17.54385964912281
8855,330330205000538,76,84,94,88,76,73,43,39,491,82,573,14.31064572425829
8856,330330205000539,48,60,69,67,62,47,40,33,353,73,426,17.136150234741784
8857,330330205000540,82,101,113,116,113,106,60,62,631,122,753,16.201859229747676
8858,330330205000541,106,121,107,112,120,73,51,41,639,92,731,12.585499316005471
8859,330330205000542,90,130,120,108,111,58,39,36,617,75,692,10.83815028901734
8860,330330205000543,60,65,93,74,61,52,53,45,405,98,503,19.4831013916501
8861,330330205000544,0,0,0,2,0,1,0,5,3,5,8,62.5
8862,330330205000545,64,108,95,114,112,106,72,59,599,131,730,17.945205479452056
8863,330330205000546,63,99,71,85,84,52,46,38,454,84,538,15.613382899628252
8864,330330205000547,35,46,41,46,59,36,23,21,263,44,307,14.332247557003257
8865,330330205000548,38,47,66,60,71,65,31,54,347,85,432,19.675925925925927
8866,330330205000549,42,49,63,61,56,48,25,30,319,55,374,14.705882352941176
8867,330330205000550,84,106,100,102,94,97,46,63,583,109,692,15.751445086705202
8868,330330205000551,23,47,18,33,23,10,11,8,154,19,173,10.982658959537572
8869,330330205000552,39,62,65,73,63,56,46,47,358,93,451,20.620842572062084
8870,330330205000553,61,53,95,83,78,101,67,64,471,131,602,21.760797342192692
8871,330330205000554,53,71,119,84,98,81,38,20,506,58,564,10.28368794326241
8872,330330205000555,18,28,42,33,34,34,23,28,189,51,240,21.25
8873,330330205000556,31,36,85,59,68,89,47,64,368,111,479,23.173277661795407
8874,330330205000557,40,65,79,53,89,61,65,64,387,129,516,25.0
8875,330330205000558,48,68,83,85,70,90,49,49,444,98,542,18.081180811808117
8876,330330205000559,31,24,59,55,46,59,37,33,274,70,344,20.348837209302324
8877,330330205000560,55,60,102,108,107,89,78,84,521,162,683,23.718887262079065
8878,330330205000561,25,34,46,49,40,47,33,34,241,67,308,21.753246753246753
8879,330330205000562,11,14,8,15,11,11,9,24,70,33,103,32.03883495145631
8880,330330205000563,40,50,121,100,76,77,45,35,464,80,544,14.705882352941176
8881,330330205000564,60,70,101,98,88,110,83,82,527,165,692,23.84393063583815
8882,330330205000565,47,78,62,83,68,67,53,40,405,93,498,18.674698795180724
8883,330330205000566,43,51,77,63,62,70,26,50,366,76,442,17.194570135746606
8884,330330205000567,64,68,110,123,98,111,88,103,574,191,765,24.96732026143791
8885,330330205000568,42,68,115,97,110,95,51,30,527,81,608,13.322368421052632
8886,330330205000569,35,42,48,59,67,43,39,41,294,80,374,21.390374331550802
8887,330330205000570,45,47,55,51,57,65,37,40,320,77,397,19.395465994962215
8888,330330205000571,91,123,95,75,72,59,31,22,515,53,568,9.330985915492958
8889,330330205000572,68,103,110,107,112,113,50,23,613,73,686,10.641399416909621
8890,330330205000573,39,48,59,72,61,69,48,49,348,97,445,21.797752808988765
8891,330330205000574,30,33,57,59,48,48,32,49,275,81,356,22.752808988764045
8892,330330205000575,72,92,128,150,121,146,82,77,709,159,868,18.317972350230416
8893,330330205000576,47,78,82,84,92,88,39,52,471,91,562,16.19217081850534
8894,330330205000577,35,48,64,64,54,52,36,50,317,86,403,21.33995037220844
8895,330330205000578,8,10,16,6,12,9,11,10,61,21,82,25.609756097560975
8896,330330205000579,80,108,108,128,117,110,93,70,651,163,814,20.024570024570025
8897,330330205000580,22,36,22,28,27,26,10,12,161,22,183,12.021857923497267
8898,330330205000581,129,148,154,162,164,126,78,68,883,146,1029,14.188532555879494
8899,330330205000582,104,89,114,104,73,69,61,56,553,117,670,17.46268656716418
8900,330330205000583,71,67,108,98,85,97,69,66,526,135,661,20.423600605143722
8901,330330205000584,25,60,80,63,44,56,33,46,328,79,407,19.41031941031941
8902,330330205000585,39,56,107,99,64,76,36,35,441,71,512,13.8671875
8903,330330205000586,30,48,102,106,58,78,39,22,422,61,483,12.629399585921325
8904,330330205000587,23,35,55,66,52,53,40,53,284,93,377,24.6684350132626
8905,330330205000588,80,95,199,154,137,119,101,66,784,167,951,17.560462670872766
8906,330330205000589,147,168,169,143,129,89,55,31,845,86,931,9.237379162191193
8907,330330205000590,204,224,233,162,166,124,69,74,1113,143,1256,11.385350318471337
8908,330330205000591,30,38,71,57,58,68,36,52,322,88,410,21.463414634146343
8909,330330205000592,21,27,58,40,55,50,30,47,251,77,328,23.475609756097562
8910,330330205000593,93,88,116,115,79,92,44,30,583,74,657,11.263318112633181
8911,330330205000594,104,109,65,69,53,34,21,15,434,36,470,7.659574468085107
8912,330330205000595,154,176,216,263,238,158,126,132,1205,258,1463,17.634996582365
8913,330330205000596,57,82,137,76,102,98,63,80,552,143,695,20.575539568345324
8914,330330205000597,65,72,72,86,79,73,62,62,447,124,571,21.71628721541156
8915,330330205000598,56,79,95,89,95,105,50,56,519,106,625,16.96
8916,330330205000599,54,98,108,116,113,91,20,10,580,30,610,4.918032786885246
8917,330330205000600,44,47,80,85,77,66,45,64,399,109,508,21.456692913385826
8918,330330205000601,33,42,70,68,67,54,28,38,334,66,400,16.5
8919,330330205000602,49,79,212,151,152,102,51,40,745,91,836,10.885167464114833
8920,330330205000603,28,45,80,74,66,60,35,34,353,69,422,16.350710900473935
8921,330330205000604,43,58,121,116,105,84,67,68,527,135,662,20.39274924471299
8922,330330205000605,37,50,105,54,51,53,40,29,350,69,419,16.46778042959427
8923,330330205000606,47,61,66,71,82,44,50,47,371,97,468,20.726495726495727
8924,330330205000607,35,51,55,64,35,47,52,39,287,91,378,24.074074074074073
8925,330330205000608,16,38,49,37,33,39,21,35,212,56,268,20.895522388059703
8926,330330205000609,91,113,170,150,110,122,55,49,756,104,860,12.093023255813954
8927,330330205000610,0,7,50,56,50,18,11,2,181,13,194,6.701030927835052
8928,330330205000611,137,146,155,126,105,88,35,30,757,65,822,7.907542579075426
8929,330330205000612,39,55,96,56,78,66,36,30,390,66,456,14.473684210526315
8930,330330205000613,44,56,101,64,74,79,41,31,418,72,490,14.693877551020408
8931,330330205000614,42,68,122,81,67,79,39,52,459,91,550,16.545454545454547
8932,330330205000615,48,77,53,47,68,56,29,31,349,60,409,14.669926650366747
8933,330330205000616,31,30,33,27,31,18,15,7,170,22,192,11.458333333333334
8934,330330205000617,122,198,103,148,101,63,44,20,735,64,799,8.010012515644556
8935,330330205000618,132,124,124,109,65,50,32,11,604,43,647,6.6460587326120555
8936,330330205000619,113,130,158,124,108,110,74,55,743,129,872,14.793577981651376
8937,330330205000620,11,6,19,19,12,11,9,12,78,21,99,21.21212121212121
8938,330330205000621,38,50,81,61,84,71,50,58,385,108,493,21.906693711967545
8939,330330205000622,28,57,63,44,75,45,44,44,312,88,400,22.0
8940,330330205000623,8,20,17,10,36,22,16,34,113,50,163,30.67484662576687
8941,330330205000624,96,112,160,172,146,124,104,101,810,205,1015,20.19704433497537
8942,330330205000625,92,112,146,164,141,144,108,90,799,198,997,19.859578736208626
8943,330330205000626,93,124,128,137,120,119,77,79,721,156,877,17.787913340935006
8944,330330205000627,22,33,34,28,51,35,37,46,203,83,286,29.02097902097902
8945,330330205000628,77,76,110,158,141,63,53,29,625,82,707,11.598302687411598
8946,330330205000629,79,97,209,179,163,159,77,47,886,124,1010,12.277227722772277
8947,330330205000630,28,59,58,41,65,48,19,12,299,31,330,9.393939393939394
8948,330330205000631,82,115,123,122,131,106,72,78,679,150,829,18.094089264173704
8949,330330205000632,85,100,95,118,128,72,53,38,598,91,689,13.20754716981132
8950,330330205000633,42,50,115,148,86,91,85,96,532,181,713,25.38569424964937
8951,330330205000634,31,64,84,100,85,80,53,33,444,86,530,16.22641509433962
8952,330330205000635,74,107,185,145,161,160,89,61,832,150,982,15.274949083503055
8953,330330205000636,79,104,175,134,128,158,115,78,778,193,971,19.87641606591143
8954,330330205000637,27,31,48,36,41,41,22,14,224,36,260,13.846153846153847
8955,330330205000638,4,6,7,8,3,6,3,0,34,3,37,8.108108108108109
8956,330330205000639,56,81,124,97,106,107,84,69,571,153,724,21.132596685082873
8957,330330205000640,125,114,186,191,188,230,159,76,1034,235,1269,18.51851851851852
8958,330330205000641,82,100,127,110,129,141,100,42,689,142,831,17.087845968712394
8959,330330205000642,66,58,78,55,50,20,6,7,327,13,340,3.823529411764706
8960,330330205000643,71,80,99,82,122,102,52,39,556,91,647,14.064914992272024
8961,330330205000644,49,75,105,67,109,98,76,38,503,114,617,18.47649918962723
8962,330330205000645,75,81,113,110,98,118,90,59,595,149,744,20.026881720430108
8963,330330205000646,78,114,128,103,128,142,88,92,693,180,873,20.61855670103093
8964,330330205000647,77,109,161,113,149,142,82,61,751,143,894,15.995525727069351
8965,330330205000648,69,97,64,111,100,64,29,30,505,59,564,10.460992907801419
8966,330330205000649,15,19,21,21,23,27,11,8,126,19,145,13.10344827586207
8967,330330205000650,0,0,3,10,42,56,25,9,111,34,145,23.448275862068964
8968,330330205000651,58,97,120,110,140,115,77,69,640,146,786,18.575063613231553
8969,330330205000652,79,107,154,115,126,142,92,67,723,159,882,18.027210884353742
8970,330330205000653,75,106,141,121,149,150,115,90,742,205,947,21.647307286166843
8971,330330205000654,90,138,135,141,162,153,101,80,819,181,1000,18.1
8972,330330205000655,89,126,124,121,153,132,63,47,745,110,855,12.865497076023392
8973,330330205000657,38,54,46,50,46,42,23,12,276,35,311,11.254019292604502
8974,330330205000658,107,142,171,157,131,121,95,58,829,153,982,15.580448065173115
8975,330330205000659,1,11,2,11,11,7,1,2,43,3,46,6.521739130434782
8976,330330205000660,78,101,119,110,89,79,51,37,576,88,664,13.25301204819277
8977,330330205000661,63,92,123,105,112,80,54,45,575,99,674,14.688427299703264
8978,330330205000662,24,46,32,41,69,26,21,20,238,41,279,14.695340501792115
8979,330330205000663,87,131,137,114,106,100,56,58,675,114,789,14.448669201520913
8980,330330205000664,42,73,82,80,94,98,49,29,469,78,547,14.259597806215723
8981,330330205000665,68,105,80,84,132,86,42,22,555,64,619,10.339256865912763
8982,330330205000666,55,78,49,65,46,42,23,18,335,41,376,10.904255319148936
8983,330330205000667,79,127,116,124,132,98,68,66,676,134,810,16.54320987654321
8984,330330205000668,69,111,96,120,113,83,55,27,592,82,674,12.166172106824925
8985,330330205000669,68,80,102,92,114,82,54,31,538,85,623,13.643659711075442
8986,330330205000670,98,147,123,122,111,73,37,24,674,61,735,8.299319727891156
8987,330330205000671,136,131,139,151,132,78,62,32,767,94,861,10.917537746806039
8988,330330205000672,70,84,93,98,108,99,55,32,552,87,639,13.615023474178404
8989,330330205000673,51,54,80,93,80,85,40,35,443,75,518,14.478764478764479
8990,330330205000674,151,221,188,207,213,140,71,29,1120,100,1220,8.19672131147541
8991,330330205000675,49,71,59,91,87,72,52,22,429,74,503,14.711729622266402
8992,330330205000676,69,76,114,89,115,103,48,40,566,88,654,13.45565749235474
8993,330330205000677,93,130,133,125,162,141,58,61,784,119,903,13.178294573643411
8994,330330205000678,79,102,110,105,125,118,67,41,639,108,747,14.457831325301205
8995,330330205000679,89,125,142,145,131,127,78,57,759,135,894,15.100671140939598
8996,330330205000680,82,102,145,137,123,116,48,43,705,91,796,11.4321608040201
8997,330330205000681,174,198,219,230,193,133,101,82,1147,183,1330,13.759398496240602
8998,330330205000682,41,59,92,77,83,97,67,74,449,141,590,23.89830508474576
8999,330330205000683,42,53,48,72,70,60,53,80,345,133,478,27.824267782426777
9000,330330205000684,81,104,124,90,138,123,39,37,660,76,736,10.326086956521738
9001,330330205000685,79,96,95,107,115,107,52,22,599,74,673,10.99554234769688
9002,330330205000686,27,46,68,63,63,91,44,30,358,74,432,17.12962962962963
9003,330330205000687,63,92,107,88,101,108,75,49,559,124,683,18.15519765739385
9004,330330205000688,33,62,94,89,77,106,87,57,461,144,605,23.801652892561982
9005,330330205000689,21,39,43,49,44,60,39,37,256,76,332,22.89156626506024
9006,330330205000690,21,27,35,58,46,50,45,43,237,88,325,27.076923076923077
9007,330330205000691,50,68,62,81,61,86,63,55,408,118,526,22.433460076045627
9008,330330205000692,95,224,136,138,244,110,62,33,947,95,1042,9.117082533589251
9009,330330205000693,59,91,110,96,108,98,52,36,562,88,650,13.538461538461538
9010,330330205000694,66,128,76,135,115,78,32,56,598,88,686,12.82798833819242
9011,330330205000695,45,62,94,91,77,101,86,66,470,152,622,24.437299035369776
9012,330330205000696,78,80,111,141,116,66,50,8,592,58,650,8.923076923076923
9013,330330205000697,53,80,105,85,83,86,61,60,492,121,613,19.73898858075041
9014,330330205000698,28,35,44,36,46,32,23,11,221,34,255,13.333333333333334
9015,330330205000699,73,65,71,79,57,40,34,17,385,51,436,11.697247706422019
9016,330330205000700,35,34,58,24,39,37,12,22,227,34,261,13.026819923371647
9017,330330205000701,64,80,135,97,117,132,105,76,625,181,806,22.456575682382134
9018,330330205000702,42,65,102,81,96,102,73,66,488,139,627,22.169059011164276
9019,330330205000703,68,94,134,111,110,125,82,74,642,156,798,19.548872180451127
9020,330330205000704,109,132,152,172,120,129,70,45,814,115,929,12.378902045209903
9021,330330205000705,17,28,8,38,28,20,14,12,139,26,165,15.757575757575758
9022,330330205000706,44,76,50,80,85,79,46,34,414,80,494,16.194331983805668
9023,330330205000707,50,88,63,94,92,51,50,53,438,103,541,19.038817005545287
9024,330330205000708,45,87,116,87,87,100,65,64,522,129,651,19.81566820276498
9025,330330205000709,44,40,40,49,48,51,24,34,272,58,330,17.575757575757574
9026,330330205000710,37,68,57,52,54,61,30,21,329,51,380,13.421052631578947
9027,330330205000711,14,30,52,32,42,57,39,53,227,92,319,28.84012539184953
9028,330330205000712,83,80,100,103,67,66,35,38,499,73,572,12.762237762237762
9029,330330205000713,43,36,26,43,28,27,22,15,203,37,240,15.416666666666666
9030,330330205000714,13,22,25,20,14,19,14,6,113,20,133,15.037593984962406
9031,330330205000715,99,158,109,117,92,53,43,23,628,66,694,9.510086455331413
9032,330330205000716,10,34,21,26,21,13,14,8,125,22,147,14.965986394557824
9033,330330205000717,38,30,36,64,46,23,15,6,237,21,258,8.13953488372093
9034,330330205000718,47,72,81,67,72,57,24,25,396,49,445,11.01123595505618
9035,330330205000719,109,131,116,176,116,107,71,54,755,125,880,14.204545454545455
9036,330330205000720,44,49,35,57,35,22,21,4,242,25,267,9.363295880149813
9037,330330205000721,47,64,63,43,77,79,31,13,373,44,417,10.551558752997602
9038,330330205000722,60,62,58,79,72,41,31,20,372,51,423,12.056737588652481
9039,330330205000723,72,88,102,116,114,83,44,26,575,70,645,10.852713178294573
9040,330330205000724,108,65,77,174,98,42,16,13,564,29,593,4.8903878583473865
9041,330330205000725,51,57,71,97,84,60,46,38,420,84,504,16.666666666666668
9042,330330205000726,26,31,51,59,48,48,43,42,263,85,348,24.42528735632184
9043,330330205000727,56,67,111,96,78,100,57,51,508,108,616,17.532467532467532
9044,330330205000728,34,46,79,80,60,77,53,66,376,119,495,24.04040404040404
9045,330330205000729,39,31,89,91,59,65,35,28,374,63,437,14.416475972540045
9046,330330205000730,38,34,66,54,69,52,48,59,313,107,420,25.476190476190474
9047,330330205000731,55,77,92,101,113,90,58,48,528,106,634,16.7192429022082
9048,330330205000732,13,11,36,16,21,29,29,48,126,77,203,37.93103448275862
9049,330330205000733,28,38,97,64,46,57,45,46,330,91,421,21.61520190023753
9050,330330205000734,42,61,88,95,87,98,78,96,471,174,645,26.976744186046513
9051,330330205000735,51,36,71,86,62,51,30,41,357,71,428,16.588785046728972
9052,330330205000736,41,32,16,53,42,13,13,17,197,30,227,13.215859030837004
9053,330330205000737,13,12,4,13,15,3,1,3,60,4,64,6.25
9054,330330205000738,53,35,74,79,64,69,61,43,374,104,478,21.757322175732217
9055,330330205000739,57,63,39,106,80,39,24,18,384,42,426,9.859154929577464
9056,330330205000740,36,65,79,75,94,81,59,61,430,120,550,21.818181818181817
9057,330330205000742,72,88,154,161,148,110,75,74,733,149,882,16.89342403628118
9058,330330205000743,19,27,42,63,44,28,18,24,223,42,265,15.849056603773585
9059,330330205000744,14,8,24,16,11,11,9,14,84,23,107,21.49532710280374
9060,330330205000745,52,26,79,166,47,25,13,13,395,26,421,6.175771971496437
9061,330330205000746,50,24,68,189,54,16,11,10,401,21,422,4.976303317535545
9062,330330205000747,69,67,81,91,65,82,47,44,455,91,546,16.666666666666668
9063,330330205000748,103,59,89,189,155,84,48,44,679,92,771,11.932555123216602
9064,330330205000749,59,77,93,132,77,63,40,15,501,55,556,9.892086330935252
9065,330330205000750,93,141,113,105,107,74,53,25,633,78,711,10.970464135021096
9066,330330205000751,106,126,159,171,125,74,42,25,761,67,828,8.091787439613526
9067,330330205000752,5,15,6,6,4,11,7,4,47,11,58,18.96551724137931
9068,330330205000753,119,120,119,133,89,67,57,30,647,87,734,11.852861035422343
9069,330330205000754,0,1,1,3,0,1,4,2,6,6,12,50.0
9070,330330205000755,7,11,5,6,6,6,1,8,41,9,50,18.0
9071,330330205000756,66,49,105,79,32,34,29,14,365,43,408,10.53921568627451
9072,330330205000757,72,85,135,143,122,95,45,47,652,92,744,12.365591397849462
9073,330330205000758,36,47,91,78,65,77,39,42,394,81,475,17.05263157894737
9074,330330205000759,42,68,78,89,79,87,62,90,443,152,595,25.54621848739496
9075,330330205000760,68,58,155,132,124,134,71,66,671,137,808,16.955445544554454
9076,330330205000761,19,20,15,17,14,17,9,6,102,15,117,12.820512820512821
9077,330330205000762,9,21,7,12,14,13,5,5,76,10,86,11.627906976744185
9078,330330205000763,12,13,15,14,13,10,8,9,77,17,94,18.085106382978722
9080,330330205000765,13,22,17,20,22,18,10,7,112,17,129,13.178294573643411
9082,330330205000769,42,115,99,111,106,100,87,50,573,137,710,19.295774647887324
9083,330330205000771,2,1,1,5,4,4,5,0,17,5,22,22.727272727272727
9084,330330205000772,5,17,22,13,12,20,12,9,89,21,110,19.09090909090909
9085,330330205000773,95,130,146,136,123,125,64,61,755,125,880,14.204545454545455
9086,330330205000774,3,9,7,6,12,7,6,3,44,9,53,16.9811320754717
9087,330330205000775,1,2,9,4,9,8,0,0,33,0,33,0.0
9088,330330205000776,151,145,135,146,110,78,38,43,765,81,846,9.574468085106384
9089,330330205000777,14,16,19,18,17,12,5,4,96,9,105,8.571428571428571
9090,330330205000778,199,242,229,189,129,114,32,23,1102,55,1157,4.753673292999136
9091,330330205000779,35,41,53,48,53,46,31,27,276,58,334,17.365269461077844
9094,330330205000785,69,72,55,66,43,28,12,7,333,19,352,5.3977272727272725
9095,330330205000786,31,46,43,47,21,19,15,4,207,19,226,8.4070796460177
9096,330330205000787,63,78,89,134,118,76,63,30,558,93,651,14.285714285714286
9097,330330205000788,23,30,36,41,38,33,18,13,201,31,232,13.362068965517242
9098,330330205000789,4,3,5,3,6,4,2,2,25,4,29,13.793103448275861
9099,330330205000790,87,108,100,113,126,65,49,29,599,78,677,11.521418020679468
9100,330330205000791,139,190,139,150,140,85,50,28,843,78,921,8.469055374592834
9101,330330205000792,177,202,240,202,163,141,58,47,1125,105,1230,8.536585365853659
9102,330330205000793,10,19,29,30,19,22,9,8,129,17,146,11.643835616438356
9103,330330205000794,9,11,18,21,17,10,5,13,86,18,104,17.307692307692307
9104,330330205000795,5,0,3,11,2,1,5,0,22,5,27,18.51851851851852
9106,330330205000797,48,53,100,88,82,102,65,50,473,115,588,19.5578231292517
9107,330330205000798,109,146,179,157,162,125,75,58,878,133,1011,13.155291790306627
9108,330330205000799,74,88,92,84,117,116,65,53,571,118,689,17.126269956458636
9109,330330205000800,57,58,64,76,71,63,31,18,389,49,438,11.187214611872147
9110,330330205000801,47,103,77,96,99,89,62,43,511,105,616,17.045454545454547
9111,330330205000802,38,54,60,62,74,71,44,33,359,77,436,17.660550458715598
9112,330330205000803,26,40,59,39,48,53,46,30,265,76,341,22.287390029325515
9113,330330205000804,63,55,79,98,69,68,47,39,432,86,518,16.602316602316602
9114,330330205000805,44,77,51,56,104,71,30,21,403,51,454,11.233480176211454
9115,330330205000808,46,77,116,88,99,111,65,56,537,121,658,18.38905775075988
9116,330330205000809,90,124,130,156,165,136,82,64,801,146,947,15.417106652587117
9117,330330205000810,86,82,87,86,60,48,23,17,449,40,489,8.1799591002045
9118,330330205000811,33,39,31,48,50,27,33,20,228,53,281,18.86120996441281
9119,330330205000812,61,67,78,59,65,85,54,34,415,88,503,17.495029821073558
9120,330330205000813,59,88,74,62,89,65,25,19,437,44,481,9.147609147609147
9121,330330205000814,72,78,106,79,69,53,26,23,457,49,506,9.683794466403162
9122,330330205000815,120,149,157,208,153,115,80,36,902,116,1018,11.394891944990176
9123,330330205000816,36,85,54,50,103,69,26,9,397,35,432,8.101851851851851
9124,330330205000817,10,7,12,19,13,16,3,2,77,5,82,6.097560975609756
9125,330330205000819,31,25,54,73,53,47,46,35,283,81,364,22.252747252747252
9126,330330205000820,43,36,101,71,63,70,66,56,384,122,506,24.110671936758894
9127,330330205000821,46,63,74,91,79,75,36,32,428,68,496,13.709677419354838
9128,330330205000822,147,195,229,262,219,172,90,72,1224,162,1386,11.688311688311689
9129,330330205000823,106,81,78,71,51,30,18,16,417,34,451,7.5388026607538805
9130,330330205000824,26,42,66,63,70,76,51,58,343,109,452,24.115044247787612
9131,330330205000825,160,115,69,153,141,80,37,18,718,55,773,7.115135834411384
9132,330330205000826,41,30,48,77,44,36,28,16,276,44,320,13.75
9133,330330205000827,40,55,70,62,84,73,73,56,384,129,513,25.146198830409357
9134,330330205000828,55,72,62,75,66,56,24,10,386,34,420,8.095238095238095
9135,330330205000829,19,15,11,17,10,5,5,2,77,7,84,8.333333333333334
9138,330330205000832,21,24,28,25,27,26,11,14,151,25,176,14.204545454545455
9139,330330205000833,15,17,16,21,17,10,11,6,96,17,113,15.044247787610619
9140,330330205000834,41,27,41,31,27,19,15,6,186,21,207,10.144927536231885
9141,330330205000835,56,73,66,54,52,39,22,9,340,31,371,8.355795148247978
9143,330330205000837,69,80,43,56,53,36,19,15,337,34,371,9.164420485175203
9144,330330205000838,7,19,14,14,16,17,20,6,87,26,113,23.008849557522122
9145,330330205000839,55,96,71,77,72,71,42,33,442,75,517,14.506769825918763
9146,330330205000840,113,45,100,71,12,16,23,11,357,34,391,8.695652173913043
9148,330330205000842,37,51,76,85,50,35,14,9,334,23,357,6.442577030812325
9149,330330205000843,25,21,39,28,25,25,3,14,163,17,180,9.444444444444445
9150,330330205000844,57,54,73,68,47,23,18,7,322,25,347,7.204610951008646
9151,330330205000845,92,147,152,135,119,87,45,26,732,71,803,8.84184308841843
9152,330330205000846,63,54,54,59,41,24,24,12,295,36,331,10.876132930513595
9153,330330205000847,43,55,54,35,22,25,20,6,234,26,260,10.0
9154,330330205000848,141,108,174,115,75,60,38,12,673,50,723,6.915629322268327
9155,330330205000849,97,130,117,102,82,73,35,33,601,68,669,10.164424514200299
9156,330330205000850,47,48,49,55,37,38,17,17,274,34,308,11.03896103896104
9157,330330205000851,13,38,25,25,16,15,19,8,132,27,159,16.9811320754717
9158,330330205000852,125,108,213,163,147,148,88,98,904,186,1090,17.06422018348624
9159,330330205000853,30,18,38,27,16,9,9,1,138,10,148,6.756756756756757
9160,330330205000854,135,176,121,113,76,42,24,14,663,38,701,5.420827389443652
9161,330330205000856,176,195,209,151,134,83,35,17,948,52,1000,5.2
9162,330330205000857,19,28,12,17,12,4,1,2,92,3,95,3.1578947368421053
9163,330330205000859,2,1,3,5,2,6,3,2,19,5,24,20.833333333333332
9165,330330205000861,20,29,13,23,15,11,9,6,111,15,126,11.904761904761905
9167,330330205000863,15,18,15,24,13,10,5,4,95,9,104,8.653846153846153
9168,330330205000864,35,52,45,45,42,29,14,16,248,30,278,10.79136690647482
9169,330330205000865,67,79,60,57,46,39,17,10,348,27,375,7.2
9170,330330205000866,74,73,50,48,34,32,18,11,311,29,340,8.529411764705882
9172,330330205000868,53,71,60,72,57,23,12,8,336,20,356,5.617977528089888
9173,330330205000869,67,116,80,77,66,49,15,6,455,21,476,4.411764705882353
9174,330330205000870,62,70,67,61,49,28,29,10,337,39,376,10.372340425531915
9175,330330205000871,50,60,40,55,35,27,16,4,267,20,287,6.968641114982578
9176,330330205000872,95,103,110,92,73,59,26,13,532,39,571,6.830122591943958
9177,330330205000873,89,105,53,61,49,26,12,1,383,13,396,3.282828282828283
9178,330330205000874,81,129,127,115,93,61,28,18,606,46,652,7.0552147239263805
9179,330330205000875,59,94,162,135,69,27,38,2,546,40,586,6.825938566552901
9180,330330205000876,31,28,33,27,31,19,18,11,169,29,198,14.646464646464647
9181,330330205000877,44,63,52,45,26,25,12,3,255,15,270,5.555555555555555
9182,330330205000878,9,13,13,8,20,19,7,8,82,15,97,15.463917525773196
9183,330330205000879,20,24,44,33,38,42,26,30,201,56,257,21.78988326848249
9184,330330205000880,90,89,73,91,77,53,36,13,473,49,522,9.386973180076629
9185,330330205000881,18,26,20,24,18,19,10,7,125,17,142,11.971830985915492
9186,330330205000882,17,32,25,28,23,16,11,4,141,15,156,9.615384615384615
9187,330330205000883,88,128,139,122,92,86,49,33,655,82,737,11.12618724559023
9188,330330205000884,36,40,49,41,50,32,29,19,248,48,296,16.216216216216218
9189,330330205000885,35,34,27,51,43,33,19,20,223,39,262,14.885496183206106
9190,330330205000886,43,30,34,60,39,15,7,4,221,11,232,4.741379310344827
9192,330330205000889,5,6,12,8,9,7,11,4,47,15,62,24.193548387096776
9193,330330205000890,34,42,41,81,41,18,6,5,257,11,268,4.104477611940299
9194,330330205000891,7,11,16,15,11,13,5,5,73,10,83,12.048192771084338
9195,330330205000892,24,29,46,29,33,27,19,25,188,44,232,18.96551724137931
9196,330330205000893,15,22,11,7,7,5,1,1,67,2,69,2.898550724637681
9197,330330205000894,75,87,76,63,71,54,33,14,426,47,473,9.936575052854122
9198,330330205000895,25,29,26,21,11,27,1,2,139,3,142,2.112676056338028
9199,330330205000896,16,15,16,12,17,5,4,4,81,8,89,8.98876404494382
9200,330330205000897,38,33,60,53,32,20,7,11,236,18,254,7.086614173228346
9201,330330205000898,66,62,37,41,30,14,6,5,250,11,261,4.21455938697318
9202,330330205000899,10,10,6,13,14,8,4,4,61,8,69,11.594202898550725
9203,330330205000900,23,28,27,23,17,21,25,12,139,37,176,21.022727272727273
9204,330330205000901,35,34,34,37,28,17,8,4,185,12,197,6.091370558375634
9205,330330205000902,7,2,13,6,4,4,3,1,36,4,40,10.0
9206,330330205000903,4,9,5,7,5,8,6,13,38,19,57,33.333333333333336
9207,330330205000904,29,35,15,33,23,15,7,1,150,8,158,5.063291139240507
9208,330330205000905,72,60,95,119,112,106,40,58,564,98,662,14.803625377643504
9209,330330205000906,70,84,116,90,94,137,96,39,591,135,726,18.59504132231405
9210,330330205000907,103,111,143,133,94,110,60,43,694,103,797,12.923462986198244
9211,330340105000001,21,34,50,44,53,69,54,78,271,132,403,32.754342431761785
9212,330340105000002,37,56,87,59,79,90,64,67,408,131,539,24.304267161410017
9213,330340105000003,40,48,60,73,76,67,66,61,364,127,491,25.865580448065174
9214,330340105000004,52,48,68,85,79,67,70,54,399,124,523,23.709369024856596
9215,330340105000005,37,79,93,80,104,93,55,69,486,124,610,20.327868852459016
9216,330340105000006,68,102,91,106,129,123,86,82,619,168,787,21.346886912325285
9217,330340105000007,36,47,75,58,55,62,41,43,333,84,417,20.14388489208633
9218,330340105000008,39,81,67,70,81,91,71,70,429,141,570,24.736842105263158
9219,330340105000009,42,44,75,63,69,71,55,46,364,101,465,21.72043010752688
9220,330340105000010,57,100,105,111,120,78,67,72,571,139,710,19.577464788732396
9221,330340105000011,91,131,181,133,139,144,98,94,819,192,1011,18.991097922848663
9222,330340105000012,51,70,106,85,101,110,79,98,523,177,700,25.285714285714285
9223,330340105000013,49,64,48,71,68,60,51,71,360,122,482,25.311203319502074
9224,330340105000014,76,85,110,108,101,105,66,60,585,126,711,17.72151898734177
9225,330340105000015,32,54,60,54,63,83,37,50,346,87,433,20.092378752886837
9226,330340105000016,32,55,56,49,45,49,27,37,286,64,350,18.285714285714285
9227,330340105000017,19,60,81,52,56,62,53,59,330,112,442,25.339366515837103
9228,330340105000018,16,25,50,18,31,28,19,33,168,52,220,23.636363636363637
9229,330340105000019,25,67,99,51,83,70,50,70,395,120,515,23.300970873786408
9230,330340105000020,32,46,39,58,48,44,51,48,267,99,366,27.049180327868854
9231,330340105000021,65,77,82,93,96,77,71,89,490,160,650,24.615384615384617
9232,330340105000022,16,36,35,27,35,60,44,97,209,141,350,40.285714285714285
9233,330340105000023,55,52,75,71,74,74,70,98,401,168,569,29.52548330404218
9234,330340105000024,59,98,101,104,129,101,84,116,592,200,792,25.252525252525253
9235,330340105000025,38,59,90,55,81,73,69,76,396,145,541,26.80221811460259
9236,330340105000026,21,41,62,47,53,67,68,88,291,156,447,34.899328859060404
9237,330340105000027,40,38,61,72,61,60,70,108,332,178,510,34.90196078431372
9238,330340105000028,24,31,48,56,54,41,56,86,254,142,396,35.85858585858586
9239,330340105000029,42,47,92,67,59,75,57,70,382,127,509,24.95088408644401
9240,330340105000030,33,38,62,60,43,56,44,34,292,78,370,21.08108108108108
9241,330340105000031,43,57,82,71,74,84,49,57,411,106,517,20.502901353965182
9242,330340105000032,62,79,110,91,113,114,67,60,569,127,696,18.24712643678161
9243,330340105000033,46,61,54,68,67,63,68,37,359,105,464,22.629310344827587
9244,330340105000034,24,26,29,21,29,26,28,33,155,61,216,28.24074074074074
9245,330340105000035,25,51,70,49,70,61,47,51,326,98,424,23.11320754716981
9246,330340105000036,75,102,118,92,106,93,65,65,586,130,716,18.156424581005588
9247,330340105000037,56,64,58,88,60,58,39,29,384,68,452,15.044247787610619
9248,330340105000038,115,103,117,107,106,103,58,43,651,101,752,13.430851063829786
9249,330340105000039,92,118,132,119,127,102,81,57,690,138,828,16.666666666666668
9250,330340105000040,98,104,120,109,106,100,57,41,637,98,735,13.333333333333334
9251,330340105000041,75,82,85,70,71,86,45,35,469,80,549,14.571948998178506
9252,330340105000042,51,68,75,66,48,59,43,28,367,71,438,16.210045662100455
9253,330340105000043,87,89,116,109,91,119,78,65,611,143,754,18.96551724137931
9254,330340105000044,39,72,95,65,94,77,75,75,442,150,592,25.33783783783784
9255,330340105000045,47,68,88,68,73,81,53,71,425,124,549,22.586520947176684
9256,330340105000046,65,89,83,104,91,105,51,52,537,103,640,16.09375
9257,330340105000047,84,109,105,90,110,78,63,50,576,113,689,16.400580551523948
9258,330340105000048,95,100,130,109,115,103,58,49,652,107,759,14.097496706192358
9259,330340105000049,99,120,123,122,120,87,61,38,671,99,770,12.857142857142858
9260,330340105000050,101,102,133,122,97,91,62,34,646,96,742,12.93800539083558
9261,330340105000051,71,112,96,90,122,79,57,54,570,111,681,16.29955947136564
9262,330340105000052,51,72,93,67,71,73,45,27,427,72,499,14.428857715430862
9263,330340105000053,85,96,119,107,104,93,60,57,604,117,721,16.22746185852982
9264,330340105000054,53,77,108,86,116,102,108,95,542,203,745,27.248322147651006
9265,330340105000055,40,80,81,100,74,96,59,70,471,129,600,21.5
9266,330340105000056,56,67,47,60,62,44,28,30,336,58,394,14.720812182741117
9267,330340105000057,28,47,31,33,44,22,12,10,205,22,227,9.691629955947137
9268,330340105000058,54,72,89,69,80,93,58,56,457,114,571,19.964973730297725
9269,330340105000059,57,81,108,104,82,107,52,50,539,102,641,15.912636505460219
9270,330340105000060,84,119,137,142,132,98,74,53,712,127,839,15.137067938021454
9271,330340105000061,86,102,98,79,81,77,46,36,523,82,605,13.553719008264462
9272,330340105000062,106,132,113,107,117,78,40,34,653,74,727,10.178817056396149
9273,330340105000063,69,105,110,96,79,82,50,36,541,86,627,13.716108452950559
9274,330340105000064,94,130,140,105,116,89,59,31,674,90,764,11.780104712041885
9275,330340105000065,104,147,123,131,109,114,64,39,728,103,831,12.394705174488568
9276,330340105000066,109,129,116,121,120,67,46,28,662,74,736,10.054347826086957
9277,330340105000067,101,105,116,99,82,81,45,31,584,76,660,11.515151515151516
9278,330340105000068,36,58,58,59,74,34,19,18,319,37,356,10.393258426966293
9279,330340105000069,79,109,104,106,101,75,35,42,574,77,651,11.827956989247312
9280,330340105000070,59,64,70,71,101,97,55,44,462,99,561,17.647058823529413
9281,330340105000071,112,133,148,140,116,100,58,39,749,97,846,11.465721040189125
9282,330340105000072,66,86,90,88,90,101,36,55,521,91,612,14.869281045751634
9283,330340105000073,23,20,25,33,35,24,17,18,160,35,195,17.94871794871795
9284,330340105000074,19,40,36,38,48,42,33,29,223,62,285,21.75438596491228
9285,330340105000075,68,53,44,61,74,47,27,18,347,45,392,11.479591836734693
9286,330340105000076,113,132,143,143,163,143,82,57,837,139,976,14.241803278688524
9287,330340105000077,40,60,92,81,68,79,41,26,420,67,487,13.757700205338809
9288,330340105000078,79,82,62,119,124,66,45,45,532,90,622,14.469453376205788
9289,330340105000079,150,160,206,240,182,112,83,31,1050,114,1164,9.793814432989691
9290,330340105000080,45,73,68,84,61,52,44,33,383,77,460,16.73913043478261
9291,330340105000081,50,75,54,84,72,73,55,30,408,85,493,17.24137931034483
9292,330340105000082,29,34,32,30,47,46,18,30,218,48,266,18.045112781954888
9293,330340105000083,43,56,38,42,71,35,36,23,285,59,344,17.151162790697676
9294,330340105000084,137,156,134,174,146,107,51,32,854,83,937,8.858057630736393
9295,330340105000085,100,86,87,145,118,74,46,39,610,85,695,12.23021582733813
9296,330340105000086,147,219,176,164,172,116,59,32,994,91,1085,8.387096774193548
9297,330340105000087,30,36,52,40,41,29,21,23,228,44,272,16.176470588235293
9298,330340105000088,93,100,97,88,95,55,47,32,528,79,607,13.014827018121911
9299,330340105000089,41,59,69,50,59,50,42,28,328,70,398,17.587939698492463
9300,330340105000090,47,45,56,52,56,58,42,42,314,84,398,21.105527638190956
9301,330340105000091,31,31,60,60,57,54,55,55,293,110,403,27.29528535980149
9302,330340105000092,7,12,3,15,14,8,13,4,59,17,76,22.36842105263158
9303,330340105000093,19,42,31,40,45,46,30,23,223,53,276,19.202898550724637
9304,330340105000094,62,100,96,87,161,118,37,71,624,108,732,14.754098360655737
9305,330340105000095,62,100,112,107,126,87,83,79,594,162,756,21.428571428571427
9306,330340105000096,53,72,91,91,108,58,71,65,473,136,609,22.33169129720854
9307,330340105000097,74,76,104,85,110,102,60,74,551,134,685,19.562043795620436
9308,330340105000098,60,60,71,84,65,85,68,69,425,137,562,24.377224199288257
9309,330340105000099,34,55,52,53,56,55,44,45,305,89,394,22.588832487309645
9310,330340105000100,40,62,87,80,70,88,70,49,427,119,546,21.794871794871796
9311,330340105000101,59,96,118,99,104,109,59,53,585,112,697,16.068866571018653
9312,330340105000102,72,93,87,102,97,87,45,40,538,85,623,13.643659711075442
9313,330340105000103,46,68,56,72,55,60,36,41,357,77,434,17.741935483870968
9314,330340105000104,111,138,171,125,148,127,60,49,820,109,929,11.733046286329387
9315,330340105000105,147,186,145,180,174,117,79,60,949,139,1088,12.775735294117647
9316,330340105000106,98,128,97,109,101,87,34,33,620,67,687,9.75254730713246
9317,330340105000107,106,115,133,117,121,89,56,46,681,102,783,13.026819923371647
9318,330340105000108,64,83,87,93,91,56,39,38,474,77,551,13.97459165154265
9319,330340105000109,25,29,29,26,25,20,9,11,154,20,174,11.494252873563218
9320,330340105000110,110,141,119,123,133,89,63,39,715,102,817,12.48470012239902
9321,330340105000111,71,96,84,80,92,79,68,45,502,113,615,18.3739837398374
9322,330340105000112,43,35,38,60,45,39,24,8,260,32,292,10.95890410958904
9323,330340105000113,88,102,88,105,77,65,27,32,525,59,584,10.102739726027398
9324,330340105000114,75,97,79,66,44,54,27,20,415,47,462,10.173160173160174
9325,330340105000115,50,59,55,96,69,49,38,15,378,53,431,12.296983758700696
9326,330340105000116,36,48,65,49,56,69,30,27,323,57,380,15.0
9327,330340105000117,64,65,79,65,59,77,38,21,409,59,468,12.606837606837606
9328,330340105000118,46,65,52,51,34,14,16,11,262,27,289,9.342560553633218
9329,330340105000119,24,18,36,30,23,17,18,7,148,25,173,14.45086705202312
9330,330340105000120,108,130,128,127,118,108,69,59,719,128,847,15.112160566706022
9331,330340105000121,57,62,83,82,76,94,54,43,454,97,551,17.604355716878402
9332,330340105000122,98,92,149,106,113,97,70,69,655,139,794,17.506297229219143
9333,330340105000123,49,68,83,68,65,48,25,16,381,41,422,9.71563981042654
9334,330340105000124,93,109,112,101,117,74,52,39,606,91,697,13.055954088952655
9335,330340105000125,41,41,37,57,45,40,32,19,261,51,312,16.346153846153847
9336,330340105000126,116,137,122,148,112,92,61,40,727,101,828,12.198067632850242
9337,330340105000127,49,72,81,96,72,60,43,50,430,93,523,17.782026768642446
9338,330340105000128,135,173,158,166,191,133,80,68,956,148,1104,13.405797101449275
9339,330340105000129,12,7,30,17,5,7,7,7,78,14,92,15.217391304347826
9340,330340105000130,72,102,117,109,138,106,55,43,644,98,742,13.20754716981132
9341,330340105000131,43,49,74,76,56,63,53,29,361,82,443,18.510158013544018
9342,330340105000132,45,62,75,61,102,65,57,47,410,104,514,20.233463035019454
9343,330340105000133,43,59,63,61,62,69,54,30,357,84,441,19.047619047619047
9344,330340105000134,51,107,77,84,129,83,50,50,531,100,631,15.847860538827259
9345,330340105000135,75,91,78,99,121,80,44,33,544,77,621,12.399355877616747
9346,330340105000136,56,89,86,101,85,62,30,32,479,62,541,11.460258780036968
9347,330340105000137,54,81,78,83,94,78,49,44,468,93,561,16.577540106951872
9348,330340105000138,45,43,84,52,52,60,40,38,336,78,414,18.840579710144926
9349,330340105000139,131,141,152,149,134,120,70,50,827,120,947,12.671594508975712
9350,330340105000140,148,170,170,168,167,128,63,46,951,109,1060,10.283018867924529
9351,330340105000141,63,91,72,90,73,59,33,24,448,57,505,11.287128712871286
9352,330340105000142,157,200,158,206,145,129,70,26,995,96,1091,8.799266727772686
9353,330340105000143,148,149,168,116,111,81,45,31,773,76,849,8.95170789163722
9354,330340105000144,103,144,149,160,161,90,54,52,807,106,913,11.610076670317634
9355,330340105000145,20,25,24,25,22,24,31,19,140,50,190,26.31578947368421
9356,330340105000146,65,108,102,95,102,82,55,46,554,101,655,15.419847328244275
9357,330340105000147,105,108,173,149,134,119,61,35,788,96,884,10.85972850678733
9358,330340105000148,48,51,60,59,63,57,31,21,338,52,390,13.333333333333334
9359,330340105000149,141,195,291,183,252,129,65,27,1191,92,1283,7.1706936866718625
9360,330340105000150,62,87,96,91,99,82,57,48,517,105,622,16.881028938906752
9361,330340105000151,38,60,72,59,80,60,30,45,369,75,444,16.89189189189189
9362,330340105000152,125,128,92,127,112,65,48,35,649,83,732,11.33879781420765
9363,330340105000153,127,127,132,135,89,89,48,22,699,70,769,9.102730819245775
9364,330340105000154,157,199,182,186,196,134,63,51,1054,114,1168,9.76027397260274
9365,330340105000155,73,81,77,85,80,56,29,18,452,47,499,9.418837675350701
9366,330340105000156,50,67,70,55,68,57,36,26,367,62,429,14.452214452214452
9367,330340105000157,22,23,23,30,13,17,17,5,128,22,150,14.666666666666666
9368,330340105000158,135,118,132,125,106,102,47,38,718,85,803,10.58530510585305
9369,330340105000159,25,21,27,25,18,34,8,10,150,18,168,10.714285714285714
9370,330340105000160,146,174,167,182,180,121,68,33,970,101,1071,9.430438842203548
9371,330340105000161,190,183,233,189,191,159,72,46,1145,118,1263,9.34283452098179
9372,330340105000162,22,29,22,22,18,16,18,4,129,22,151,14.56953642384106
9373,330340105000163,17,33,31,13,37,32,12,29,163,41,204,20.098039215686274
9374,330340105000164,83,96,85,133,129,87,59,30,613,89,702,12.678062678062679
9375,330340105000165,53,87,107,109,105,91,71,74,552,145,697,20.803443328550934
9376,330340105000166,81,123,123,138,102,99,55,30,666,85,751,11.318242343541945
9377,330340105000167,40,77,73,80,72,65,60,42,407,102,509,20.039292730844792
9378,330340105000168,19,45,70,33,58,43,23,27,268,50,318,15.723270440251572
9379,330340105000169,77,80,87,55,77,46,33,23,422,56,478,11.715481171548117
9380,330340105000170,12,18,24,18,21,24,20,9,117,29,146,19.863013698630137
9381,330340105000171,69,112,127,98,112,96,56,46,614,102,716,14.245810055865922
9382,330340105000172,139,133,161,148,140,104,56,43,825,99,924,10.714285714285714
9383,330340105000173,121,164,103,135,125,100,54,28,748,82,830,9.879518072289157
9384,330340105000174,25,49,44,36,58,58,38,48,270,86,356,24.15730337078652
9385,330340105000175,38,66,84,66,79,80,66,61,413,127,540,23.51851851851852
9386,330340105000176,31,46,51,39,38,57,30,40,262,70,332,21.08433734939759
9387,330340105000177,17,31,39,40,50,32,24,19,209,43,252,17.063492063492063
9388,330340105000178,50,54,71,86,78,50,37,34,389,71,460,15.434782608695652
9389,330340105000179,19,24,35,26,35,28,24,14,167,38,205,18.536585365853657
9390,330340105000180,33,38,28,43,47,50,35,16,239,51,290,17.586206896551722
9391,330340105000181,108,114,123,155,138,114,107,62,752,169,921,18.349619978284473
9392,330340105000182,39,52,33,47,43,30,21,23,244,44,288,15.277777777777779
9393,330340105000183,36,26,58,53,39,39,38,26,251,64,315,20.317460317460316
9394,330340105000184,31,39,30,36,26,21,16,9,183,25,208,12.01923076923077
9395,330340105000185,38,42,63,55,51,60,37,30,309,67,376,17.819148936170212
9396,330340105000186,98,112,128,149,116,103,78,45,706,123,829,14.837153196622436
9397,330340105000187,23,44,37,43,51,52,30,38,250,68,318,21.38364779874214
9398,330340105000188,83,100,125,101,105,85,44,30,599,74,673,10.99554234769688
9399,330340105000189,75,72,68,62,40,32,16,9,349,25,374,6.684491978609626
9400,330340105000190,27,44,42,47,56,44,28,27,260,55,315,17.46031746031746
9401,330340105000191,30,54,63,41,50,43,35,18,281,53,334,15.868263473053892
9402,330340105000192,66,83,72,83,94,73,77,83,471,160,631,25.356576862123614
9403,330340105000193,45,50,52,51,58,34,18,16,290,34,324,10.493827160493828
9404,330340105000194,42,75,84,80,67,66,40,23,414,63,477,13.20754716981132
9405,330340105000195,76,82,77,80,78,57,41,20,450,61,511,11.937377690802348
9406,330340105000196,47,44,59,35,43,34,29,25,262,54,316,17.088607594936708
9407,330340105000197,41,48,38,65,38,25,28,19,255,47,302,15.562913907284768
9408,330340105000198,86,88,111,94,109,68,50,46,556,96,652,14.723926380368098
9409,330340105000199,67,69,73,88,56,60,31,28,413,59,472,12.5
9410,330340110000001,45,51,39,48,56,34,18,17,273,35,308,11.363636363636363
9411,330340110000002,53,68,95,69,74,69,52,29,428,81,509,15.913555992141454
9412,330340110000003,93,133,126,97,133,119,61,42,701,103,804,12.810945273631841
9413,330340110000004,33,23,27,30,31,29,19,22,173,41,214,19.1588785046729
9414,330340110000005,119,141,129,154,135,102,63,61,780,124,904,13.716814159292035
9415,330340110000006,160,211,179,208,155,126,86,70,1039,156,1195,13.05439330543933
9416,330340110000007,4,2,5,3,5,4,2,2,23,4,27,14.814814814814815
9417,330340110000008,84,90,78,92,65,54,38,34,463,72,535,13.457943925233645
9418,330340110000009,18,28,21,25,25,19,17,10,136,27,163,16.56441717791411
9419,330340110000010,25,41,59,35,34,35,17,15,229,32,261,12.260536398467433
9420,330340115000001,133,130,111,162,114,99,45,42,749,87,836,10.4066985645933
9421,330340115000002,166,216,183,185,164,144,70,49,1058,119,1177,10.110450297366185
9422,330340115000003,120,137,136,123,111,79,52,43,706,95,801,11.860174781523096
9423,330340115000004,20,28,18,24,23,17,5,4,130,9,139,6.474820143884892
9424,330340115000005,32,57,25,40,32,18,10,4,204,14,218,6.422018348623853
9425,330340115000006,156,216,203,194,138,117,80,50,1024,130,1154,11.265164644714039
9426,330340115000007,102,103,121,102,73,64,43,33,565,76,641,11.856474258970358
9427,330340115000008,150,184,139,165,141,85,58,43,864,101,965,10.466321243523316
9428,330340115000009,53,66,57,44,35,40,16,5,295,21,316,6.6455696202531644
9429,330340115000010,45,73,72,62,49,39,28,12,340,40,380,10.526315789473685
9430,330340115000011,114,155,119,121,129,63,61,34,701,95,796,11.93467336683417
9431,330340115000012,97,153,123,128,108,64,40,30,673,70,743,9.421265141318978
9432,330340115000013,62,79,67,73,59,46,23,15,386,38,424,8.962264150943396
9433,330340115000014,116,132,145,145,109,84,34,35,731,69,800,8.625
9434,330340115000015,105,119,89,111,65,58,29,22,547,51,598,8.528428093645484
9435,330340115000016,19,10,17,11,9,7,4,2,73,6,79,7.594936708860759
9436,330340120000001,28,30,33,28,36,28,18,25,183,43,226,19.02654867256637
9437,330340120000002,85,86,107,101,91,66,30,27,536,57,593,9.612141652613827
9438,330340120000003,80,110,131,112,104,99,54,43,636,97,733,13.233287858117325
9439,330340120000004,87,144,116,109,119,91,54,36,666,90,756,11.904761904761905
9440,330340120000005,60,100,103,88,96,75,56,30,522,86,608,14.144736842105264
9441,330340120000006,75,85,93,106,83,74,31,18,516,49,565,8.672566371681416
9442,330340120000007,91,132,97,116,113,78,37,24,627,61,688,8.866279069767442
9443,330340120000008,75,71,95,88,61,67,34,22,457,56,513,10.916179337231968
9444,330340120000009,102,100,98,114,111,67,45,28,592,73,665,10.977443609022556
9445,330340120000010,157,159,188,175,175,113,61,32,967,93,1060,8.773584905660377
9446,330340120000011,166,196,188,208,226,125,71,56,1109,127,1236,10.275080906148867
9447,330340120000012,134,127,177,144,134,84,47,23,800,70,870,8.045977011494253
9448,330340120000013,144,151,158,195,154,108,34,28,910,62,972,6.378600823045267
9449,330340120000014,103,129,147,146,112,100,58,36,737,94,831,11.311672683513839
9450,330340120000015,57,77,113,115,86,105,55,49,553,104,657,15.82952815829528
9451,330340120000016,77,114,135,112,143,98,42,33,679,75,754,9.946949602122016
9452,330340120000017,91,143,126,116,109,82,39,24,667,63,730,8.63013698630137
9453,330340120000018,78,77,79,89,88,52,43,37,463,80,543,14.732965009208103
9454,330340120000019,65,73,86,55,85,58,37,30,422,67,489,13.701431492842536
9455,330340120000020,73,71,82,79,61,60,31,24,426,55,481,11.434511434511435
9456,330340120000021,127,148,152,122,120,94,55,35,763,90,853,10.550996483001173
9457,330340120000022,99,100,160,131,111,85,59,30,686,89,775,11.483870967741936
9458,330340120000023,180,207,234,187,157,146,61,33,1111,94,1205,7.800829875518672
9459,330340120000024,61,53,41,49,30,23,20,8,257,28,285,9.824561403508772
9460,330340120000025,197,212,157,155,118,64,55,23,903,78,981,7.951070336391437
9461,330340120000026,98,126,82,95,73,54,29,24,528,53,581,9.122203098106713
9462,330340120000027,122,125,114,113,86,70,49,23,630,72,702,10.256410256410257
9463,330340120000028,146,168,188,136,151,132,64,43,921,107,1028,10.408560311284047
9464,330340120000029,247,276,282,265,267,169,100,53,1506,153,1659,9.22242314647378
9465,330340120000030,90,112,115,120,107,71,55,44,615,99,714,13.865546218487395
9466,330340120000031,137,130,139,208,119,84,72,45,817,117,934,12.526766595289079
9467,330340120000032,96,98,118,126,109,101,65,56,648,121,769,15.734720416124837
9468,330340120000033,79,90,72,102,79,50,40,23,472,63,535,11.77570093457944
9469,330340120000034,150,198,144,138,125,77,38,24,832,62,894,6.935123042505593
9470,330340120000035,131,156,171,170,126,104,52,42,858,94,952,9.873949579831933
9471,330340120000036,164,122,149,155,110,87,55,30,787,85,872,9.747706422018348
9472,330340120000037,60,52,85,78,68,44,32,23,387,55,442,12.44343891402715
9473,330340120000038,109,142,159,192,117,92,50,28,811,78,889,8.773903262092238
9474,330340120000039,48,39,42,29,25,18,12,6,201,18,219,8.219178082191782
9475,330340120000040,55,48,67,85,77,62,25,33,394,58,452,12.831858407079647
9476,330340120000041,55,98,81,70,82,53,25,23,439,48,487,9.856262833675565
9477,330340120000042,67,65,73,68,58,39,20,24,370,44,414,10.628019323671497
9478,330340120000043,108,113,140,104,107,82,46,29,654,75,729,10.2880658436214
9479,330340120000044,160,197,184,203,173,107,67,31,1024,98,1122,8.73440285204991
9480,330340125000001,28,49,47,51,43,49,33,23,267,56,323,17.3374613003096
9481,330340125000002,54,72,66,87,104,84,52,36,467,88,555,15.855855855855856
9482,330340125000003,44,55,67,83,76,64,32,21,389,53,442,11.990950226244344
9483,330340125000004,55,88,90,87,104,74,46,31,498,77,575,13.391304347826088
9484,330340125000005,33,63,44,54,47,55,32,28,296,60,356,16.853932584269664
9485,330340125000006,9,7,23,14,12,16,11,8,81,19,100,19.0
9486,330340125000007,3,4,7,5,4,3,0,3,26,3,29,10.344827586206897
9487,330340125000008,73,90,80,86,86,72,37,14,487,51,538,9.479553903345725
9488,330340125000009,22,43,54,40,55,48,18,27,262,45,307,14.657980456026058
9489,330340125000010,64,78,66,75,75,73,40,43,431,83,514,16.147859922178988
9490,330340125000011,46,43,48,66,49,43,34,21,295,55,350,15.714285714285714
9491,330340125000012,25,29,33,35,33,32,16,18,187,34,221,15.384615384615385
9492,330340125000013,55,69,51,73,69,40,30,23,357,53,410,12.926829268292684
9493,330340127000001,85,102,109,91,128,76,56,36,591,92,683,13.469985358711567
9494,330340127000002,138,149,159,139,151,103,66,35,839,101,940,10.74468085106383
9495,330340127000003,25,41,29,44,43,24,36,23,206,59,265,22.264150943396228
9496,330340127000004,72,85,84,86,77,67,40,40,471,80,551,14.519056261343012
9497,330340127000005,81,110,90,117,108,94,68,68,600,136,736,18.47826086956522
9498,330340127000006,70,102,94,113,153,79,64,49,611,113,724,15.607734806629834
9499,330340127000007,22,32,32,30,42,33,23,21,191,44,235,18.72340425531915
9500,330340127000008,17,38,36,30,50,46,33,21,217,54,271,19.92619926199262
9501,330340127000009,19,16,24,24,18,11,10,14,112,24,136,17.647058823529413
9502,330340127000010,30,52,38,36,46,33,9,15,235,24,259,9.266409266409266
9503,330340127000011,4,0,7,1,3,3,1,0,18,1,19,5.2631578947368425
9504,330340127000012,34,34,27,31,36,16,21,11,178,32,210,15.238095238095237
9505,330340127000013,95,132,122,102,149,106,83,54,706,137,843,16.251482799525505
9506,330340130000001,133,159,194,187,143,118,82,54,934,136,1070,12.710280373831775
9507,330340130000002,97,95,124,111,99,88,39,39,614,78,692,11.271676300578035
9508,330340130000003,74,93,89,105,95,69,77,47,525,124,649,19.106317411402156
9509,330340130000004,91,124,120,108,108,120,59,53,671,112,783,14.303959131545339
9510,330340130000005,229,286,294,260,192,174,72,52,1435,124,1559,7.953816549069916
9511,330340130000006,25,35,24,22,33,22,13,12,161,25,186,13.440860215053764
9512,330340130000007,156,198,151,199,172,117,52,46,993,98,1091,8.982584784601283
9513,330340130000008,92,109,100,99,91,66,42,29,557,71,628,11.305732484076433
9514,330340130000009,53,64,39,48,46,43,21,12,293,33,326,10.122699386503067
9515,330340130000010,80,79,83,68,65,33,25,13,408,38,446,8.52017937219731
9516,330340130000011,39,51,54,52,47,45,31,25,288,56,344,16.27906976744186
9517,330340135000001,35,41,49,35,55,46,27,32,261,59,320,18.4375
9518,330340135000002,22,27,6,20,43,30,9,6,148,15,163,9.202453987730062
9519,330340135000003,112,143,138,134,133,81,44,28,741,72,813,8.85608856088561
9520,330340135000004,40,42,57,52,47,47,24,22,285,46,331,13.897280966767372
9521,330340135000005,59,61,68,79,79,62,55,43,408,98,506,19.367588932806324
9522,330340135000006,123,164,154,157,170,139,78,40,907,118,1025,11.512195121951219
9524,330350005100002,34,47,74,37,66,74,36,43,332,79,411,19.221411192214113
9525,330350005100003,31,38,51,49,53,66,34,42,288,76,364,20.87912087912088
9526,330350005100004,29,49,57,65,65,74,45,53,339,98,437,22.42562929061785
9527,330350005100005,51,62,68,78,78,79,49,75,416,124,540,22.962962962962962
9528,330350005100006,61,58,85,78,88,70,37,58,440,95,535,17.757009345794394
9529,330350005100007,42,62,89,73,72,88,71,65,426,136,562,24.199288256227756
9530,330350005100008,48,95,130,116,100,116,54,47,605,101,706,14.305949008498583
9531,330350005100009,28,40,53,47,63,60,31,41,291,72,363,19.834710743801654
9532,330350005100010,50,68,83,91,116,107,59,66,515,125,640,19.53125
9533,330350005100011,38,83,87,58,94,78,53,53,438,106,544,19.485294117647058
9534,330350005100012,100,171,155,155,177,163,85,108,921,193,1114,17.32495511669659
9535,330350005100013,54,75,74,68,95,87,38,35,453,73,526,13.87832699619772
9536,330350005100014,57,73,81,73,96,93,70,50,473,120,593,20.236087689713322
9537,330350005100015,56,91,86,83,71,69,38,26,456,64,520,12.307692307692308
9538,330350005100016,66,106,98,91,73,70,27,33,504,60,564,10.638297872340425
9539,330350005100017,71,96,113,99,99,76,36,27,554,63,617,10.210696920583468
9540,330350005100018,73,87,86,79,84,65,33,29,474,62,536,11.567164179104477
9541,330350005100019,61,95,101,89,110,73,27,20,529,47,576,8.159722222222221
9542,330350005100020,116,146,150,163,133,85,68,31,793,99,892,11.09865470852018
9543,330350005100021,112,140,131,120,113,80,50,41,696,91,787,11.562897077509529
9544,330350005100022,97,113,126,122,126,98,56,20,682,76,758,10.026385224274406
9545,330350005100023,63,70,81,76,89,62,39,41,441,80,521,15.355086372360844
9546,330350005100024,169,188,158,178,163,112,69,43,968,112,1080,10.37037037037037
9547,330350005100025,63,93,101,96,77,96,70,44,526,114,640,17.8125
9548,330350005100026,122,188,174,201,167,179,129,89,1031,218,1249,17.45396317053643
9549,330350005100027,22,45,46,34,36,55,51,40,238,91,329,27.659574468085108
9550,330350005100028,49,74,82,57,84,92,39,40,438,79,517,15.28046421663443
9551,330350005100029,38,55,74,77,71,72,54,41,387,95,482,19.70954356846473
9552,330350005100030,74,109,114,87,101,100,50,38,585,88,673,13.075780089153046
9553,330350005100031,65,93,101,92,90,97,53,32,538,85,623,13.643659711075442
9554,330350005100032,71,80,90,67,64,68,22,28,440,50,490,10.204081632653061
9555,330350005100033,68,79,97,109,94,98,66,50,545,116,661,17.549167927382754
9556,330350005100034,68,70,67,77,67,54,35,28,403,63,466,13.51931330472103
9557,330350005100035,75,95,107,107,117,79,66,43,580,109,689,15.820029027576197
9558,330350005100036,49,70,77,83,91,60,52,47,430,99,529,18.714555765595463
9559,330350005100037,37,58,68,66,54,62,47,34,345,81,426,19.014084507042252
9560,330350005100038,83,115,129,138,120,119,57,46,704,103,807,12.763320941759604
9561,330350005100039,71,117,115,93,113,114,81,75,623,156,779,20.025673940949936
9562,330350005100040,87,116,112,134,123,96,64,54,668,118,786,15.012722646310433
9563,330350005100041,39,47,53,54,57,51,32,46,301,78,379,20.58047493403694
9564,330350005100042,53,75,67,78,100,76,72,76,449,148,597,24.79061976549414
9565,330350005100043,38,56,65,67,62,68,38,26,356,64,420,15.238095238095237
9566,330350005100044,51,97,95,101,96,103,78,53,543,131,674,19.43620178041543
9567,330350005100045,62,93,105,111,115,96,69,59,582,128,710,18.028169014084508
9568,330350005100046,55,123,123,85,111,137,81,103,634,184,818,22.493887530562347
9569,330350005100047,35,57,48,51,60,57,53,32,308,85,393,21.62849872773537
9570,330350005100048,61,85,67,88,81,78,44,54,460,98,558,17.56272401433692
9571,330350005100049,47,56,62,62,63,60,47,39,350,86,436,19.724770642201836
9572,330350005100050,51,79,87,94,64,88,46,33,463,79,542,14.575645756457565
9573,330350005100051,45,64,89,87,90,78,50,46,453,96,549,17.48633879781421
9574,330350005100052,71,86,93,115,99,87,66,55,551,121,672,18.00595238095238
9575,330350005100053,49,55,83,83,69,76,49,50,415,99,514,19.260700389105057
9576,330350005100054,14,26,22,39,27,23,12,8,151,20,171,11.695906432748538
9577,330350005100055,36,36,42,57,49,46,37,27,266,64,330,19.393939393939394
9578,330350005100056,43,52,62,60,52,46,39,33,315,72,387,18.6046511627907
9579,330350005100057,69,63,71,83,61,79,46,24,426,70,496,14.112903225806452
9580,330350005100058,41,50,63,66,66,54,42,48,340,90,430,20.930232558139537
9581,330350005100059,90,93,108,108,129,118,70,63,646,133,779,17.073170731707318
9582,330350005100060,43,63,57,63,72,53,42,44,351,86,437,19.679633867276888
9583,330350005100061,76,151,126,145,113,95,58,42,706,100,806,12.40694789081886
9584,330350005100062,62,77,93,85,82,77,45,29,476,74,550,13.454545454545455
9585,330350005100063,93,88,126,114,74,89,74,52,584,126,710,17.746478873239436
9586,330350005100064,83,99,117,108,88,80,47,33,575,80,655,12.213740458015268
9587,330350005100065,75,82,148,119,94,78,37,34,596,71,667,10.644677661169416
9588,330350005100066,42,75,133,65,60,43,28,29,418,57,475,12.0
9589,330350005100067,56,73,127,101,89,90,43,24,536,67,603,11.11111111111111
9590,330350005100068,81,89,115,137,95,82,48,23,599,71,670,10.597014925373134
9591,330350005100069,136,172,203,209,186,110,92,57,1016,149,1165,12.78969957081545
9592,330350005100070,85,99,155,113,100,97,78,43,649,121,770,15.714285714285714
9593,330350005100071,86,107,112,86,73,72,50,28,536,78,614,12.703583061889251
9594,330350005100072,59,89,68,94,74,64,23,7,448,30,478,6.2761506276150625
9595,330350005100073,138,149,177,124,134,103,58,47,825,105,930,11.290322580645162
9596,330350005100074,104,127,106,109,87,61,32,29,594,61,655,9.312977099236642
9597,330350005100075,143,144,138,131,102,62,49,31,720,80,800,10.0
9598,330350005100076,73,113,76,91,98,60,35,26,511,61,572,10.664335664335665
9599,330350005100077,131,163,129,135,138,92,63,55,788,118,906,13.024282560706402
9600,330350005100078,89,106,98,110,114,61,41,29,578,70,648,10.802469135802468
9601,330350005100079,84,106,101,83,95,55,23,33,524,56,580,9.655172413793103
9602,330350005100080,55,86,90,77,52,72,26,35,432,61,493,12.373225152129818
9603,330350005100081,114,155,124,116,82,61,37,17,652,54,706,7.648725212464589
9604,330350005100082,90,116,103,94,80,63,46,18,546,64,610,10.491803278688524
9605,330350005100083,120,155,145,191,131,119,90,52,861,142,1003,14.15752741774676
9606,330350005100084,77,104,106,93,100,93,67,44,573,111,684,16.228070175438596
9607,330350005100085,64,88,92,101,85,87,45,33,517,78,595,13.109243697478991
9608,330350005100086,88,122,105,114,101,78,41,37,608,78,686,11.370262390670554
9609,330350005100087,52,64,84,67,57,63,37,18,387,55,442,12.44343891402715
9610,330350005100088,96,138,120,107,97,119,59,49,677,108,785,13.757961783439491
9611,330350005100089,60,78,93,94,75,68,46,31,468,77,545,14.128440366972477
9612,330350005100090,45,66,52,69,49,47,33,26,328,59,387,15.24547803617571
9613,330350005100091,71,121,98,101,106,90,55,39,587,94,681,13.80323054331865
9614,330350005100092,68,80,108,83,100,80,59,53,519,112,631,17.74960380348653
9615,330350005100093,54,70,89,104,88,70,61,61,475,122,597,20.435510887772196
9616,330350005100094,38,75,113,98,97,92,63,61,513,124,637,19.46624803767661
9617,330350005100095,63,115,114,100,123,95,69,75,610,144,754,19.09814323607427
9618,330350005100096,55,98,76,85,106,87,51,60,507,111,618,17.961165048543688
9619,330350005100097,42,53,67,65,72,74,56,44,373,100,473,21.141649048625794
9620,330350005100098,29,53,59,55,52,47,45,36,295,81,376,21.54255319148936
9621,330350005100099,81,82,114,101,115,92,64,65,585,129,714,18.067226890756302
9622,330350005100100,63,96,89,74,82,52,33,35,456,68,524,12.977099236641221
9623,330350005100101,43,68,74,58,64,70,51,43,377,94,471,19.957537154989385
9624,330350005100102,42,73,73,64,74,78,40,43,404,83,487,17.04312114989733
9625,330350005100103,41,35,34,53,34,46,25,22,243,47,290,16.20689655172414
9626,330350005100104,66,93,107,103,87,92,56,51,548,107,655,16.33587786259542
9627,330350005100105,39,60,88,75,73,70,40,28,405,68,473,14.376321353065538
9628,330350005100106,57,90,99,81,89,62,43,27,478,70,548,12.773722627737227
9629,330350005100107,48,87,83,78,96,87,37,36,479,73,552,13.22463768115942
9630,330350005100108,87,130,126,118,93,112,67,50,666,117,783,14.942528735632184
9631,330350005100109,64,99,119,101,128,104,49,55,615,104,719,14.46453407510431
9632,330350005100110,82,101,112,116,110,117,52,53,638,105,743,14.131897711978466
9633,330350005100111,33,48,61,44,35,34,11,8,255,19,274,6.934306569343065
9634,330350005100112,71,104,121,97,125,94,46,49,612,95,707,13.437057991513438
9635,330350005100113,66,106,99,93,86,74,43,62,524,105,629,16.69316375198728
9636,330350005100114,67,90,79,123,67,74,38,44,500,82,582,14.0893470790378
9637,330350005100115,59,60,73,79,66,76,36,30,413,66,479,13.778705636743215
9638,330350005100116,111,119,116,135,112,117,60,42,710,102,812,12.561576354679802
9639,330350005100117,33,50,90,74,81,61,50,59,389,109,498,21.88755020080321
9640,330350005100118,70,105,107,107,84,72,57,46,545,103,648,15.895061728395062
9641,330350005100119,73,75,97,82,73,48,28,28,448,56,504,11.11111111111111
9642,330350005100120,26,37,43,40,43,41,35,23,230,58,288,20.13888888888889
9643,330350005100121,106,127,134,103,133,115,56,43,718,99,817,12.11750305997552
9644,330350005100122,40,66,50,57,76,51,28,33,340,61,401,15.211970074812967
9645,330350005100123,89,106,105,74,71,60,22,22,505,44,549,8.014571948998178
9646,330350005100124,55,73,101,83,87,76,38,45,475,83,558,14.874551971326165
9647,330350005100125,67,90,78,71,68,81,42,26,455,68,523,13.001912045889101
9648,330350005100126,75,86,70,54,41,26,12,11,352,23,375,6.133333333333334
9649,330350005100127,44,82,107,61,121,77,23,11,492,34,526,6.4638783269961975
9650,330350005100128,141,145,151,131,123,103,51,48,794,99,893,11.08622620380739
9651,330350005100129,71,83,78,62,51,38,19,18,383,37,420,8.80952380952381
9652,330350005100130,60,84,118,101,91,87,58,45,541,103,644,15.993788819875776
9653,330350005100131,29,50,55,36,72,59,39,57,301,96,397,24.181360201511335
9654,330350005100132,121,116,131,145,143,91,47,20,747,67,814,8.230958230958231
9655,330350005100133,106,172,128,137,137,97,54,37,777,91,868,10.483870967741936
9657,330350005100135,58,69,94,85,87,61,47,39,454,86,540,15.925925925925926
9658,330350005100136,81,135,123,119,86,94,47,43,638,90,728,12.362637362637363
9659,330350005100137,137,156,177,182,143,113,78,52,908,130,1038,12.524084778420038
9660,330350005100138,61,88,121,149,90,112,103,72,621,175,796,21.984924623115578
9661,330350005100139,48,90,86,87,109,90,88,79,510,167,677,24.667651403249632
9662,330350005100140,109,128,167,194,160,106,93,56,864,149,1013,14.70878578479763
9663,330350005100141,58,75,58,72,85,53,40,43,401,83,484,17.14876033057851
9664,330350005100142,71,81,77,86,74,65,27,21,454,48,502,9.56175298804781
9665,330350005100143,70,131,87,105,99,97,47,33,589,80,669,11.958146487294469
9666,330350005100144,126,132,132,131,129,74,48,28,724,76,800,9.5
9667,330350005100145,35,36,45,37,43,39,23,19,235,42,277,15.16245487364621
9668,330350005100146,58,108,120,100,109,101,43,39,596,82,678,12.094395280235988
9669,330350005100147,56,74,76,82,80,51,31,31,419,62,481,12.88981288981289
9670,330350005100148,57,66,62,69,88,63,29,36,405,65,470,13.829787234042554
9671,330350005100149,58,125,107,67,120,80,39,35,557,74,631,11.727416798732172
9672,330350005100150,81,106,117,102,131,107,58,73,644,131,775,16.903225806451612
9673,330350005100151,45,70,104,85,70,77,51,46,451,97,548,17.7007299270073
9674,330350005100152,68,81,100,88,89,62,37,31,488,68,556,12.23021582733813
9675,330350005100153,78,99,109,93,97,83,51,30,559,81,640,12.65625
9676,330350005100154,37,67,79,69,56,57,25,27,365,52,417,12.470023980815348
9677,330350005100155,65,81,79,75,87,44,38,29,431,67,498,13.453815261044177
9678,330350005100156,83,98,102,86,90,68,40,34,527,74,601,12.312811980033278
9679,330350005100157,81,110,85,102,76,68,40,38,522,78,600,13.0
9680,330350005100158,138,187,156,153,166,123,67,47,923,114,1037,10.993249758919962
9681,330350005100159,47,67,57,56,59,51,33,28,337,61,398,15.326633165829145
9682,330350005100160,81,117,120,88,97,83,66,40,586,106,692,15.31791907514451
9683,330350005100161,91,128,117,118,124,86,37,42,664,79,743,10.63257065948856
9684,330350005100162,26,51,54,46,56,52,27,32,285,59,344,17.151162790697676
9685,330350005100163,114,132,121,106,98,95,42,62,666,104,770,13.506493506493506
9686,330350005100164,95,126,110,113,90,83,43,47,617,90,707,12.72984441301273
9687,330350005100165,99,137,110,126,93,73,56,27,638,83,721,11.511789181692095
9688,330350005100166,120,168,133,146,127,108,70,34,802,104,906,11.479028697571744
9689,330350005100167,129,166,125,173,131,110,47,40,834,87,921,9.446254071661238
9690,330350005100168,95,113,115,125,110,87,48,51,645,99,744,13.306451612903226
9691,330350005100169,81,109,84,124,88,60,46,41,546,87,633,13.744075829383887
9692,330350005100170,70,110,96,81,70,64,21,26,491,47,538,8.736059479553903
9693,330350005100171,80,80,97,91,80,70,46,31,498,77,575,13.391304347826088
9694,330350005100172,87,84,123,96,97,87,39,29,574,68,642,10.59190031152648
9695,330350005100173,82,104,135,102,89,91,54,20,603,74,677,10.930576070901035
9696,330350005100174,101,90,136,106,104,88,38,41,625,79,704,11.221590909090908
9697,330350005100175,127,155,177,129,127,105,66,44,820,110,930,11.827956989247312
9698,330350005100176,88,122,77,102,78,55,33,20,522,53,575,9.217391304347826
9699,330350005100177,91,116,128,99,106,76,40,25,616,65,681,9.544787077826726
9700,330350005100178,62,90,126,84,89,69,43,33,520,76,596,12.751677852348994
9701,330350005100179,99,132,100,121,80,67,51,30,599,81,680,11.911764705882353
9702,330350005100180,98,163,124,137,121,103,63,22,746,85,831,10.22864019253911
9703,330350005100181,120,148,165,128,128,97,62,40,786,102,888,11.486486486486486
9704,330350005100182,99,104,120,121,91,105,56,45,640,101,741,13.630229419703104
9705,330350005100183,69,72,69,97,51,60,33,12,418,45,463,9.719222462203025
9706,330350005100184,97,123,88,88,68,48,31,32,512,63,575,10.956521739130435
9707,330350005100185,47,72,88,64,66,52,33,19,389,52,441,11.791383219954648
9708,330350005100186,62,81,68,88,65,53,45,29,417,74,491,15.071283095723015
9709,330350005100187,57,80,65,83,61,66,29,26,412,55,467,11.777301927194861
9710,330350005100188,19,29,52,33,40,40,28,17,213,45,258,17.441860465116278
9711,330350005100189,44,46,40,50,25,23,15,10,228,25,253,9.881422924901186
9712,330350005100190,92,146,150,109,122,98,65,35,717,100,817,12.239902080783354
9713,330350005100191,58,92,115,71,101,72,29,20,509,49,558,8.78136200716846
9714,330350005100192,66,130,126,97,87,104,59,34,610,93,703,13.229018492176387
9715,330350005100193,107,144,140,121,116,101,62,34,729,96,825,11.636363636363637
9716,330350005100194,91,140,118,104,109,72,37,30,634,67,701,9.557774607703282
9717,330350005100195,62,63,76,58,66,62,34,30,387,64,451,14.19068736141907
9718,330350005100196,123,176,144,159,113,86,52,28,801,80,881,9.080590238365494
9719,330350005100197,127,174,154,186,135,106,70,39,882,109,991,10.99899091826438
9720,330350005100198,261,308,207,227,180,116,63,34,1299,97,1396,6.948424068767908
9721,330350005100199,122,159,117,121,121,89,47,40,729,87,816,10.661764705882353
9722,330350005100200,160,184,130,127,83,66,43,29,750,72,822,8.75912408759124
9723,330350005100201,106,145,124,103,115,68,39,38,661,77,738,10.433604336043361
9724,330350005100202,105,156,128,138,138,97,64,37,762,101,863,11.703360370799537
9725,330350005100203,58,67,75,70,71,49,38,26,390,64,454,14.09691629955947
9726,330350005100204,73,106,132,94,114,100,63,67,619,130,749,17.356475300400533
9727,330350005100205,50,103,111,99,99,89,62,42,551,104,655,15.877862595419847
9728,330350005100206,54,74,96,90,93,89,66,71,496,137,633,21.64296998420221
9729,330350005100207,37,55,73,69,63,71,42,48,368,90,458,19.650655021834062
9730,330350005100208,42,79,63,69,51,79,45,34,383,79,462,17.0995670995671
9731,330350005100209,36,47,71,71,66,75,52,40,366,92,458,20.087336244541486
9732,330350005100210,56,87,98,112,65,75,44,47,493,91,584,15.582191780821917
9733,330350005100211,37,60,59,63,83,57,55,65,359,120,479,25.052192066805844
9734,330350005100212,30,66,54,43,51,56,32,25,300,57,357,15.966386554621849
9735,330350005100213,69,61,102,96,75,75,65,37,478,102,580,17.586206896551722
9736,330350005100214,59,67,88,95,72,94,54,72,475,126,601,20.965058236272878
9737,330350005100215,66,82,90,89,97,71,46,45,495,91,586,15.52901023890785
9738,330350005100216,93,96,107,115,92,52,44,40,555,84,639,13.145539906103286
9739,330350005100217,104,126,129,114,99,69,41,20,641,61,702,8.68945868945869
9740,330350005100218,98,157,139,134,149,96,42,43,773,85,858,9.906759906759907
9741,330350005100219,37,44,38,38,50,37,26,18,244,44,288,15.277777777777779
9742,330350005100220,86,93,87,97,79,65,51,20,507,71,578,12.283737024221454
9743,330350005100221,12,29,29,31,32,37,21,24,170,45,215,20.930232558139537
9744,330350005100222,88,103,118,113,95,84,46,46,601,92,693,13.275613275613276
9745,330350005100223,47,100,88,90,71,90,47,37,486,84,570,14.736842105263158
9746,330350005100224,58,50,84,105,74,79,53,46,450,99,549,18.0327868852459
9747,330350005100225,61,75,81,95,87,83,46,39,482,85,567,14.991181657848324
9748,330350005100226,95,87,98,120,111,78,50,34,589,84,673,12.481426448736999
9749,330350005100227,58,80,83,82,65,56,32,23,424,55,479,11.482254697286013
9750,330350005100228,82,115,95,99,109,79,63,34,579,97,676,14.349112426035504
9751,330350005100229,90,103,110,91,96,97,43,33,587,76,663,11.463046757164404
9752,330350005100230,59,77,74,79,80,57,46,54,426,100,526,19.011406844106464
9753,330350005100231,57,52,77,82,55,59,46,30,382,76,458,16.593886462882097
9754,330350005100232,47,57,54,67,80,55,46,32,360,78,438,17.80821917808219
9755,330350005100233,77,131,113,108,95,76,52,25,600,77,677,11.37370753323486
9756,330350005100234,83,100,111,117,103,87,62,44,601,106,707,14.992927864214993
9757,330350005100235,110,160,121,105,107,68,41,17,671,58,729,7.956104252400548
9758,330350005100236,71,93,70,81,71,42,34,29,428,63,491,12.830957230142566
9759,330350005100237,72,102,95,80,66,79,33,26,494,59,553,10.669077757685352
9760,330350005100238,79,82,100,81,78,51,37,20,471,57,528,10.795454545454545
9761,330350005100239,69,103,114,101,99,97,28,40,583,68,651,10.44546850998464
9762,330350005100240,72,104,101,75,67,71,31,14,490,45,535,8.411214953271028
9763,330350005100241,100,106,108,91,108,81,47,26,594,73,667,10.944527736131935
9764,330350005100242,45,40,48,40,51,18,21,10,242,31,273,11.355311355311356
9765,330350005100243,68,81,104,66,75,70,41,18,464,59,523,11.281070745697896
9766,330350005100244,50,60,63,57,74,60,38,14,364,52,416,12.5
9767,330350005100245,83,130,99,138,108,68,43,24,626,67,693,9.668109668109668
9768,330350005100246,39,48,57,56,61,41,46,39,302,85,387,21.963824289405686
9769,330350005100247,59,79,90,63,86,69,38,37,446,75,521,14.395393474088293
9770,330350005100248,30,50,57,45,50,56,35,27,288,62,350,17.714285714285715
9771,330350005100249,35,35,49,47,31,47,19,24,244,43,287,14.982578397212544
9772,330350005100250,35,47,48,65,53,57,32,40,305,72,377,19.09814323607427
9773,330350005100251,39,64,51,69,76,45,29,33,344,62,406,15.270935960591133
9774,330350005100252,36,51,39,46,69,57,53,28,298,81,379,21.37203166226913
9775,330350005100253,90,95,124,136,111,77,56,47,633,103,736,13.994565217391305
9776,330350005100254,107,119,136,133,109,82,30,31,686,61,747,8.165997322623829
9777,330350005100255,62,103,102,115,98,72,37,27,552,64,616,10.38961038961039
9778,330350005100256,42,73,82,55,61,39,36,31,352,67,419,15.990453460620525
9779,330350005100257,64,92,86,90,61,49,28,21,442,49,491,9.979633401221996
9780,330350005100258,115,160,153,138,105,82,46,25,753,71,824,8.616504854368932
9781,330350005100259,126,152,77,145,86,67,42,17,653,59,712,8.286516853932584
9782,330350005100260,49,81,62,64,75,37,26,29,368,55,423,13.002364066193854
9783,330350005100261,95,107,116,109,94,68,38,31,589,69,658,10.486322188449847
9784,330350005100262,58,61,69,52,77,47,24,30,364,54,418,12.91866028708134
9785,330350005100263,77,98,86,83,90,73,43,20,507,63,570,11.052631578947368
9786,330350005100264,49,64,58,66,59,60,42,37,356,79,435,18.160919540229884
9787,330350005100265,43,43,51,55,48,41,20,26,281,46,327,14.067278287461773
9788,330350005100266,45,48,74,57,54,59,31,33,337,64,401,15.960099750623442
9789,330350005100267,74,91,106,69,84,74,42,17,498,59,557,10.59245960502693
9790,330350005100268,59,71,66,72,76,50,33,37,394,70,464,15.086206896551724
9791,330350005100269,58,81,75,84,71,80,31,32,449,63,512,12.3046875
9792,330350005100270,73,78,73,98,54,57,26,20,433,46,479,9.603340292275574
9793,330350005100271,57,96,58,83,75,51,32,25,420,57,477,11.949685534591195
9794,330350005100272,83,109,133,143,115,104,67,63,687,130,817,15.911872705018359
9795,330350005100273,68,125,112,90,119,98,53,53,612,106,718,14.763231197771587
9796,330350005100274,42,48,48,54,51,47,47,30,290,77,367,20.980926430517712
9797,330350005100275,30,33,78,45,40,63,36,19,289,55,344,15.988372093023257
9798,330350005100276,53,80,79,74,103,46,28,20,435,48,483,9.937888198757763
9799,330350005100277,93,146,152,111,114,75,42,32,691,74,765,9.673202614379084
9800,330350005100278,47,72,88,74,82,69,40,23,432,63,495,12.727272727272727
9801,330350005100279,54,57,73,69,61,66,39,17,380,56,436,12.844036697247706
9803,330350005100281,71,92,89,83,81,66,30,21,482,51,533,9.568480300187618
9804,330350005100282,104,138,103,137,85,55,37,22,622,59,681,8.66372980910426
9805,330350005100283,23,36,35,31,27,25,17,20,177,37,214,17.289719626168225
9806,330350005100284,48,57,61,65,69,55,38,22,355,60,415,14.457831325301205
9807,330350005100285,51,57,74,44,64,56,34,22,346,56,402,13.930348258706468
9808,330350005100286,40,42,83,59,44,53,37,25,321,62,383,16.18798955613577
9809,330350005100287,49,91,72,67,66,77,41,40,422,81,503,16.10337972166998
9810,330350005100288,81,92,69,92,92,58,52,45,484,97,581,16.695352839931154
9811,330350005100289,8,13,16,16,7,8,4,4,68,8,76,10.526315789473685
9812,330350005100290,75,126,115,104,110,87,42,30,617,72,689,10.449927431059507
9813,330350005100291,52,63,78,50,64,46,25,21,353,46,399,11.528822055137844
9814,330350005100292,61,92,91,69,92,80,33,33,485,66,551,11.978221415607985
9815,330350005100293,76,83,74,91,75,45,40,34,444,74,518,14.285714285714286
9816,330350005100294,69,42,35,34,25,16,5,7,221,12,233,5.150214592274678
9817,330350005100295,67,92,76,68,82,76,29,36,461,65,526,12.357414448669202
9818,330350005110001,49,51,78,80,71,74,53,42,403,95,498,19.076305220883533
9819,330350005110002,45,65,104,70,75,70,35,10,429,45,474,9.49367088607595
9820,330350005110003,29,32,33,39,30,24,17,15,187,32,219,14.61187214611872
9821,330350005110004,66,71,66,76,66,71,43,35,416,78,494,15.789473684210526
9822,330350005110005,72,105,109,115,107,95,60,43,603,103,706,14.589235127478753
9823,330350005110006,58,93,86,77,106,81,28,44,501,72,573,12.565445026178011
9824,330350005110007,98,99,130,107,90,78,53,48,602,101,703,14.366998577524893
9825,330350005110008,78,85,84,82,87,76,23,33,492,56,548,10.218978102189782
9826,330350005110009,61,78,98,98,75,80,43,39,490,82,572,14.335664335664335
9827,330350005110010,79,72,101,70,101,89,38,51,512,89,601,14.808652246256239
9828,330350005110011,52,88,88,71,108,74,29,29,481,58,539,10.760667903525047
9829,330350005110012,65,70,55,75,53,40,27,16,358,43,401,10.723192019950124
9830,330350005110013,96,116,141,100,72,83,49,27,608,76,684,11.11111111111111
9831,330350005110014,47,72,101,67,83,70,41,49,440,90,530,16.9811320754717
9832,330350005110015,105,119,121,106,89,61,36,23,601,59,660,8.93939393939394
9833,330350005110016,62,90,94,68,93,60,35,32,467,67,534,12.546816479400748
9834,330350005110017,139,197,136,161,143,88,58,41,864,99,963,10.280373831775702
9835,330350005110018,82,92,109,87,94,83,49,29,547,78,625,12.48
9836,330350005110019,100,93,110,90,99,63,55,48,555,103,658,15.653495440729483
9837,330350005110020,120,156,137,137,120,97,59,32,767,91,858,10.606060606060606
9838,330350005110021,102,86,110,113,89,73,46,21,573,67,640,10.46875
9839,330350005110022,54,84,66,66,68,41,32,18,379,50,429,11.655011655011656
9840,330350005110023,76,130,92,85,91,41,29,10,515,39,554,7.03971119133574
9841,330350005110024,85,105,134,102,102,78,36,28,606,64,670,9.552238805970148
9842,330350005110025,79,112,92,107,105,93,65,47,588,112,700,16.0
9843,330350005110026,72,86,99,92,87,64,47,26,500,73,573,12.739965095986038
9844,330350005110027,145,123,179,141,152,95,56,53,835,109,944,11.546610169491526
9845,330350005110028,49,85,76,77,59,52,31,23,398,54,452,11.946902654867257
9846,330350005110029,72,112,99,87,88,55,40,18,513,58,571,10.157618213660244
9847,330350005110030,126,115,95,92,93,65,33,26,586,59,645,9.147286821705427
9848,330350005110031,49,64,51,59,53,60,35,21,336,56,392,14.285714285714286
9849,330350005110032,80,115,100,91,81,71,36,24,538,60,598,10.033444816053512
9850,330350005110033,94,120,113,127,110,112,59,35,676,94,770,12.207792207792208
9851,330350005110034,101,131,142,123,101,99,57,47,697,104,801,12.983770287141073
9852,330350005110035,94,107,88,106,83,55,65,43,533,108,641,16.848673946957877
9853,330350005110036,74,102,104,115,111,88,51,37,594,88,682,12.903225806451612
9854,330350005110037,119,131,150,143,147,77,53,40,767,93,860,10.813953488372093
9855,330350005110038,169,166,163,129,106,68,49,18,801,67,868,7.71889400921659
9856,330350005110039,83,104,105,86,93,73,34,41,544,75,619,12.116316639741518
9857,330350005110040,123,136,151,143,148,93,41,40,794,81,875,9.257142857142858
9858,330350005110041,101,146,123,147,136,97,57,40,750,97,847,11.452184179456907
9859,330350005110042,66,90,58,67,83,52,41,32,416,73,489,14.928425357873211
9860,330350005110043,84,109,88,99,92,74,37,33,546,70,616,11.363636363636363
9861,330350005110044,88,113,119,118,93,86,57,32,617,89,706,12.606232294617564
9862,330350005110045,79,105,99,93,93,88,37,29,557,66,623,10.593900481540931
9863,330350005110046,37,40,62,51,45,52,23,14,287,37,324,11.419753086419753
9864,330350005110047,69,92,80,72,87,62,19,33,462,52,514,10.116731517509727
9865,330350005110048,124,218,142,133,155,80,63,33,852,96,948,10.126582278481013
9866,330350005110049,93,143,108,111,86,57,44,29,598,73,671,10.879284649776453
9867,330350005110050,142,154,166,143,103,105,54,31,813,85,898,9.465478841870825
9868,330350005110051,106,158,117,99,71,86,27,14,637,41,678,6.047197640117994
9869,330350005110052,142,181,138,126,95,88,42,29,770,71,841,8.442330558858501
9870,330350005110053,162,167,155,125,111,66,46,36,786,82,868,9.44700460829493
9871,330350005110054,131,155,131,124,93,57,44,24,691,68,759,8.959156785243742
9872,330350005110055,113,136,133,154,104,69,56,34,709,90,799,11.264080100125156
9873,330350005110056,144,158,153,137,115,81,54,32,788,86,874,9.839816933638444
9874,330350005110057,119,152,143,120,137,94,33,34,765,67,832,8.052884615384615
9875,330350005110058,92,117,104,77,95,68,23,22,553,45,598,7.525083612040134
9876,330350005110059,71,114,84,109,93,67,33,23,538,56,594,9.427609427609427
9877,330350005110060,108,155,131,113,130,94,41,22,731,63,794,7.934508816120907
9878,330350005110061,95,143,106,105,80,49,31,25,578,56,634,8.832807570977918
9879,330350005110062,75,105,93,77,91,52,33,38,493,71,564,12.588652482269504
9880,330350005110063,89,128,86,100,88,49,48,34,540,82,622,13.183279742765274
9881,330350005110064,50,69,67,58,60,35,24,16,339,40,379,10.554089709762533
9882,330350005110065,99,113,109,130,123,72,36,39,646,75,721,10.402219140083218
9883,330350005110066,70,99,79,69,66,50,28,16,433,44,477,9.224318658280922
9884,330350005110067,85,102,81,113,93,41,27,13,515,40,555,7.207207207207207
9885,330350005110068,133,138,140,142,111,86,47,35,750,82,832,9.85576923076923
9886,330350005110069,56,86,63,69,54,37,33,11,365,44,409,10.75794621026895
9887,330350005110070,78,74,80,73,57,91,34,26,453,60,513,11.695906432748538
9888,330350005110071,22,44,67,100,80,50,22,13,363,35,398,8.793969849246231
9889,330350005110072,43,87,61,62,55,54,24,15,362,39,401,9.72568578553616
9890,330350005110073,67,98,88,88,86,54,33,31,481,64,545,11.743119266055047
9891,330350005110074,119,161,148,133,103,76,46,36,740,82,822,9.975669099756692
9892,330350005110075,110,130,120,110,107,96,55,33,673,88,761,11.563731931668856
9893,330350005110076,42,70,86,99,77,67,40,32,441,72,513,14.035087719298245
9894,330350005110077,63,66,72,67,36,38,24,13,342,37,379,9.762532981530343
9895,330350005110078,109,132,140,116,130,100,41,50,727,91,818,11.124694376528117
9896,330350005110079,56,76,72,65,58,54,32,23,381,55,436,12.614678899082568
9897,330350005110080,80,126,110,98,97,77,43,43,588,86,674,12.759643916913946
9898,330350005110081,63,72,73,78,65,50,47,28,401,75,476,15.756302521008404
9899,330350005110082,48,68,77,69,49,56,42,31,367,73,440,16.59090909090909
9900,330350005110083,64,103,70,74,60,61,32,23,432,55,487,11.293634496919918
9901,330350005110084,148,182,143,165,126,84,57,37,848,94,942,9.978768577494693
9902,330350005110085,98,97,90,125,68,35,14,13,513,27,540,5.0
9903,330350005110087,114,140,149,121,105,82,36,22,711,58,769,7.542262678803641
9904,330350005110088,270,257,165,184,145,105,61,46,1126,107,1233,8.67802108678021
9905,330350005110089,65,73,64,99,89,36,13,9,426,22,448,4.910714285714286
9906,330350005110090,62,67,74,95,73,51,71,37,422,108,530,20.37735849056604
9907,330350005110091,74,132,111,129,137,87,68,60,670,128,798,16.040100250626566
9908,330350005110092,138,188,142,141,136,91,49,38,836,87,923,9.42578548212351
9909,330350005110093,83,93,81,82,74,70,33,34,483,67,550,12.181818181818182
9910,330350005110094,128,146,113,97,72,56,18,25,612,43,655,6.564885496183206
9911,330350005110095,143,156,153,153,131,91,77,33,827,110,937,11.739594450373533
9912,330350005110096,132,141,169,134,105,88,55,27,769,82,851,9.63572267920094
9913,330350005110097,99,112,88,110,82,73,30,27,564,57,621,9.178743961352657
9914,330350005110098,92,102,82,94,77,45,24,17,492,41,533,7.6923076923076925
9915,330350005110099,76,68,72,85,52,47,28,24,400,52,452,11.504424778761061
9916,330350005110100,70,109,95,83,86,61,34,31,504,65,569,11.423550087873462
9917,330350005110101,73,152,112,83,84,69,39,18,573,57,630,9.047619047619047
9918,330350005110102,79,92,87,86,78,72,32,25,494,57,551,10.344827586206897
9919,330350005110103,104,114,103,94,85,69,39,36,569,75,644,11.645962732919255
9920,330350005110104,51,90,109,63,94,70,32,35,477,67,544,12.316176470588236
9921,330350005110105,34,61,46,46,52,27,25,26,266,51,317,16.08832807570978
9922,330350005110106,85,131,139,121,101,108,44,50,685,94,779,12.066752246469832
9923,330350005110107,71,94,85,89,79,51,35,38,469,73,542,13.468634686346864
9924,330350005110108,112,135,124,128,109,96,51,47,704,98,802,12.219451371571072
9925,330350005110109,104,130,118,131,101,85,52,35,669,87,756,11.507936507936508
9926,330350005110110,40,63,59,54,47,42,27,26,305,53,358,14.804469273743017
9927,330350005110111,45,58,51,53,46,26,24,9,279,33,312,10.576923076923077
9928,330350005110112,61,100,72,77,74,54,21,25,438,46,484,9.50413223140496
9929,330350005110113,113,161,142,135,126,85,49,34,762,83,845,9.822485207100591
9930,330350005110114,118,128,105,119,109,56,46,26,635,72,707,10.183875530410184
9931,330350005110115,110,143,141,135,138,94,46,62,761,108,869,12.428078250863061
9932,330350005110116,37,63,59,51,60,51,27,40,321,67,388,17.2680412371134
9933,330350005110117,71,100,86,80,79,55,26,27,471,53,524,10.114503816793894
9934,330350005110118,89,123,91,91,81,51,45,22,526,67,593,11.298482293423271
9935,330350005110119,57,92,82,66,77,80,44,34,454,78,532,14.661654135338345
9936,330350005110120,50,84,82,69,72,75,29,10,432,39,471,8.280254777070065
9937,330350005110121,22,41,47,47,37,50,28,25,244,53,297,17.845117845117844
9938,330350005110122,78,94,100,87,92,92,57,39,543,96,639,15.023474178403756
9939,330350005110123,113,155,115,114,105,80,53,28,682,81,763,10.615989515072084
9940,330350005110124,72,87,70,92,60,71,39,34,452,73,525,13.904761904761905
9941,330350005110125,87,113,90,103,101,71,37,30,565,67,632,10.60126582278481
9942,330350005110126,65,74,65,51,76,38,38,18,369,56,425,13.176470588235293
9943,330350005110127,76,95,88,84,74,54,35,39,471,74,545,13.577981651376147
9944,330350005110128,109,161,100,101,90,73,34,15,634,49,683,7.174231332357247
9945,330350005110129,129,135,134,109,117,89,42,22,713,64,777,8.236808236808237
9946,330350005110130,81,115,97,106,87,85,58,61,571,119,690,17.246376811594203
9947,330350005110131,85,125,100,88,93,82,41,39,573,80,653,12.251148545176111
9948,330350005110132,65,114,112,80,102,76,39,34,549,73,622,11.736334405144694
9949,330350005110133,76,91,83,78,64,46,27,30,438,57,495,11.515151515151516
9950,330350005110134,86,85,71,79,44,43,32,13,408,45,453,9.933774834437086
9951,330350005110135,152,146,142,159,95,80,46,24,774,70,844,8.293838862559241
9952,330350005110136,114,141,135,120,82,91,43,25,683,68,751,9.054593874833555
9953,330350005110137,133,170,133,141,116,72,38,21,765,59,824,7.160194174757281
9954,330350005110138,69,81,89,80,62,46,49,15,427,64,491,13.034623217922608
9955,330350005110139,90,120,111,123,112,65,52,40,621,92,713,12.903225806451612
9956,330350005110140,138,148,103,131,66,61,26,11,647,37,684,5.409356725146199
9957,330350005110141,54,62,46,53,48,27,14,16,290,30,320,9.375
9958,330350005110142,87,99,91,89,77,59,36,26,502,62,564,10.99290780141844
9959,330350005110143,122,129,113,109,107,52,37,20,632,57,689,8.272859216255442
9960,330350005110144,165,224,186,165,162,78,64,25,980,89,1069,8.325537885874649
9961,330350005110145,79,107,82,87,54,46,30,24,455,54,509,10.609037328094303
9962,330350005110146,75,101,129,82,79,84,38,43,550,81,631,12.836767036450079
9963,330350005110147,87,115,82,90,74,59,19,22,507,41,548,7.481751824817518
9964,330350005110148,65,88,86,88,88,89,66,23,504,89,593,15.008431703204048
9965,330350005110149,49,59,78,67,55,48,18,17,356,35,391,8.951406649616368
9966,330350005110150,41,54,52,53,43,44,24,34,287,58,345,16.81159420289855
9967,330350005110151,49,71,60,61,68,53,29,21,362,50,412,12.135922330097088
9968,330350005110152,111,148,122,123,126,92,65,48,722,113,835,13.532934131736527
9969,330350005110153,55,67,50,69,47,50,29,30,338,59,397,14.861460957178842
9970,330350005110154,68,85,65,67,66,39,50,20,390,70,460,15.217391304347826
9971,330350005110155,126,138,138,98,95,72,36,18,667,54,721,7.489597780859917
9972,330350005110156,52,83,65,62,72,53,33,23,387,56,443,12.641083521444695
9973,330350005110157,91,98,97,88,78,55,41,19,507,60,567,10.582010582010582
9974,330350005110158,76,84,70,76,54,39,19,15,399,34,433,7.852193995381063
9975,330350005110159,48,86,76,62,69,74,28,18,415,46,461,9.97830802603037
9976,330350005110160,82,107,109,101,89,74,42,32,562,74,636,11.635220125786164
9977,330350005110161,104,123,121,101,104,80,29,37,633,66,699,9.44206008583691
9978,330350005110162,153,154,133,106,107,58,42,30,711,72,783,9.195402298850574
9979,330350005110163,79,91,82,97,78,74,29,23,501,52,553,9.403254972875226
9980,330350005110164,108,144,153,108,117,74,35,31,704,66,770,8.571428571428571
9981,330350005110165,68,104,82,92,91,66,37,26,503,63,566,11.130742049469964
9982,330350005110166,74,125,83,87,106,72,33,11,547,44,591,7.4450084602368864
9983,330350005110167,58,73,67,56,63,41,29,13,358,42,400,10.5
9984,330350005110168,65,89,75,128,67,48,32,25,472,57,529,10.775047258979207
9985,330350005110169,61,80,76,65,64,46,44,21,392,65,457,14.223194748358862
9986,330350005110170,34,52,38,38,39,24,21,16,225,37,262,14.122137404580153
9987,330350005110171,53,77,51,68,57,50,22,27,356,49,405,12.098765432098766
9988,330350005110172,76,84,82,75,64,47,30,14,428,44,472,9.322033898305085
9989,330350005110173,57,83,67,58,81,54,29,31,400,60,460,13.043478260869565
9990,330350005110174,66,82,67,65,61,41,29,21,382,50,432,11.574074074074074
9991,330350005110175,54,77,64,93,61,60,44,18,409,62,471,13.163481953290871
9992,330350005110176,46,77,62,68,68,49,44,21,370,65,435,14.942528735632184
9993,330350005110177,97,121,106,116,84,72,48,31,596,79,675,11.703703703703704
9994,330350005110178,107,103,126,92,66,54,34,20,548,54,602,8.970099667774086
9995,330350005110179,119,122,91,128,110,74,71,33,644,104,748,13.903743315508022
9996,330350005110180,140,193,140,126,111,54,34,19,764,53,817,6.487148102815177
9997,330350005110181,119,170,88,108,71,52,29,9,608,38,646,5.882352941176471
9998,330350005110182,210,230,199,199,157,96,46,18,1091,64,1155,5.541125541125541
9999,330350005110183,39,62,77,43,63,54,31,37,338,68,406,16.748768472906406
10000,330350005110184,47,69,76,59,44,49,31,25,344,56,400,14.0
10001,330350005110185,126,122,155,97,98,62,37,21,660,58,718,8.07799442896936
10002,330350005110186,68,91,67,79,66,57,42,15,428,57,485,11.75257731958763
10003,330350005110187,121,143,116,108,111,64,32,24,663,56,719,7.7885952712100135
10004,330350005110188,79,100,72,78,60,41,30,14,430,44,474,9.282700421940929
10005,330350005110189,81,82,82,81,59,55,21,13,440,34,474,7.172995780590718
10006,330350005110190,53,63,72,74,59,49,37,14,370,51,421,12.114014251781473
10007,330350005110191,39,77,53,63,60,43,24,19,335,43,378,11.375661375661375
10008,330350005110192,65,70,94,68,54,49,37,27,400,64,464,13.793103448275861
10009,330350005110193,170,197,170,166,147,95,64,29,945,93,1038,8.959537572254336
10010,330350005120001,170,225,215,184,121,100,61,33,1015,94,1109,8.476104598737601
10011,330350005120002,164,211,129,163,112,84,62,33,863,95,958,9.916492693110648
10012,330350005120003,133,151,135,124,110,56,41,26,709,67,776,8.6340206185567
10013,330350005120004,112,156,168,125,120,83,49,31,764,80,844,9.47867298578199
10014,330350005120005,188,222,170,178,122,103,60,32,983,92,1075,8.55813953488372
10015,330350005120006,141,183,121,130,106,58,48,38,739,86,825,10.424242424242424
10016,330350005120007,112,127,111,94,70,46,31,13,560,44,604,7.28476821192053
10017,330350005120008,55,87,59,89,39,37,24,12,366,36,402,8.955223880597014
10018,330350005120009,170,215,194,190,133,82,42,35,984,77,1061,7.257304429783224
10019,330350005120010,160,197,154,129,92,64,38,17,796,55,851,6.462984723854289
10020,330350005120011,122,153,134,137,110,80,63,40,736,103,839,12.276519666269369
10021,330350005120012,55,76,73,65,59,41,31,15,369,46,415,11.08433734939759
10022,330350005120013,89,93,96,102,74,62,38,28,516,66,582,11.34020618556701
10023,330350005120014,165,218,165,173,136,80,52,32,937,84,1021,8.22722820763957
10024,330350005120015,170,156,142,114,105,56,42,32,743,74,817,9.057527539779683
10025,330350005120016,96,122,101,107,63,55,34,19,544,53,597,8.877721943048575
10026,330350005120017,77,110,77,101,63,53,32,26,481,58,539,10.760667903525047
10027,330350005120018,111,134,135,127,105,78,64,31,690,95,785,12.101910828025478
10028,330350005120019,121,155,141,134,113,62,56,47,726,103,829,12.424607961399277
10029,330350005120020,65,67,66,79,48,34,35,15,359,50,409,12.224938875305623
10030,330350005120021,98,80,91,86,70,57,45,27,482,72,554,12.99638989169675
10031,330350005120022,84,98,83,112,82,59,45,21,518,66,584,11.301369863013699
10032,330350005120023,105,123,113,103,82,54,30,29,580,59,639,9.23317683881064
10033,330350005120024,106,150,112,132,95,55,57,24,650,81,731,11.080711354309166
10034,330350005120025,119,197,147,140,129,62,42,19,794,61,855,7.1345029239766085
10035,330350005120026,120,159,111,129,109,91,46,25,719,71,790,8.987341772151899
10036,330350005120027,146,173,161,155,158,111,57,33,904,90,994,9.054325955734406
10037,330350005120028,133,195,144,165,121,90,34,28,848,62,910,6.813186813186813
10038,330350005120029,117,160,113,131,90,57,44,31,668,75,743,10.094212651413189
10039,330350005120030,88,96,122,97,82,63,46,22,548,68,616,11.03896103896104
10040,330350005120031,115,108,116,121,91,75,51,29,626,80,706,11.331444759206798
10041,330350005120032,87,111,101,111,82,60,35,20,552,55,607,9.060955518945635
10042,330350005120033,85,64,52,75,60,40,40,16,376,56,432,12.962962962962964
10043,330350005120034,70,80,90,84,86,58,23,22,468,45,513,8.771929824561404
10044,330350005120035,64,145,109,112,100,77,43,22,607,65,672,9.672619047619047
10045,330350005120036,136,142,151,128,106,62,48,30,725,78,803,9.71357409713574
10046,330350005120037,109,129,107,130,82,69,31,13,626,44,670,6.567164179104478
10047,330350005120038,68,126,61,103,121,42,20,6,521,26,547,4.753199268738574
10048,330350005120039,108,160,101,125,132,43,13,16,669,29,698,4.154727793696275
10049,330350005120040,106,146,84,122,103,38,13,11,599,24,623,3.852327447833066
10050,330350005120041,107,156,100,130,149,56,22,11,698,33,731,4.514363885088919
10051,330350005120042,102,122,122,93,86,52,35,20,577,55,632,8.70253164556962
10052,330350005120043,142,181,176,148,126,93,63,28,866,91,957,9.508881922675027
10053,330350005120044,111,146,127,117,92,60,41,23,653,64,717,8.92608089260809
10054,330350005120045,75,84,81,82,82,47,38,39,451,77,528,14.583333333333334
10055,330350005120046,113,144,108,95,109,61,26,40,630,66,696,9.482758620689655
10056,330350005120047,101,102,93,82,68,53,28,36,499,64,563,11.367673179396093
10057,330350005120048,136,192,165,138,107,63,43,27,801,70,871,8.036739380022961
10058,330350005120049,102,118,122,101,121,64,44,28,628,72,700,10.285714285714286
10059,330350005120050,68,132,84,110,106,62,48,40,562,88,650,13.538461538461538
10060,330350005120051,79,115,114,112,104,77,48,42,601,90,691,13.024602026049203
10061,330350005120052,54,90,84,74,76,65,23,38,443,61,504,12.103174603174603
10062,330350005120053,41,57,56,70,71,46,49,27,341,76,417,18.225419664268586
10063,330350005120054,83,115,95,144,107,77,60,36,621,96,717,13.389121338912133
10064,330350005120055,68,84,79,93,78,54,40,28,456,68,524,12.977099236641221
10065,330350005120056,51,55,60,75,64,44,38,27,349,65,414,15.70048309178744
10066,330350005120057,85,102,115,73,100,77,41,50,552,91,643,14.152410575427682
10067,330350005120058,100,138,123,143,84,95,56,41,683,97,780,12.435897435897436
10068,330350005120059,96,123,100,106,124,80,31,29,629,60,689,8.708272859216255
10069,330350005120060,134,170,130,134,130,73,48,40,771,88,859,10.244470314318976
10070,330350005120061,99,125,88,104,78,53,45,24,547,69,616,11.2012987012987
10071,330350005120062,46,66,45,53,57,36,20,15,303,35,338,10.355029585798816
10072,330350005120063,65,73,90,66,67,54,39,36,415,75,490,15.306122448979592
10073,330350005120064,73,82,73,95,86,62,14,15,471,29,500,5.8
10074,330350005120065,135,191,149,139,121,80,40,29,815,69,884,7.8054298642533935
10075,330350005120066,160,182,167,153,133,86,47,31,881,78,959,8.13347236704901
10076,330350005120067,85,139,133,88,99,73,49,29,617,78,695,11.223021582733812
10077,330350005120068,61,71,98,78,70,56,34,16,434,50,484,10.330578512396695
10078,330350005120069,77,79,113,116,54,62,34,14,501,48,549,8.743169398907105
10079,330350005120070,87,113,123,101,74,81,34,21,579,55,634,8.675078864353312
10080,330350005120071,41,63,41,71,52,31,25,16,299,41,340,12.058823529411764
10081,330350005120072,71,69,68,64,83,39,34,26,394,60,454,13.215859030837004
10082,330350005120073,70,87,104,71,84,73,26,23,489,49,538,9.107806691449815
10083,330350005120074,87,114,116,102,94,55,28,37,568,65,633,10.268562401263823
10084,330350005120075,123,137,140,137,102,81,43,43,720,86,806,10.66997518610422
10085,330350005120076,92,154,125,129,136,64,46,33,700,79,779,10.141206675224646
10086,330350005120077,83,105,125,101,89,68,34,27,571,61,632,9.651898734177216
10087,330350005120078,39,72,53,65,52,41,26,15,322,41,363,11.294765840220386
10088,330350005120079,49,74,65,36,63,40,11,20,327,31,358,8.659217877094973
10089,330350005120080,100,146,106,144,99,67,47,28,662,75,737,10.176390773405698
10090,330350005120081,137,185,133,116,121,85,44,41,777,85,862,9.860788863109049
10091,330350005120082,71,92,101,100,91,61,28,19,516,47,563,8.348134991119005
10092,330350005120083,66,90,82,89,77,54,48,33,458,81,539,15.027829313543599
10093,330350005120084,158,187,134,148,105,84,45,26,816,71,887,8.004509582863585
10094,330350005120085,105,131,98,106,92,65,30,25,597,55,652,8.43558282208589
10095,330350005120086,136,111,197,151,118,99,46,35,812,81,893,9.070548712206048
10096,330350005120087,179,233,173,235,169,103,55,33,1092,88,1180,7.4576271186440675
10097,330350005120088,167,165,123,123,94,51,26,23,723,49,772,6.347150259067358
10098,330350005120089,96,91,98,75,84,66,34,37,510,71,581,12.220309810671257
10099,330350005120090,53,67,57,58,57,49,31,19,341,50,391,12.787723785166241
10100,330350005120091,114,92,117,73,56,46,23,16,498,39,537,7.262569832402234
10101,330350005120092,134,153,133,138,112,82,57,49,752,106,858,12.354312354312354
10102,330350005120093,57,60,81,71,56,59,29,23,384,52,436,11.926605504587156
10103,330350005120094,81,109,82,101,88,54,32,26,515,58,573,10.122164048865619
10104,330350005120095,44,66,83,62,60,50,28,24,365,52,417,12.470023980815348
10105,330350005120096,78,130,110,101,107,64,42,34,590,76,666,11.411411411411411
10106,330350005120097,66,108,89,94,83,75,27,23,515,50,565,8.849557522123893
10107,330350005120098,70,113,100,88,74,29,38,16,474,54,528,10.227272727272727
10108,330350005120099,64,106,101,83,88,80,26,26,522,52,574,9.059233449477352
10109,330350005120100,58,57,91,73,57,47,25,16,383,41,424,9.669811320754716
10110,330350005120101,107,150,156,138,131,87,65,27,769,92,861,10.685249709639953
10111,330350005120102,94,112,81,105,86,60,29,25,538,54,592,9.121621621621621
10112,330350005120103,101,92,94,73,66,51,33,24,477,57,534,10.674157303370787
10113,330350005120104,78,110,86,85,80,60,25,26,499,51,550,9.272727272727273
10114,330350005120105,84,112,98,102,105,86,46,41,587,87,674,12.908011869436201
10115,330350005120106,98,149,159,124,109,95,62,38,734,100,834,11.990407673860911
10116,330350005120107,79,106,103,89,113,91,40,44,581,84,665,12.631578947368421
10117,330350005120108,85,97,110,88,83,63,28,39,526,67,593,11.298482293423271
10118,330350005120109,81,80,90,79,87,75,35,35,492,70,562,12.455516014234876
10119,330350005120110,67,119,132,86,122,94,58,48,620,106,726,14.600550964187327
10120,330350005120111,121,167,146,124,124,100,50,49,782,99,881,11.237230419977298
10121,330350005120112,88,129,119,96,112,80,48,30,624,78,702,11.11111111111111
10122,330350005120113,66,82,83,79,89,52,30,32,451,62,513,12.085769980506823
10123,330350005120114,88,121,126,115,113,105,56,46,668,102,770,13.246753246753247
10124,330350005120115,40,47,52,51,68,50,31,28,308,59,367,16.076294277929154
10125,330350005120116,88,123,112,137,85,106,67,42,651,109,760,14.342105263157896
10126,330350005120117,114,145,127,152,123,110,52,46,771,98,869,11.277330264672036
10127,330350005120118,43,56,62,52,68,54,32,49,335,81,416,19.471153846153847
10128,330350005120119,67,90,89,83,69,82,37,34,480,71,551,12.885662431941924
10129,330350005120120,44,71,72,59,54,52,36,12,352,48,400,12.0
10130,330350005120121,65,107,99,88,102,78,39,50,539,89,628,14.171974522292993
10131,330350005120122,65,100,91,87,65,63,32,29,471,61,532,11.466165413533835
10132,330350005120123,84,125,102,106,92,67,45,39,576,84,660,12.727272727272727
10133,330350005120124,69,64,85,91,54,47,26,23,410,49,459,10.675381263616558
10134,330350005120125,110,126,135,117,101,92,56,45,681,101,782,12.915601023017903
10135,330350005120126,77,98,93,92,91,64,34,28,515,62,577,10.74523396880416
10136,330350005120127,63,96,72,88,72,31,29,16,422,45,467,9.635974304068522
10137,330350005120128,97,155,121,105,129,104,51,43,711,94,805,11.677018633540373
10138,330350005120129,49,84,94,56,79,75,19,25,437,44,481,9.147609147609147
10139,330350005120130,71,96,97,88,65,68,19,35,485,54,539,10.018552875695732
10140,330350005120131,91,116,116,96,88,70,47,28,577,75,652,11.503067484662576
10141,330350005120132,77,117,73,73,57,39,21,8,436,29,465,6.236559139784946
10142,330350005120133,116,137,107,112,62,44,30,15,578,45,623,7.223113964686998
10143,330350005120134,37,34,38,86,37,25,12,9,257,21,278,7.553956834532374
10144,330350005120135,130,157,107,136,100,64,40,19,694,59,753,7.835325365205843
10145,330350005120136,90,112,94,98,80,74,29,18,548,47,595,7.899159663865547
10146,330350005120137,62,55,56,39,54,27,22,8,293,30,323,9.287925696594428
10147,330350005120138,119,132,120,128,84,69,44,20,652,64,716,8.938547486033519
10148,330350005120139,98,95,92,101,62,57,29,13,505,42,547,7.678244972577697
10149,330350005120140,141,159,162,146,109,75,53,26,792,79,871,9.07003444316877
10150,330350005120141,74,93,97,86,75,58,29,18,483,47,530,8.867924528301886
10151,330350005120142,71,94,64,66,83,31,21,10,409,31,440,7.045454545454546
10152,330350005120143,153,185,181,145,113,94,52,22,871,74,945,7.830687830687831
10153,330350005120144,90,132,103,105,82,56,54,36,568,90,658,13.677811550151976
10154,330350005120145,101,129,104,95,96,47,43,21,572,64,636,10.062893081761006
10155,330350005120146,80,117,93,69,62,43,43,16,464,59,523,11.281070745697896
10156,330350005120147,133,175,132,122,107,76,39,41,745,80,825,9.696969696969697
10157,330350005120148,84,120,129,103,89,97,31,25,622,56,678,8.259587020648967
10158,330350005120149,211,216,194,270,165,103,77,41,1159,118,1277,9.240407204385278
10159,330350005120150,130,143,122,153,114,82,49,21,744,70,814,8.5995085995086
10160,330350005120151,56,101,72,62,63,77,31,22,431,53,484,10.950413223140496
10161,330350005120152,130,134,135,115,99,52,20,17,665,37,702,5.27065527065527
10162,330350005120153,93,94,70,97,75,39,27,21,468,48,516,9.30232558139535
10163,330350005120154,49,86,64,85,52,34,29,17,370,46,416,11.057692307692308
10164,330350005120155,65,112,86,82,95,52,34,14,492,48,540,8.88888888888889
10165,330350005120156,73,77,113,104,70,56,30,18,493,48,541,8.872458410351202
10166,330350005120157,101,120,119,93,81,64,28,22,578,50,628,7.961783439490445
10167,330350005120158,75,109,78,72,80,28,20,20,442,40,482,8.298755186721992
10168,330350005120159,87,98,101,96,72,44,26,21,498,47,545,8.623853211009175
10169,330350005120160,66,92,64,66,78,40,33,37,406,70,476,14.705882352941176
10170,330350005120161,58,111,99,64,60,64,43,24,456,67,523,12.810707456978967
10171,330350005120162,45,75,38,45,49,39,31,18,291,49,340,14.411764705882353
10172,330350005120163,46,65,69,38,66,36,26,22,320,48,368,13.043478260869565
10173,330350005120164,77,94,108,89,78,51,30,18,497,48,545,8.807339449541285
10174,330350005120165,65,69,93,82,70,51,37,30,430,67,497,13.480885311871228
10175,330350005120166,118,180,93,111,93,56,24,16,651,40,691,5.788712011577424
10176,330350005120167,100,122,110,88,76,40,27,19,536,46,582,7.903780068728523
10177,330350005120168,119,133,101,97,65,41,36,20,556,56,612,9.15032679738562
10178,330350005120169,105,135,112,123,76,94,35,19,645,54,699,7.725321888412017
10179,330350005120170,130,127,104,112,95,63,29,26,631,55,686,8.017492711370263
10180,330350005120171,55,74,52,54,60,36,23,21,331,44,375,11.733333333333333
10181,330350005120172,100,116,94,80,72,52,25,14,514,39,553,7.052441229656419
10182,330350005120173,120,110,103,92,71,68,32,8,564,40,604,6.622516556291391
10183,330350005120174,93,109,112,104,57,47,36,12,522,48,570,8.421052631578947
10184,330350005120175,121,131,113,101,104,65,18,23,635,41,676,6.06508875739645
10185,330350005160001,72,112,79,79,63,57,29,18,462,47,509,9.233791748526523
10186,330350005160002,98,122,135,127,97,83,56,28,662,84,746,11.26005361930295
10187,330350005160003,98,135,112,104,96,75,42,31,620,73,693,10.533910533910534
10188,330350005160004,92,135,154,112,107,88,35,14,688,49,737,6.648575305291724
10189,330350005160005,57,82,92,54,83,54,32,13,422,45,467,9.635974304068522
10190,330350005160006,94,106,116,87,81,57,40,31,541,71,612,11.601307189542483
10191,330350005160007,102,129,110,103,92,50,36,20,586,56,642,8.722741433021806
10192,330350005160008,75,96,69,53,58,43,28,16,394,44,438,10.045662100456621
10193,330350005160009,154,176,114,108,86,62,42,25,700,67,767,8.735332464146023
10194,330350005160010,169,209,148,184,241,99,72,39,1050,111,1161,9.560723514211887
10195,330350005160011,103,138,161,131,102,99,72,54,734,126,860,14.651162790697674
10196,330350005160012,101,146,135,95,110,89,33,33,676,66,742,8.89487870619946
10197,330350005160013,84,111,92,99,79,44,36,25,509,61,570,10.701754385964913
10198,330350005160014,168,203,142,150,136,68,57,25,867,82,949,8.640674394099051
10199,330350005160015,76,127,86,96,75,54,48,14,514,62,576,10.76388888888889
10200,330350005160016,56,97,85,77,62,63,32,29,440,61,501,12.17564870259481
10201,330350005160017,162,185,165,175,133,96,64,58,916,122,1038,11.753371868978805
10202,330350005160018,193,261,190,189,146,107,54,36,1086,90,1176,7.653061224489796
10203,330350005160019,95,120,117,115,69,69,29,20,585,49,634,7.728706624605678
10204,330350005160020,113,169,127,123,128,80,59,36,740,95,835,11.377245508982035
10205,330350005160021,107,156,132,106,96,72,38,29,669,67,736,9.103260869565217
10206,330350005160022,97,125,82,119,65,68,46,20,556,66,622,10.610932475884244
10207,330350005160023,105,131,124,113,102,74,67,22,649,89,738,12.059620596205962
10208,330350005160024,86,127,115,75,82,54,48,26,539,74,613,12.071778140293638
10209,330350005160025,86,128,82,77,89,72,34,21,534,55,589,9.33786078098472
10210,330350005160026,69,101,91,55,61,46,25,9,423,34,457,7.439824945295404
10211,330350005160027,130,203,146,123,120,114,61,29,836,90,926,9.719222462203025
10212,330350005160028,104,117,127,98,73,48,50,14,567,64,631,10.142630744849445
10213,330350005160029,107,149,112,143,115,72,61,24,698,85,783,10.855683269476373
10214,330350005160030,112,152,160,117,101,112,54,36,754,90,844,10.663507109004739
10215,330350005160031,142,173,179,130,120,100,47,25,844,72,916,7.860262008733624
10216,330350005160032,145,164,142,125,91,88,41,18,755,59,814,7.2481572481572485
10217,330350005160033,107,167,120,119,100,75,24,28,688,52,740,7.027027027027027
10218,330350005160034,150,204,131,166,96,55,52,28,802,80,882,9.070294784580499
10219,330350005160035,152,176,186,162,116,86,53,31,878,84,962,8.731808731808732
10220,330350005160036,121,99,123,89,77,57,30,21,566,51,617,8.26580226904376
10221,330350005160037,119,178,142,134,156,72,66,49,801,115,916,12.554585152838428
10222,330350005160038,197,264,261,211,243,172,95,42,1348,137,1485,9.225589225589225
10223,330350005160039,93,133,132,110,133,119,75,27,720,102,822,12.408759124087592
10224,330350005160040,202,233,192,208,168,95,64,41,1098,105,1203,8.728179551122194
10225,330350005160041,101,90,100,101,63,60,26,18,515,44,559,7.8711985688729875
10226,330350005160042,79,89,109,101,86,69,32,24,533,56,589,9.507640067911714
10227,330350005160043,233,255,222,295,245,159,79,34,1409,113,1522,7.424441524310118
10228,330350005160044,96,141,102,119,95,89,53,33,642,86,728,11.813186813186814
10229,330350005160045,138,142,118,116,90,70,32,19,674,51,725,7.0344827586206895
10230,330350005160046,110,132,151,135,97,74,45,19,699,64,763,8.387942332896461
10231,330350005160047,145,151,117,121,116,87,54,35,737,89,826,10.774818401937045
10232,330350005160048,153,200,175,132,152,86,75,44,898,119,1017,11.701081612586037
10233,330350005160049,124,194,109,151,102,91,49,33,771,82,853,9.613130128956623
10234,330350005160050,168,196,162,123,120,84,60,24,853,84,937,8.964781216648879
10235,330350005160051,172,218,124,129,129,78,29,23,850,52,902,5.764966740576496
10236,330350005160052,112,178,106,107,103,59,27,18,665,45,710,6.338028169014085
10237,330350005160053,132,165,130,157,99,80,47,20,763,67,830,8.072289156626505
10238,330350005160054,88,146,81,77,102,58,24,12,552,36,588,6.122448979591836
10239,330350005160055,139,164,125,115,98,66,27,24,707,51,758,6.728232189973615
10240,330350005160056,156,164,173,120,125,68,22,28,806,50,856,5.841121495327103
10241,330350005160057,103,131,90,85,80,54,25,9,543,34,577,5.892547660311958
10242,330350005160058,59,107,43,52,54,39,24,12,354,36,390,9.23076923076923
10243,330350005160059,81,100,97,85,67,64,27,16,494,43,537,8.007448789571695
10244,330350005160060,94,98,63,68,76,45,33,18,444,51,495,10.303030303030303
10245,330350005160061,289,329,287,249,201,115,78,42,1470,120,1590,7.547169811320755
10246,330350005160062,18,24,15,25,9,15,5,7,106,12,118,10.169491525423728
10247,330350005160063,41,63,37,62,42,23,25,11,268,36,304,11.842105263157896
10248,330350005160064,110,156,153,112,127,88,44,24,746,68,814,8.353808353808354
10249,330350005160065,144,162,128,137,101,85,58,39,757,97,854,11.358313817330211
10250,330350005160066,136,171,134,127,135,72,47,36,775,83,858,9.673659673659674
10251,330350005160067,178,233,105,140,140,71,44,20,867,64,931,6.874328678839957
10252,330350005160068,128,148,136,138,122,64,36,33,736,69,805,8.571428571428571
10253,330350005160069,99,104,78,75,74,64,41,30,494,71,565,12.56637168141593
10254,330350005160070,100,111,79,72,72,74,45,33,508,78,586,13.310580204778157
10255,330350005160071,139,169,114,98,111,51,27,29,682,56,738,7.588075880758808
10256,330350005160072,163,199,124,125,104,78,38,30,793,68,861,7.897793263646922
10257,330350005160073,139,191,129,99,83,51,22,9,692,31,723,4.287690179806362
10258,330350005160074,114,173,133,133,105,77,51,37,735,88,823,10.69258809234508
10259,330350005160075,95,107,62,72,57,40,24,12,433,36,469,7.67590618336887
10260,330350005160076,67,93,70,86,82,47,55,29,445,84,529,15.879017013232515
10261,330350005160077,207,240,189,165,156,95,45,25,1052,70,1122,6.238859180035651
10262,330350005160078,218,246,195,163,110,87,71,23,1019,94,1113,8.44564240790656
10263,330350005160079,166,158,161,122,86,66,41,24,759,65,824,7.888349514563107
10264,330350005160080,87,78,61,65,37,55,31,18,383,49,432,11.342592592592593
10265,330350005160081,49,59,73,37,62,28,17,12,308,29,337,8.6053412462908
10266,330350005160082,74,100,113,77,102,51,27,11,517,38,555,6.846846846846847
10267,330350005160083,51,90,50,59,60,36,17,9,346,26,372,6.989247311827957
10268,330350005160085,163,167,234,182,147,86,70,21,979,91,1070,8.504672897196262
10269,330350005160086,132,167,142,131,110,97,44,24,779,68,847,8.028335301062574
10270,330350005160087,151,174,157,134,100,75,30,29,791,59,850,6.9411764705882355
10271,330350005160088,117,167,130,113,167,68,45,36,762,81,843,9.608540925266905
10272,330350005160089,184,205,162,136,129,110,55,31,926,86,1012,8.49802371541502
10273,330350005160090,171,202,141,137,120,105,36,28,876,64,940,6.808510638297872
10274,330350005160091,182,186,149,174,94,71,50,22,856,72,928,7.758620689655173
10275,330350005160092,113,151,108,113,92,55,34,17,632,51,683,7.46705710102489
10276,330350005160093,158,174,125,132,131,89,43,23,809,66,875,7.542857142857143
10277,330350005160094,127,234,138,218,148,59,59,32,924,91,1015,8.96551724137931
10278,330350005160095,149,165,153,133,159,87,45,26,846,71,917,7.742639040348964
10279,330350005160096,247,309,280,232,199,112,72,28,1379,100,1479,6.761325219743069
10280,330350005160097,59,75,84,80,64,43,28,30,405,58,463,12.526997840172786
10281,330350005160098,99,139,99,84,93,38,31,22,552,53,605,8.760330578512397
10282,330350005160099,93,129,85,80,77,34,23,22,498,45,543,8.287292817679559
10283,330350005160100,105,132,124,96,102,57,24,26,616,50,666,7.5075075075075075
10284,330350005160101,139,173,127,136,105,78,46,39,758,85,843,10.083036773428233
10285,330350005160102,176,175,154,115,97,92,39,27,809,66,875,7.542857142857143
10286,330350005160103,77,99,78,97,72,60,39,20,483,59,542,10.885608856088561
10287,330350005160104,100,133,107,113,83,46,44,23,582,67,649,10.323574730354391
10288,330350005160105,123,144,101,116,102,68,44,27,654,71,725,9.793103448275861
10289,330350005160106,101,115,83,82,61,29,26,27,471,53,524,10.114503816793894
10290,330350005160107,96,132,97,91,86,47,30,21,549,51,600,8.5
10291,330350005160108,140,183,131,134,93,64,35,22,745,57,802,7.107231920199501
10292,330350005160109,84,119,105,72,74,69,22,9,523,31,554,5.595667870036101
10293,330350005160110,66,88,116,76,68,52,17,9,466,26,492,5.284552845528455
10294,330350005160111,37,56,48,35,45,24,8,8,245,16,261,6.130268199233717
10295,330350005160112,95,100,75,55,76,41,20,16,442,36,478,7.531380753138075
10296,330350005160113,121,154,113,103,92,70,37,27,653,64,717,8.92608089260809
10297,330350005160114,213,218,186,192,143,113,61,46,1065,107,1172,9.129692832764505
10298,330350005160115,54,67,45,52,64,33,19,19,315,38,353,10.76487252124646
10299,330350005160116,66,76,103,81,76,66,28,26,468,54,522,10.344827586206897
10300,330350005160117,106,123,103,94,100,71,39,25,597,64,661,9.68229954614221
10301,330350005160118,109,126,94,95,68,46,19,21,538,40,578,6.920415224913495
10302,330350005160119,30,39,19,16,20,19,7,5,143,12,155,7.741935483870968
10303,330350005160120,17,21,16,20,12,6,6,1,92,7,99,7.070707070707071
10304,330350005160121,37,62,35,43,25,14,17,4,216,21,237,8.860759493670885
10307,330350005160124,17,17,9,18,10,5,11,5,76,16,92,17.391304347826086
10308,330350005160125,313,248,216,203,148,136,54,43,1264,97,1361,7.127112417340191
10309,330350005160126,82,117,53,69,49,33,13,12,403,25,428,5.841121495327103
10310,330350005160127,113,108,89,71,60,42,20,11,483,31,514,6.031128404669261
10311,330350005160128,87,110,60,66,57,36,13,9,416,22,438,5.0228310502283104
10312,330350005160129,65,47,45,35,35,27,7,9,254,16,270,5.925925925925926
10313,330350005160130,32,34,24,34,27,10,7,0,161,7,168,4.166666666666667
10314,330350005160131,49,76,27,42,41,17,9,7,252,16,268,5.970149253731344
10315,330350005160132,70,67,44,47,40,24,21,6,292,27,319,8.463949843260188
10316,330350005160133,87,115,71,78,44,41,13,6,436,19,455,4.175824175824176
10317,330350005160134,70,64,60,46,28,27,11,5,295,16,311,5.144694533762058
10318,330350005160135,107,96,60,81,51,28,20,14,423,34,457,7.439824945295404
10319,330350005170001,104,154,127,119,117,93,51,47,714,98,812,12.068965517241379
10320,330350005170002,145,168,167,134,110,94,61,37,818,98,916,10.698689956331878
10321,330350005170003,115,152,121,118,124,80,33,31,710,64,774,8.268733850129198
10322,330350005170004,63,106,92,102,65,70,60,20,498,80,578,13.84083044982699
10323,330350005170005,49,53,58,56,36,39,15,12,291,27,318,8.49056603773585
10324,330350005170006,8,18,8,6,18,16,7,7,74,14,88,15.909090909090908
10325,330350005170007,54,89,68,65,58,45,18,12,379,30,409,7.334963325183374
10326,330350005170008,116,160,86,101,92,57,23,16,612,39,651,5.990783410138249
10327,330350005170009,74,128,103,100,95,57,38,20,557,58,615,9.43089430894309
10328,330350005170010,199,236,194,157,190,129,54,48,1105,102,1207,8.450704225352112
10329,330350005170011,126,164,111,97,103,62,24,20,663,44,707,6.223479490806223
10330,330350005170012,114,169,119,94,127,77,35,19,700,54,754,7.161803713527852
10331,330350005170013,128,205,127,115,119,70,31,27,764,58,822,7.0559610705596105
10332,330350005170014,160,168,109,143,110,65,29,16,755,45,800,5.625
10333,330350005170015,142,187,169,155,113,100,50,44,866,94,960,9.791666666666666
10334,330350005170016,83,113,73,83,85,46,26,11,483,37,520,7.115384615384615
10335,330350005170017,74,92,120,105,120,69,56,19,580,75,655,11.450381679389313
10336,330350005170018,78,77,87,102,97,62,28,13,503,41,544,7.536764705882353
10337,330350005170019,79,83,73,71,64,40,20,11,410,31,441,7.029478458049887
10338,330350005170020,96,90,114,86,72,63,36,16,521,52,573,9.075043630017452
10339,330350005170021,69,120,94,97,99,70,50,24,549,74,623,11.87800963081862
10340,330350005170022,93,129,133,133,110,75,46,37,673,83,756,10.97883597883598
10341,330350005170023,53,77,51,48,57,32,11,14,318,25,343,7.288629737609329
10342,330350005170024,76,62,90,67,53,60,27,32,408,59,467,12.633832976445396
10343,330350005170025,114,153,113,98,99,69,28,18,646,46,692,6.6473988439306355
10344,330350005170026,116,158,127,103,81,69,43,30,654,73,727,10.041265474552958
10345,330350005170027,85,108,75,71,78,55,27,23,472,50,522,9.578544061302683
10346,330350005170028,148,158,150,138,111,91,53,31,796,84,880,9.545454545454545
10347,330350005170029,112,107,131,88,82,51,36,17,571,53,624,8.493589743589743
10348,330350005170030,161,217,179,184,179,98,52,43,1018,95,1113,8.53548966756514
10349,330350005170031,102,131,113,113,85,76,52,27,620,79,699,11.301859799713878
10350,330350005170032,38,43,57,38,46,33,20,18,255,38,293,12.969283276450511
10351,330350005170033,123,129,109,89,106,49,39,24,605,63,668,9.431137724550899
10352,330350005170034,154,187,180,131,124,96,46,42,872,88,960,9.166666666666666
10353,330350005170035,196,217,177,163,166,101,46,36,1020,82,1102,7.441016333938294
10354,330350005170036,199,226,205,181,117,79,44,26,1007,70,1077,6.499535747446611
10355,330350005170037,226,275,199,206,159,82,53,50,1147,103,1250,8.24
10356,330350005170038,64,145,89,98,76,61,33,21,533,54,587,9.199318568994888
10357,330350005170039,76,84,81,92,52,54,37,24,439,61,500,12.2
10358,330350005170040,74,100,104,81,74,50,36,13,483,49,532,9.210526315789474
10359,330350005170041,71,104,77,67,53,34,22,20,406,42,448,9.375
10360,330350005170042,76,103,93,90,74,42,20,21,478,41,519,7.89980732177264
10361,330350005170043,150,182,209,184,158,125,75,60,1008,135,1143,11.811023622047244
10362,330350005170044,60,84,62,79,62,40,26,12,387,38,425,8.941176470588236
10363,330350005170045,150,170,151,133,136,79,48,40,819,88,907,9.70231532524807
10364,330350005170046,134,143,144,104,124,52,32,35,701,67,768,8.723958333333334
10365,330350005170047,114,118,125,110,89,79,29,36,635,65,700,9.285714285714286
10366,330350005170048,146,204,111,121,95,74,50,32,751,82,833,9.843937575030012
10367,330350005170049,96,129,60,93,81,53,38,22,512,60,572,10.48951048951049
10368,330350005170050,111,176,166,138,100,66,48,25,757,73,830,8.795180722891565
10369,330350005170051,119,138,122,116,109,81,47,25,685,72,757,9.511228533685602
10370,330350005170052,102,113,132,102,75,77,37,15,601,52,653,7.9632465543644715
10371,330350005170053,117,166,172,145,132,108,54,31,840,85,925,9.18918918918919
10372,330350005170054,103,112,108,97,77,54,47,34,551,81,632,12.816455696202532
10373,330350005170055,131,174,147,142,107,78,46,26,779,72,851,8.46063454759107
10374,330350005170056,109,112,98,94,98,63,26,27,574,53,627,8.452950558213717
10375,330350005170057,132,169,146,132,81,77,50,40,737,90,827,10.882708585247883
10376,330350005170058,149,140,114,106,105,49,24,25,663,49,712,6.882022471910112
10377,330350005170059,92,120,75,83,79,54,38,20,503,58,561,10.33868092691622
10378,330350005170060,155,197,129,135,126,87,43,42,829,85,914,9.299781181619256
10379,330350005170061,216,227,215,149,122,84,56,31,1013,87,1100,7.909090909090909
10380,330350005170062,154,238,145,156,122,64,48,25,879,73,952,7.668067226890757
10381,330350005170063,54,65,57,62,46,35,13,5,319,18,337,5.341246290801187
10382,330350005170064,92,101,106,75,77,53,38,23,504,61,565,10.79646017699115
10383,330350005170065,113,117,127,101,66,43,46,20,567,66,633,10.42654028436019
10384,330350005170067,86,100,130,114,89,89,51,32,608,83,691,12.011577424023155
10385,330350005170068,103,151,130,113,121,86,54,35,704,89,793,11.223203026481714
10386,330350005170069,110,127,124,110,91,72,40,32,634,72,706,10.19830028328612
10387,330350005170070,139,151,137,133,117,95,42,27,772,69,841,8.204518430439952
10388,330350005170071,78,110,83,72,62,31,15,13,436,28,464,6.0344827586206895
10389,330350005170072,89,138,86,95,92,65,30,18,565,48,613,7.830342577487765
10390,330350005170073,270,308,204,235,172,112,61,25,1301,86,1387,6.2004325883201155
10391,330350005170074,91,108,90,86,84,50,27,20,509,47,556,8.453237410071942
10392,330350005170075,119,115,95,117,68,62,32,19,576,51,627,8.133971291866029
10393,330350005170076,138,182,139,121,120,89,33,18,789,51,840,6.071428571428571
10394,330350005170077,136,157,125,105,86,62,29,16,671,45,716,6.284916201117318
10395,330350005170078,81,107,81,71,83,43,17,19,466,36,502,7.171314741035856
10396,330350005170079,85,104,121,89,108,59,30,22,566,52,618,8.414239482200648
10397,330350005170080,69,94,78,71,53,42,26,12,407,38,445,8.539325842696629
10398,330350005170081,46,73,64,58,55,40,41,25,336,66,402,16.417910447761194
10399,330350005170082,47,46,65,53,33,34,22,13,278,35,313,11.182108626198083
10400,330350005170083,27,53,70,48,45,61,30,21,304,51,355,14.366197183098592
10401,330350005170084,58,93,69,62,57,43,21,7,382,28,410,6.829268292682927
10402,330350005170085,45,59,28,32,37,24,6,8,225,14,239,5.857740585774058
10403,330350005170086,120,132,111,102,76,56,16,16,597,32,629,5.087440381558029
10404,330350005170087,99,139,109,107,102,68,35,45,624,80,704,11.363636363636363
10405,330350005170088,116,129,112,128,101,54,35,23,640,58,698,8.30945558739255
10406,330350005170089,41,66,54,62,43,38,30,12,304,42,346,12.138728323699421
10407,330350005170090,70,107,80,103,81,50,42,26,491,68,559,12.164579606440071
10408,330350005170091,76,89,81,52,66,52,36,21,416,57,473,12.050739957716702
10409,330350005170092,61,76,83,70,69,63,29,21,422,50,472,10.59322033898305
10410,330350005170093,58,65,86,46,39,61,18,10,355,28,383,7.310704960835509
10411,330350005180001,56,90,96,70,88,68,48,45,468,93,561,16.577540106951872
10412,330350005180002,48,74,82,44,61,54,31,17,363,48,411,11.678832116788321
10413,330350005180003,75,101,78,83,76,53,26,27,466,53,519,10.211946050096339
10414,330350005180004,136,145,110,124,66,61,39,27,642,66,708,9.322033898305085
10415,330350005180005,80,93,101,80,112,59,43,26,525,69,594,11.616161616161616
10416,330350005180006,33,44,45,42,43,34,11,5,241,16,257,6.22568093385214
10417,330350005180007,44,52,40,50,47,27,24,17,260,41,301,13.621262458471762
10418,330350005180008,109,143,119,119,123,87,69,40,700,109,809,13.473423980222497
10420,330350005180010,114,147,116,113,99,83,48,38,672,86,758,11.345646437994723
10421,330350005180011,54,77,72,59,64,54,27,19,380,46,426,10.7981220657277
10422,330350005180012,238,263,365,299,145,46,9,4,1356,13,1369,0.9495982468955442
10423,330350005180013,55,62,68,69,45,48,22,31,347,53,400,13.25
10424,330350005180014,115,152,141,111,131,68,49,26,718,75,793,9.457755359394703
10425,330350005180015,74,90,61,81,55,30,23,17,391,40,431,9.280742459396752
10426,330350005180016,47,58,65,49,58,37,26,19,314,45,359,12.534818941504179
10427,330350005180017,111,153,108,116,117,63,38,26,668,64,732,8.743169398907105
10428,330350005180018,86,86,95,83,58,54,30,20,462,50,512,9.765625
10429,330350005180019,109,133,93,84,64,50,26,14,533,40,573,6.980802792321117
10430,330350005180020,86,86,93,72,90,45,37,26,472,63,535,11.77570093457944
10431,330350005180021,101,153,114,123,106,52,50,34,649,84,733,11.459754433833561
10432,330350005180022,96,129,90,121,78,61,41,19,575,60,635,9.448818897637794
10433,330350005180023,71,112,84,116,95,51,36,21,529,57,586,9.726962457337883
10434,330350005180024,54,67,51,57,60,31,14,22,320,36,356,10.112359550561798
10435,330350005180025,92,111,77,114,96,62,25,22,552,47,599,7.846410684474123
10436,330350005180026,72,95,86,75,69,50,22,18,447,40,487,8.213552361396303
10437,330350005180027,118,129,110,87,69,53,34,15,566,49,615,7.967479674796748
10438,330350005180028,119,140,134,118,96,60,25,31,667,56,723,7.745504840940526
10439,330350005180029,159,244,174,172,149,107,56,45,1005,101,1106,9.132007233273056
10440,330350005180030,63,81,70,71,56,36,26,12,377,38,415,9.156626506024097
10441,330350005180031,221,286,217,215,154,115,71,47,1208,118,1326,8.89894419306184
10442,330350005180032,102,103,106,99,77,70,24,15,557,39,596,6.543624161073826
10443,330350005180033,126,119,90,106,83,49,32,21,573,53,626,8.466453674121405
10444,330350005180034,51,81,85,85,59,69,57,20,430,77,507,15.187376725838265
10445,330350005180035,76,110,102,106,98,63,40,22,555,62,617,10.048622366288493
10446,330350005180036,82,117,87,92,72,51,29,29,501,58,559,10.37567084078712
10447,330350005180037,130,126,142,105,109,78,47,34,690,81,771,10.505836575875486
10448,330350005180038,108,151,116,109,105,73,30,41,662,71,733,9.686221009549795
10449,330350005180039,205,234,186,162,112,79,65,35,978,100,1078,9.276437847866418
10450,330350005180040,67,63,82,63,89,45,31,26,409,57,466,12.231759656652361
10451,330350005180041,75,102,93,80,66,52,26,24,468,50,518,9.652509652509652
10452,330350005180042,68,100,74,59,64,40,29,22,405,51,456,11.18421052631579
10453,330350005180043,88,144,82,94,66,48,27,22,522,49,571,8.581436077057793
10454,330350005180044,78,130,105,97,84,62,41,13,556,54,610,8.852459016393443
10455,330350005180045,125,164,127,120,105,78,49,37,719,86,805,10.683229813664596
10456,330350005180046,66,101,89,72,89,39,40,31,456,71,527,13.472485768500949
10457,330350005180047,120,155,131,107,86,52,35,17,651,52,703,7.396870554765291
10458,330350005180048,215,257,201,195,166,97,63,47,1131,110,1241,8.8638195004029
10459,330350005180049,148,147,129,126,96,73,59,18,719,77,796,9.673366834170855
10460,330350005180050,172,197,142,148,121,68,75,48,848,123,971,12.667353244078269
10461,330350005180051,92,122,80,95,71,35,32,22,495,54,549,9.836065573770492
10462,330350005180052,100,118,94,85,77,41,26,23,515,49,564,8.687943262411348
10463,330350005180053,81,90,85,82,67,54,33,24,459,57,516,11.046511627906977
10464,330350005180054,84,122,111,108,80,66,52,27,571,79,650,12.153846153846153
10465,330350005180055,149,189,157,137,140,93,49,47,865,96,961,9.989594172736732
10466,330350005180056,207,266,220,202,181,119,51,42,1195,93,1288,7.220496894409938
10467,330350005180057,66,95,66,73,81,34,49,27,415,76,491,15.478615071283096
10468,330350005180058,107,112,107,90,69,80,48,20,565,68,633,10.742496050552923
10469,330350005180059,87,87,100,90,68,65,29,31,497,60,557,10.771992818671455
10470,330350005180060,150,174,129,128,102,53,19,22,736,41,777,5.276705276705277
10471,330350005180061,82,138,89,78,75,53,24,14,515,38,553,6.871609403254973
10472,330350005180062,83,98,111,92,96,54,50,31,534,81,615,13.170731707317072
10473,330350005180063,134,161,149,172,114,86,52,51,816,103,919,11.207834602829163
10474,330350005180064,95,119,82,111,75,44,29,23,526,52,578,8.996539792387543
10475,330350005180065,92,90,71,95,74,35,23,22,457,45,502,8.96414342629482
10476,330350005180066,118,140,156,143,151,68,55,42,776,97,873,11.11111111111111
10477,330350005180067,75,80,86,70,81,50,37,23,442,60,502,11.952191235059761
10478,330350005180068,56,60,63,57,58,35,18,16,329,34,363,9.366391184573002
10479,330350005180069,127,141,138,118,101,83,41,34,708,75,783,9.578544061302683
10480,330350005180070,56,75,77,65,45,31,35,19,349,54,403,13.399503722084367
10481,330350005180071,94,110,98,86,62,44,19,21,494,40,534,7.49063670411985
10482,330350005180072,125,121,117,96,75,43,41,27,577,68,645,10.542635658914728
10483,330350005180073,93,119,91,105,77,46,42,14,531,56,587,9.540034071550256
10484,330350005180074,86,113,90,84,66,63,26,20,502,46,548,8.394160583941606
10485,330350005180075,138,152,166,113,118,91,46,38,778,84,862,9.74477958236659
10486,330350005180076,204,162,161,162,137,91,58,24,917,82,999,8.208208208208209
10487,330350005180077,93,109,101,89,98,70,39,26,560,65,625,10.4
10488,330350005180078,120,162,137,177,93,95,79,42,784,121,905,13.370165745856353
10489,330350005180079,115,148,114,130,86,74,52,27,667,79,746,10.589812332439678
10490,330350005180080,116,135,121,104,84,53,35,27,613,62,675,9.185185185185185
10491,330350005180081,86,124,101,72,78,46,25,15,507,40,547,7.312614259597806
10492,330350005180082,144,179,170,137,107,72,45,41,809,86,895,9.608938547486034
10493,330350005180083,181,224,142,161,119,65,42,18,892,60,952,6.302521008403361
10494,330350005180084,86,122,68,81,77,28,20,17,462,37,499,7.414829659318637
10495,330350005180085,207,196,212,174,124,100,61,37,1013,98,1111,8.82088208820882
10496,330350005180086,142,203,137,138,106,95,56,31,821,87,908,9.581497797356828
10497,330350005180087,133,124,112,91,84,51,46,23,595,69,664,10.391566265060241
10498,330350005180088,134,114,92,98,69,42,39,15,549,54,603,8.955223880597014
10500,330350005180090,153,145,163,158,113,72,38,29,804,67,871,7.6923076923076925
10501,330350005180091,76,142,102,118,100,71,46,28,609,74,683,10.834553440702782
10502,330350005180092,81,107,84,81,83,46,36,28,482,64,546,11.72161172161172
10503,330350005180093,91,122,107,70,78,42,22,19,510,41,551,7.441016333938294
10504,330350005180094,82,99,97,94,100,61,33,20,533,53,586,9.044368600682594
10505,330350005180095,92,94,89,77,85,61,24,19,498,43,541,7.948243992606285
10506,330350005180096,48,61,68,72,50,46,27,18,345,45,390,11.538461538461538
10507,330350005180097,115,125,116,137,92,60,30,14,645,44,689,6.386066763425254
10508,330350005180098,121,168,130,158,109,78,29,28,764,57,821,6.942752740560293
10509,330350005180099,131,153,142,122,102,67,34,31,717,65,782,8.312020460358056
10510,330350005180100,71,93,71,81,53,49,21,22,418,43,461,9.327548806941431
10511,330350005180101,151,202,141,160,119,104,58,41,877,99,976,10.14344262295082
10512,330350005180102,110,118,112,94,91,69,45,15,594,60,654,9.174311926605505
10513,330350005180103,154,192,140,149,102,74,62,40,811,102,913,11.171960569550931
10514,330350005180104,95,103,78,89,59,38,29,16,462,45,507,8.875739644970414
10515,330350005180105,78,104,79,80,72,46,34,16,459,50,509,9.82318271119843
10516,330350005180106,140,232,159,123,124,79,44,28,857,72,929,7.750269106566201
10517,330350005180107,127,86,101,72,40,46,35,12,472,47,519,9.05587668593449
10518,330350005180108,113,184,108,105,100,65,38,28,675,66,741,8.906882591093117
10519,330350005180109,93,136,108,70,99,52,20,26,558,46,604,7.6158940397351
10520,330350005180110,127,168,112,112,85,52,26,18,656,44,700,6.285714285714286
10521,330350005180111,182,235,181,182,148,83,52,40,1011,92,1103,8.340888485947415
10522,330350005180112,137,212,132,159,150,101,55,48,891,103,994,10.362173038229376
10523,330350005180113,110,154,96,109,73,66,42,20,608,62,670,9.253731343283581
10524,330350005180114,93,125,90,81,88,64,41,40,541,81,622,13.02250803858521
10525,330350005180115,73,102,100,77,83,60,34,21,495,55,550,10.0
10526,330350005180116,101,83,94,81,49,38,21,12,446,33,479,6.8893528183716075
10527,330350005180117,95,148,119,115,93,57,52,45,627,97,724,13.397790055248619
10528,330350005180118,79,74,71,77,63,47,32,18,411,50,461,10.845986984815617
10529,330350005180119,45,70,63,57,69,54,30,25,358,55,413,13.317191283292978
10530,330350005180120,43,45,46,38,39,33,13,10,244,23,267,8.614232209737828
10531,330350005180121,82,107,86,72,68,47,18,15,462,33,495,6.666666666666667
10532,330350005180122,77,66,91,64,67,56,36,15,421,51,472,10.805084745762711
10533,330350005180123,40,51,50,51,27,26,21,6,245,27,272,9.926470588235293
10534,330350005180124,64,100,91,79,94,64,36,43,492,79,571,13.8353765323993
10535,330350005180125,75,95,84,91,71,52,36,16,468,52,520,10.0
10536,330350005180126,87,121,89,100,87,58,26,33,542,59,601,9.816971713810316
10537,330350005180127,80,95,67,72,75,40,21,26,429,47,476,9.873949579831933
10538,330350005180128,73,138,94,89,101,59,34,33,554,67,621,10.789049919484702
10539,330350005180129,107,97,117,97,75,65,40,36,558,76,634,11.987381703470032
10540,330350005180130,104,134,99,99,87,41,31,22,564,53,617,8.589951377633712
10541,330350005180131,52,68,49,49,55,39,21,17,312,38,350,10.857142857142858
10542,330350005180132,105,142,113,85,77,52,26,20,574,46,620,7.419354838709677
10543,330350005180133,81,90,110,82,76,63,51,29,502,80,582,13.745704467353951
10544,330350005180134,107,159,99,87,102,55,29,11,609,40,649,6.163328197226503
10545,330350005180135,45,72,61,50,65,26,29,17,319,46,365,12.602739726027398
10546,330350005180136,63,64,79,80,68,41,30,30,395,60,455,13.186813186813186
10547,330350005180137,90,137,92,95,81,39,30,22,534,52,586,8.873720136518772
10548,330350005180138,111,116,125,119,59,57,51,19,587,70,657,10.654490106544902
10549,330350005180139,47,68,47,49,31,45,24,18,287,42,329,12.76595744680851
10550,330350005180140,57,67,65,52,60,38,21,15,339,36,375,9.6
10551,330350005180141,75,95,95,83,77,43,24,26,468,50,518,9.652509652509652
10552,330350005180142,38,72,46,45,53,33,11,8,287,19,306,6.209150326797386
10553,330350005180143,49,67,63,61,29,42,21,10,311,31,342,9.064327485380117
10554,330350005180144,43,76,84,72,50,44,25,23,369,48,417,11.510791366906474
10555,330350005180145,52,65,74,52,71,51,34,29,365,63,428,14.719626168224298
10556,330350005180146,57,82,73,59,63,44,20,18,378,38,416,9.134615384615385
10557,330350005180147,101,146,152,114,93,107,39,19,713,58,771,7.522697795071336
10558,330350005180148,105,115,102,83,66,48,32,27,519,59,578,10.207612456747405
10559,330350005180149,64,62,70,58,55,40,24,14,349,38,387,9.819121447028424
10560,330350005180150,58,76,70,59,72,48,20,28,383,48,431,11.136890951276103
10561,330350005180151,66,91,84,77,77,46,37,17,441,54,495,10.909090909090908
10562,330350005180152,64,85,71,51,54,44,20,12,369,32,401,7.980049875311721
10563,330350005180153,37,62,57,46,57,27,18,19,286,37,323,11.455108359133128
10564,330350005180154,63,95,76,63,66,34,25,15,397,40,437,9.153318077803204
10565,330350005180155,100,91,79,82,41,44,28,16,437,44,481,9.147609147609147
10566,330350005180156,72,77,93,54,70,44,16,14,410,30,440,6.818181818181818
10567,330350005180157,48,51,69,57,45,32,14,22,302,36,338,10.650887573964496
10568,330350005180158,51,70,62,62,57,37,26,18,339,44,383,11.488250652741515
10569,330350005180159,67,74,70,49,51,30,11,10,341,21,362,5.801104972375691
10570,330350005180160,90,84,67,88,45,27,15,18,401,33,434,7.6036866359447
10571,330350005180161,104,119,109,106,78,71,36,21,587,57,644,8.850931677018634
10572,330350005180162,160,160,131,154,93,67,33,27,765,60,825,7.2727272727272725
10573,330350005180163,111,116,109,81,66,38,22,19,521,41,562,7.295373665480427
10575,330350005180165,162,169,139,149,108,87,45,27,814,72,886,8.126410835214447
10576,330350005180167,43,60,63,37,52,29,15,11,284,26,310,8.387096774193548
10577,330350005190001,184,254,238,182,175,141,77,48,1174,125,1299,9.62278675904542
10578,330350005190002,94,120,123,120,88,99,45,37,644,82,726,11.294765840220386
10579,330350005190003,127,144,192,147,127,101,62,40,838,102,940,10.851063829787234
10580,330350005190004,184,247,171,198,118,102,71,18,1020,89,1109,8.025247971145175
10581,330350005190005,196,216,217,165,123,87,51,29,1004,80,1084,7.380073800738008
10582,330350005190006,157,186,155,177,108,79,48,25,862,73,935,7.807486631016043
10583,330350005190007,221,268,190,223,171,89,75,43,1162,118,1280,9.21875
10584,330350005190008,104,100,94,111,75,59,46,27,543,73,616,11.85064935064935
10585,330350005190009,53,50,38,31,32,23,8,4,227,12,239,5.02092050209205
10586,330350005190010,73,109,85,81,82,78,40,33,508,73,581,12.564543889845094
10587,330350005190011,92,146,104,99,101,65,35,30,607,65,672,9.672619047619047
10588,330350005190012,82,105,59,65,51,20,9,12,382,21,403,5.2109181141439205
10589,330350005190013,131,195,168,150,126,111,57,24,881,81,962,8.41995841995842
10590,330350005190014,156,199,178,159,130,110,51,52,932,103,1035,9.951690821256038
10591,330350005190015,169,176,174,161,160,121,98,106,961,204,1165,17.510729613733904
10592,330350005190016,81,121,104,87,100,75,32,16,568,48,616,7.792207792207792
10593,330350005190017,134,153,125,120,108,63,58,28,703,86,789,10.899873257287705
10594,330350005190018,160,213,176,159,146,103,56,54,957,110,1067,10.309278350515465
10595,330350005190019,67,89,57,66,65,48,35,28,392,63,455,13.846153846153847
10596,330350005190020,108,128,117,95,88,58,44,25,594,69,663,10.407239819004525
10597,330350005190021,222,314,198,212,145,111,59,28,1202,87,1289,6.749418153607448
10598,330350005190022,131,154,143,135,127,77,50,41,767,91,858,10.606060606060606
10599,330350005190023,160,180,143,163,100,94,56,32,840,88,928,9.482758620689655
10600,330350005190024,44,54,56,48,37,32,17,14,271,31,302,10.264900662251655
10601,330350005190025,118,141,109,136,101,76,38,29,681,67,748,8.957219251336898
10602,330350005190026,111,152,122,107,95,56,28,34,643,62,705,8.794326241134751
10603,330350005190027,75,103,106,86,91,71,36,29,532,65,597,10.887772194304858
10604,330350005190028,162,194,150,126,101,61,41,20,794,61,855,7.1345029239766085
10605,330350005190029,99,125,122,115,95,70,44,27,626,71,697,10.18651362984218
10606,330350005190030,100,90,79,85,73,37,20,5,464,25,489,5.112474437627812
10607,330350005190031,112,128,98,104,92,65,34,17,599,51,650,7.846153846153846
10608,330350005190032,234,260,236,197,149,123,54,26,1199,80,1279,6.254886630179828
10609,330350005190033,183,231,159,188,159,93,47,43,1013,90,1103,8.159564823209429
10610,330350005190034,137,160,116,130,114,80,45,19,737,64,801,7.990012484394507
10611,330350005190035,125,147,161,139,120,112,76,30,804,106,910,11.648351648351648
10612,330350005190036,130,163,158,113,114,87,62,31,765,93,858,10.839160839160838
10613,330350005190037,155,177,129,113,121,79,42,22,774,64,838,7.637231503579952
10614,330350005190038,187,199,167,167,130,100,53,28,950,81,1031,7.8564500484966056
10615,330350005190039,125,201,157,161,138,82,80,51,864,131,995,13.165829145728644
10616,330350005190040,88,140,131,120,111,81,46,35,671,81,752,10.77127659574468
10617,330350005190041,132,201,184,135,171,131,82,60,954,142,1096,12.956204379562044
10618,330350005190042,242,299,217,227,163,146,50,47,1294,97,1391,6.9734004313443565
10619,330350005190043,166,234,207,197,160,89,61,32,1053,93,1146,8.115183246073299
10620,330350005190044,87,143,101,96,87,82,29,17,596,46,642,7.165109034267913
10621,330350005190045,221,288,201,215,175,91,53,20,1191,73,1264,5.775316455696203
10622,330350005190046,125,174,125,116,99,73,39,29,712,68,780,8.717948717948717
10623,330350005190047,112,146,111,104,99,73,39,20,645,59,704,8.380681818181818
10624,330350005190048,156,170,159,148,106,75,40,22,814,62,876,7.077625570776256
10625,330350005190049,161,199,189,202,138,104,73,30,993,103,1096,9.397810218978103
10626,330350005190050,165,217,171,188,137,86,55,25,964,80,1044,7.662835249042145
10627,330350005190051,124,158,151,122,108,109,45,21,772,66,838,7.875894988066825
10628,330350005190052,150,199,177,160,101,88,70,41,875,111,986,11.257606490872211
10629,330350005190053,70,97,95,103,63,72,50,23,500,73,573,12.739965095986038
10630,330350005190054,118,167,126,112,91,60,40,24,674,64,738,8.672086720867208
10631,330350005190055,95,130,125,111,79,67,53,27,607,80,687,11.644832605531295
10632,330350005190056,131,158,150,136,92,71,54,27,738,81,819,9.89010989010989
10633,330350005190057,92,119,100,101,76,54,36,17,542,53,595,8.907563025210084
10634,330350005190058,90,110,122,112,71,85,49,30,590,79,669,11.80866965620329
10635,330350005190059,77,133,100,122,89,86,52,26,607,78,685,11.386861313868613
10636,330350005190060,157,221,192,150,152,96,65,33,968,98,1066,9.193245778611633
10637,330350005190061,166,163,197,145,109,94,56,32,874,88,962,9.147609147609147
10638,330350005190062,22,41,23,19,20,22,10,9,147,19,166,11.44578313253012
10639,330350005190063,86,129,87,99,66,46,40,25,513,65,578,11.245674740484429
10640,330350005190064,147,238,163,127,154,100,58,27,929,85,1014,8.382642998027613
10641,330350005190065,65,85,84,69,55,58,19,8,416,27,443,6.094808126410835
10642,330350005190066,72,79,83,89,42,45,41,12,410,53,463,11.44708423326134
10643,330350005190067,168,178,168,158,124,87,43,26,883,69,952,7.2478991596638656
10644,330350005190068,192,220,158,148,135,93,47,24,946,71,1017,6.981317600786627
10645,330350005190069,110,139,111,123,97,69,53,37,649,90,739,12.178619756427604
10646,330350005190070,135,166,136,104,95,54,36,20,690,56,746,7.506702412868632
10647,330350005190071,131,147,118,110,76,57,28,20,639,48,687,6.986899563318778
10648,330350005190072,271,288,262,270,190,128,63,31,1409,94,1503,6.254158349966733
10649,330350005190073,184,184,143,169,131,77,35,40,888,75,963,7.788161993769471
10650,330350005190074,78,93,92,85,50,73,25,35,471,60,531,11.299435028248588
10651,330350005190075,102,155,109,132,98,75,46,27,671,73,744,9.811827956989248
10652,330350005190076,69,84,64,60,55,41,19,16,373,35,408,8.57843137254902
10653,330350005190077,90,104,100,81,64,45,23,16,484,39,523,7.45697896749522
10654,330350005190078,80,85,82,64,69,31,31,9,411,40,451,8.869179600886918
10655,330350005190079,69,120,123,72,92,70,32,35,546,67,613,10.929853181076671
10656,330350005190080,131,190,128,106,83,42,27,11,680,38,718,5.2924791086350975
10657,330350005190081,171,237,163,181,140,68,38,39,960,77,1037,7.42526518804243
10658,330350005190082,78,92,77,91,64,51,23,13,453,36,489,7.361963190184049
10659,330350005190083,52,46,41,37,25,19,16,5,220,21,241,8.71369294605809
10660,330350005190084,8,12,15,16,18,11,2,1,80,3,83,3.6144578313253013
10661,330350005190085,126,143,98,95,63,63,32,20,588,52,640,8.125
10662,330350005190086,48,81,74,51,63,54,30,15,371,45,416,10.817307692307692
10663,330350005200001,54,53,69,59,59,41,27,18,335,45,380,11.842105263157896
10664,330350005200002,117,150,135,161,141,126,50,51,830,101,931,10.848549946294307
10665,330350005200003,75,160,105,165,104,80,64,28,689,92,781,11.7797695262484
10666,330350005200004,57,100,74,89,91,70,54,29,481,83,564,14.71631205673759
10667,330350005200005,56,112,89,85,96,66,42,37,504,79,583,13.550600343053173
10668,330350005200006,128,138,146,138,148,93,46,34,791,80,871,9.184845005740527
10669,330350005200007,92,106,99,98,93,74,48,23,562,71,633,11.216429699842022
10670,330350005200008,39,61,60,82,74,52,28,25,368,53,421,12.589073634204276
10671,330350005200009,32,41,71,49,34,28,19,23,255,42,297,14.141414141414142
10672,330350005200010,19,42,53,29,35,23,11,5,201,16,217,7.373271889400922
10673,330350005200011,77,121,108,96,72,44,30,16,518,46,564,8.156028368794326
10674,330350005200012,94,114,115,102,95,65,41,32,585,73,658,11.094224924012158
10675,330350005200013,105,115,121,103,88,65,29,34,597,63,660,9.545454545454545
10676,330350005200014,48,42,51,59,20,23,26,17,243,43,286,15.034965034965035
10677,330350005200015,185,235,202,185,163,104,55,46,1074,101,1175,8.595744680851064
10678,330350005200016,101,150,168,154,116,86,39,50,775,89,864,10.300925925925926
10679,330350005200017,96,122,129,141,112,92,64,58,692,122,814,14.987714987714988
10680,330350005200018,93,135,126,133,113,99,42,45,699,87,786,11.068702290076336
10681,330350005200019,83,132,141,161,131,59,45,63,707,108,815,13.251533742331288
10682,330350005200020,216,300,231,229,218,133,77,55,1327,132,1459,9.047292666209733
10683,330350005200021,128,122,160,179,117,89,58,38,795,96,891,10.774410774410775
10684,330350005200022,142,203,192,209,139,97,65,43,982,108,1090,9.908256880733944
10685,330350005200023,100,164,138,129,110,62,37,22,703,59,762,7.742782152230971
10686,330350005200024,69,118,107,100,85,53,23,12,532,35,567,6.172839506172839
10687,330350005200025,136,170,138,150,134,75,49,33,803,82,885,9.265536723163843
10688,330350005200026,86,118,107,106,65,65,47,22,547,69,616,11.2012987012987
10689,330350005200027,77,130,70,115,113,75,34,32,580,66,646,10.21671826625387
10690,330350005200028,111,161,148,117,110,71,30,20,718,50,768,6.510416666666667
10691,330350005200029,131,143,174,147,94,84,32,14,773,46,819,5.616605616605616
10692,330350005200030,157,252,178,159,162,75,45,31,983,76,1059,7.176581680830973
10693,330350005200031,109,141,138,136,82,58,31,25,664,56,720,7.777777777777778
10694,330350005200032,79,124,99,100,79,55,41,26,536,67,603,11.11111111111111
10695,330350005200033,61,95,149,117,45,40,21,12,507,33,540,6.111111111111111
10696,330350005200034,84,127,121,95,95,77,32,27,599,59,658,8.966565349544073
10697,330350005200035,137,166,172,150,110,118,32,22,853,54,907,5.953693495038589
10698,330350005200036,112,151,84,101,79,41,22,9,568,31,599,5.175292153589315
10699,330350005200037,130,132,133,99,89,54,36,25,637,61,698,8.739255014326648
10700,330350005200038,105,141,140,122,101,62,31,18,671,49,720,6.805555555555555
10701,330350005200039,78,87,118,83,67,64,18,29,497,47,544,8.639705882352942
10702,330350005200040,100,147,137,159,139,85,46,32,767,78,845,9.23076923076923
10703,330350005200041,120,149,111,118,66,55,46,12,619,58,677,8.567208271787297
10704,330350005200042,47,112,90,121,101,28,27,9,499,36,535,6.728971962616822
10705,330350005200043,175,171,167,141,100,49,25,19,803,44,847,5.194805194805195
10706,330350005200044,56,87,60,60,62,26,28,20,351,48,399,12.030075187969924
10707,330350005200045,112,102,123,139,80,63,50,34,619,84,703,11.948790896159316
10708,330350005200046,124,115,201,190,120,29,12,3,779,15,794,1.8891687657430731
10709,330350005200047,108,122,101,97,74,54,22,16,556,38,594,6.397306397306397
10710,330350005200048,117,169,138,119,93,69,28,22,705,50,755,6.622516556291391
10711,330350005200049,123,127,148,135,89,91,52,18,713,70,783,8.939974457215836
10712,330350005200050,14,16,31,32,38,16,14,10,147,24,171,14.035087719298245
10713,330350005200051,30,28,45,46,23,20,16,6,192,22,214,10.280373831775702
10714,330350005200052,82,120,118,101,85,83,40,23,589,63,652,9.662576687116564
10715,330350005200053,78,114,99,98,80,76,39,34,545,73,618,11.812297734627832
10716,330350005200054,82,100,152,140,58,36,19,6,568,25,593,4.2158516020236085
10717,330350005200055,112,157,120,155,111,78,46,39,733,85,818,10.39119804400978
10718,330350005200056,80,120,121,99,101,75,55,22,596,77,673,11.441307578008916
10719,330350005200057,80,88,89,78,76,53,46,16,464,62,526,11.787072243346008
10720,330350005200058,136,169,123,143,108,74,40,25,753,65,818,7.946210268948655
10721,330350005200059,97,171,93,129,146,65,39,34,701,73,774,9.431524547803617
10722,330350005200060,96,136,110,106,89,44,26,10,581,36,617,5.834683954619125
10723,330350005200061,163,241,214,175,137,64,64,28,994,92,1086,8.47145488029466
10724,330350005200062,153,173,129,122,86,49,37,31,712,68,780,8.717948717948717
10725,330350005200063,136,245,152,128,112,122,39,17,895,56,951,5.888538380651945
10726,330350005200064,135,148,128,137,89,81,35,11,718,46,764,6.020942408376963
10727,330350005200065,105,163,124,129,86,46,21,20,653,41,694,5.9077809798270895
10728,330350005200066,45,83,51,52,52,45,22,17,328,39,367,10.626702997275205
10729,330350005200067,81,103,89,101,72,65,28,12,511,40,551,7.259528130671506
10730,330350005200068,35,56,109,95,65,42,24,7,402,31,433,7.159353348729792
10731,330350005200069,68,96,83,59,92,62,24,35,460,59,519,11.368015414258188
10732,330350005200070,90,120,97,96,83,63,46,31,549,77,626,12.300319488817891
10733,330350005200071,62,72,81,79,85,36,21,31,415,52,467,11.13490364025696
10734,330350005200072,28,41,39,36,35,22,7,10,201,17,218,7.798165137614679
10735,330350005200073,48,73,77,100,87,50,19,19,435,38,473,8.033826638477802
10736,330350005200074,58,80,112,129,86,53,46,25,518,71,589,12.054329371816639
10737,330350005200075,100,119,106,75,95,53,20,15,548,35,583,6.003430531732419
10738,330350005200076,73,106,134,117,62,51,13,7,543,20,563,3.552397868561279
10739,330350005200077,80,119,99,99,75,55,33,12,527,45,572,7.8671328671328675
10740,330350005200078,85,103,113,94,76,64,43,24,535,67,602,11.129568106312293
10741,330350005200079,138,163,138,129,78,59,21,16,705,37,742,4.986522911051213
10742,330350005200080,85,99,134,93,66,48,27,23,525,50,575,8.695652173913043
10743,330350005200081,105,267,94,105,120,108,19,4,799,23,822,2.798053527980535
10744,330350005200082,51,79,79,61,69,38,15,21,377,36,413,8.716707021791768
10745,330350005200083,88,106,90,87,56,50,28,15,477,43,520,8.26923076923077
10746,330350005200084,59,98,67,62,36,43,14,16,365,30,395,7.594936708860759
10747,330350005200085,48,77,62,66,57,35,21,21,345,42,387,10.852713178294573
10748,330350005200086,47,35,58,56,35,35,8,2,266,10,276,3.6231884057971016
10749,330350005210001,57,96,48,42,39,43,18,14,325,32,357,8.96358543417367
10750,330350005210002,20,21,31,16,23,22,16,13,133,29,162,17.901234567901234
10751,330350005210004,50,58,41,34,29,22,23,15,234,38,272,13.970588235294118
10752,330350005210005,81,76,85,67,84,48,49,31,441,80,521,15.355086372360844
10753,330350005210006,85,109,80,71,78,60,27,24,483,51,534,9.55056179775281
10754,330350005210007,141,164,136,98,106,78,37,37,723,74,797,9.284818067754077
10755,330350005210008,118,126,119,77,99,86,55,34,625,89,714,12.46498599439776
10756,330350005210009,41,54,21,21,21,22,16,9,180,25,205,12.195121951219512
10757,330350005210010,64,59,41,50,40,28,21,16,282,37,319,11.598746081504702
10758,330350005210011,8,7,5,7,3,7,5,4,37,9,46,19.565217391304348
10759,330350005210012,110,136,127,110,97,70,50,22,650,72,722,9.97229916897507
10760,330350005210013,257,302,252,214,183,134,69,46,1342,115,1457,7.89293067947838
10761,330350005210014,44,46,39,27,32,20,7,8,208,15,223,6.726457399103139
10762,330350005210015,67,76,57,64,44,56,27,19,364,46,410,11.21951219512195
10763,330350005210016,31,54,27,24,24,31,22,10,191,32,223,14.349775784753364
10764,330350005210017,32,41,22,32,26,15,18,12,168,30,198,15.151515151515152
10765,330350005210018,13,16,10,15,9,8,10,7,71,17,88,19.318181818181817
10766,330350005210019,39,66,42,43,52,53,33,12,295,45,340,13.235294117647058
10767,330350005210020,20,35,25,21,32,17,11,12,150,23,173,13.294797687861271
10768,330350005210021,34,47,58,45,31,28,10,7,243,17,260,6.538461538461538
10769,330350005210022,39,39,28,34,40,28,18,13,208,31,239,12.97071129707113
10770,330350005210023,95,133,69,77,79,43,28,9,496,37,533,6.941838649155723
10771,330350005210024,47,55,39,36,37,43,25,13,257,38,295,12.88135593220339
10772,330350005210025,32,44,35,33,44,34,22,18,222,40,262,15.267175572519085
10773,330350005210026,30,24,17,17,22,15,11,4,125,15,140,10.714285714285714
10774,330350005210027,64,98,64,59,71,56,34,22,412,56,468,11.965811965811966
10775,330350005210028,22,28,32,22,15,16,12,10,135,22,157,14.012738853503185
10776,330350005210029,95,133,79,91,69,41,22,19,508,41,549,7.468123861566484
10777,330350005210030,66,99,78,54,54,54,27,20,405,47,452,10.398230088495575
10778,330350005210031,63,89,83,69,71,51,40,24,426,64,490,13.061224489795919
10779,330350005210032,91,131,90,97,87,85,51,40,581,91,672,13.541666666666666
10780,330360905000001,22,61,67,56,69,68,41,49,343,90,433,20.785219399538107
10781,330360905000002,75,128,163,167,159,124,108,66,816,174,990,17.575757575757574
10782,330360905000003,69,113,157,112,146,139,94,71,736,165,901,18.312985571587124
10783,330360905000004,55,80,81,92,99,75,56,46,482,102,584,17.465753424657535
10784,330360905000005,55,88,104,98,97,96,68,55,538,123,661,18.608169440242058
10785,330360905000006,76,128,138,204,159,113,131,36,818,167,985,16.95431472081218
10786,330360905000007,27,62,56,58,66,77,60,57,346,117,463,25.26997840172786
10787,330360905000008,37,82,88,94,130,70,57,73,501,130,631,20.602218700475436
10788,330360905000009,74,113,130,115,106,97,74,64,635,138,773,17.852522639068564
10789,330360905000010,42,89,56,43,57,46,22,17,333,39,372,10.483870967741936
10790,330360905000011,111,236,237,235,254,179,68,50,1252,118,1370,8.613138686131387
10791,330360905000012,45,44,59,40,42,31,18,13,261,31,292,10.616438356164384
10792,330360905000013,51,56,58,71,51,59,28,24,346,52,398,13.06532663316583
10793,330360905000014,82,170,151,141,149,138,79,47,831,126,957,13.16614420062696
10794,330360905000015,71,67,81,69,55,48,36,15,391,51,442,11.538461538461538
10795,330360905000016,17,30,35,22,27,18,10,7,149,17,166,10.240963855421686
10796,330360905000017,57,117,120,103,115,68,28,22,580,50,630,7.936507936507937
10797,330360905000018,89,131,129,133,114,68,42,17,664,59,723,8.160442600276625
10798,330360905000019,93,99,100,109,80,53,38,20,534,58,592,9.797297297297296
10799,330360905000020,128,450,289,289,195,96,58,27,1447,85,1532,5.5483028720626635
10800,330360905000021,97,135,171,143,146,104,64,42,796,106,902,11.751662971175167
10801,330360905000022,147,189,196,164,196,122,69,65,1014,134,1148,11.67247386759582
10802,330360905000023,0,2,24,51,78,60,21,8,215,29,244,11.885245901639344
10803,330360905000024,28,51,47,56,66,27,12,7,275,19,294,6.462585034013605
10804,330360905000025,73,169,105,112,134,95,30,28,688,58,746,7.774798927613941
10805,330360905000026,87,117,131,116,154,121,69,76,726,145,871,16.647531572904708
10806,330360905000027,56,94,82,85,87,90,59,46,494,105,599,17.529215358931552
10807,330360905000028,79,110,174,103,140,81,57,56,687,113,800,14.125
10808,330360905000029,68,148,122,135,142,72,55,32,687,87,774,11.24031007751938
10809,330360905000030,41,58,48,55,64,30,24,30,296,54,350,15.428571428571429
10810,330360905000031,82,146,96,115,124,71,42,23,634,65,699,9.298998569384835
10811,330360905000032,0,0,42,190,100,43,3,0,375,3,378,0.7936507936507936
10812,330360905000033,128,121,142,113,90,69,51,30,663,81,744,10.887096774193548
10813,330360905000034,81,98,110,93,108,99,35,31,589,66,655,10.076335877862595
10814,330360905000035,126,150,134,161,123,96,58,32,790,90,880,10.227272727272727
10815,330360905000036,141,226,147,137,162,113,84,59,926,143,1069,13.376987839101965
10816,330360905000037,88,120,119,121,142,82,45,41,672,86,758,11.345646437994723
10817,330360905000038,79,89,107,104,81,60,32,33,520,65,585,11.11111111111111
10818,330360905000039,66,99,99,86,83,42,30,20,475,50,525,9.523809523809524
10819,330360905000040,134,112,198,180,121,73,76,37,818,113,931,12.1374865735768
10820,330360905000041,177,189,214,231,189,101,58,37,1101,95,1196,7.94314381270903
10821,330360905000042,95,147,137,109,111,73,50,34,672,84,756,11.11111111111111
10822,330360905000043,87,116,176,166,144,99,44,34,788,78,866,9.006928406466512
10823,330360905000044,59,202,86,93,145,70,64,34,655,98,753,13.01460823373174
10824,330360905000045,52,88,78,88,89,58,38,19,453,57,510,11.176470588235293
10825,330360905000046,37,67,94,64,70,49,33,20,381,53,434,12.211981566820276
10826,330360905000047,93,100,176,133,102,85,56,31,689,87,776,11.211340206185566
10827,330360905000048,100,143,131,161,142,76,49,32,753,81,834,9.712230215827338
10828,330360905000049,120,173,137,150,132,93,61,33,805,94,899,10.456062291434927
10829,330360905000050,44,52,45,51,46,35,27,20,273,47,320,14.6875
10830,330360905000051,89,120,123,122,118,78,48,32,650,80,730,10.95890410958904
10831,330360905000052,70,937,117,130,490,199,125,250,1943,375,2318,16.17773943054357
10832,330360905000053,110,109,102,120,89,47,25,9,577,34,611,5.564648117839607
10833,330360905000054,151,189,274,238,95,65,32,17,1012,49,1061,4.618284637134779
10834,330360905000055,120,113,253,207,179,141,48,25,1013,73,1086,6.721915285451197
10835,330360905000056,52,65,71,82,60,51,40,22,381,62,443,13.99548532731377
10836,330360905000057,45,64,80,83,126,100,44,14,498,58,556,10.431654676258994
10837,330360905000058,6,24,24,26,58,28,13,7,166,20,186,10.75268817204301
10838,330360905000059,55,63,83,43,52,49,31,15,345,46,391,11.764705882352942
10839,330360905000060,52,87,105,92,109,119,52,40,564,92,656,14.024390243902438
10840,330360905000061,38,64,88,81,91,80,33,43,442,76,518,14.671814671814673
10841,330360905000062,27,30,31,30,32,35,19,11,185,30,215,13.953488372093023
10842,330360905000063,57,73,164,105,97,69,52,58,565,110,675,16.296296296296298
10843,330360905000064,45,68,62,58,64,49,32,25,346,57,403,14.1439205955335
10844,330360905000065,47,60,84,133,91,62,30,14,477,44,521,8.445297504798464
10845,330360905000066,82,88,58,103,95,40,29,24,466,53,519,10.211946050096339
10846,330360905000067,44,46,38,44,41,36,18,17,249,35,284,12.32394366197183
10847,330360905000068,63,87,138,142,126,90,62,52,646,114,760,15.0
10848,330370805000001,43,95,72,78,90,106,82,121,484,203,687,29.54876273653566
10849,330370805000002,116,126,131,116,120,118,85,74,727,159,886,17.945823927765236
10850,330370805000003,74,104,105,99,103,97,54,61,582,115,697,16.499282639885223
10851,330370805000004,0,3,13,18,15,2,4,5,51,9,60,15.0
10852,330370805000005,108,135,147,117,129,112,78,85,748,163,911,17.892425905598245
10853,330370805000006,103,137,127,106,103,87,52,51,663,103,766,13.446475195822455
10854,330370805000007,135,180,165,147,142,119,77,78,888,155,1043,14.860977948226271
10855,330370805000008,55,83,101,89,104,95,74,62,527,136,663,20.512820512820515
10856,330370805000009,42,78,62,68,76,72,55,67,398,122,520,23.46153846153846
10857,330370805000010,129,137,114,118,107,70,54,32,675,86,761,11.300919842312746
10858,330370805000011,67,96,71,74,93,45,35,37,446,72,518,13.8996138996139
10859,330370805000012,100,138,130,97,102,64,41,15,631,56,687,8.151382823871907
10860,330370805000013,72,110,131,92,126,94,58,64,625,122,747,16.331994645247658
10861,330370805000014,108,156,133,126,101,104,50,40,728,90,818,11.00244498777506
10862,330370805000015,94,146,130,115,129,122,69,57,736,126,862,14.617169373549883
10863,330370805000016,102,122,112,127,98,56,50,45,617,95,712,13.342696629213483
10864,330370805000017,92,108,129,105,106,93,71,66,633,137,770,17.792207792207794
10865,330370805000018,98,130,123,115,137,106,67,67,709,134,843,15.895610913404507
10866,330370805000019,38,30,43,51,41,47,27,25,250,52,302,17.218543046357617
10867,330370805000020,99,80,80,107,80,69,35,38,515,73,588,12.414965986394558
10868,330370805000021,39,54,44,42,42,30,21,20,251,41,292,14.04109589041096
10869,330370805000022,110,126,148,119,138,107,64,51,748,115,863,13.325608342989572
10870,330370805000023,141,195,128,119,111,89,38,30,783,68,851,7.990599294947121
10871,330370805000024,157,135,123,76,69,39,19,20,599,39,638,6.112852664576803
10872,330370805000025,47,81,48,50,40,27,19,15,293,34,327,10.397553516819572
10873,330370805000026,40,28,32,23,24,16,9,7,163,16,179,8.938547486033519
10874,330370805000027,43,60,37,33,27,24,9,10,224,19,243,7.818930041152264
10875,330370805000028,24,33,24,22,32,9,10,10,144,20,164,12.195121951219512
10876,330370805000029,94,94,94,88,83,47,36,28,500,64,564,11.347517730496454
10877,330370805000030,112,145,151,110,106,59,43,27,683,70,753,9.296148738379815
10878,330370805000031,59,71,49,53,42,20,19,15,294,34,328,10.365853658536585
10879,330370805000032,73,71,93,79,80,82,62,46,478,108,586,18.43003412969283
10880,330370810000001,89,92,66,76,55,52,43,38,430,81,511,15.851272015655578
10881,330370810000002,19,36,19,30,25,22,13,17,151,30,181,16.574585635359117
10882,330370810000003,76,112,65,79,64,55,29,40,451,69,520,13.26923076923077
10883,330370810000004,51,57,59,48,53,23,16,9,291,25,316,7.9113924050632916
10884,330370810000005,52,65,68,57,52,23,27,28,317,55,372,14.78494623655914
10885,330370815000001,100,139,137,136,139,109,70,84,760,154,914,16.849015317286653
10886,330370815000002,113,120,115,109,116,91,67,38,664,105,769,13.65409622886866
10887,330370815000003,88,79,100,76,87,58,36,27,488,63,551,11.433756805807622
10888,330370815000004,88,88,125,105,100,96,59,48,602,107,709,15.091678420310297
10889,330370815000005,101,105,113,88,107,78,26,28,592,54,646,8.359133126934985
10890,330370815000006,133,130,125,90,95,73,32,29,646,61,707,8.628005657708629
10891,330370815000007,74,88,81,92,94,48,48,20,477,68,545,12.477064220183486
10892,330370815000008,70,91,71,92,97,75,52,35,496,87,583,14.922813036020584
10893,330370815000009,85,84,125,103,103,98,60,47,598,107,705,15.177304964539006
10894,330370815000010,61,69,70,73,72,64,38,34,409,72,481,14.96881496881497
10895,330370815000011,74,123,145,110,126,111,72,49,689,121,810,14.938271604938272
10896,330370815000012,65,94,92,100,115,94,48,61,560,109,669,16.292974588938716
10897,330370815000013,57,69,61,61,83,65,31,41,396,72,468,15.384615384615385
10898,330370815000014,106,101,131,92,132,88,57,49,650,106,756,14.02116402116402
10899,330370815000015,99,116,107,111,109,73,39,32,615,71,686,10.349854227405247
10900,330370815000016,104,99,110,116,78,57,32,22,564,54,618,8.737864077669903
10901,330370815000017,1,2,2,0,1,2,6,1,8,7,15,46.666666666666664
10902,330370815000018,41,42,49,34,45,38,16,11,249,27,276,9.782608695652174
10903,330370815000019,69,64,58,68,67,40,41,32,366,73,439,16.62870159453303
10904,330370815000020,67,70,82,83,101,58,26,24,461,50,511,9.784735812133073
10905,330370815000021,54,66,60,67,65,49,23,19,361,42,403,10.421836228287841
10906,330370815000022,67,90,59,98,68,46,27,17,428,44,472,9.322033898305085
10907,330370815000023,68,70,78,67,68,66,23,33,417,56,473,11.839323467230445
10908,330370815000024,61,82,59,65,77,45,45,29,389,74,463,15.982721382289418
10909,330370815000025,55,69,71,75,61,71,33,20,402,53,455,11.648351648351648
10910,330370815000026,243,283,161,157,128,71,36,19,1043,55,1098,5.009107468123862
10911,330370815000027,83,83,107,88,64,81,31,21,506,52,558,9.31899641577061
10912,330370820000001,116,158,116,139,105,76,63,56,710,119,829,14.354644149577805
10913,330370820000002,111,143,119,122,96,96,46,38,687,84,771,10.894941634241246
10914,330370820000003,80,121,88,95,100,92,60,59,576,119,695,17.12230215827338
10915,330370820000004,54,59,43,44,52,41,17,19,293,36,329,10.94224924012158
10916,330370820000005,49,56,39,50,49,31,14,25,274,39,313,12.460063897763579
10917,330370820000006,78,73,63,86,63,36,40,27,399,67,466,14.377682403433477
10918,330370820000007,45,52,57,51,59,47,29,32,311,61,372,16.397849462365592
10919,330380705000001,6,21,12,12,23,19,14,17,93,31,124,25.0
10920,330380705000002,7,16,9,14,23,24,21,36,93,57,150,38.0
10921,330380705000003,59,79,67,65,73,61,29,39,404,68,472,14.40677966101695
10922,330380705000004,184,178,196,166,110,64,41,34,898,75,973,7.708119218910586
10923,330380705000005,80,124,97,78,70,71,23,15,520,38,558,6.810035842293907
10924,330380705000006,97,113,123,122,96,57,33,20,608,53,661,8.018154311649017
10925,330380705000007,115,121,135,123,90,57,31,27,641,58,699,8.297567954220314
10926,330380705000008,115,127,157,131,83,72,44,30,685,74,759,9.749670619235836
10927,330380705000009,154,154,164,129,87,75,51,35,763,86,849,10.129564193168433
10928,330380705000010,123,134,117,123,88,47,19,8,632,27,659,4.09711684370258
10929,330380705000011,106,133,113,87,69,48,28,9,556,37,593,6.239460370994941
10930,330380705000012,195,213,200,203,136,98,76,44,1045,120,1165,10.300429184549357
10931,330380705000013,207,222,200,166,109,83,52,41,987,93,1080,8.61111111111111
10932,330380705000014,83,93,107,111,104,76,72,40,574,112,686,16.3265306122449
10933,330380705000015,111,150,120,148,139,111,43,16,779,59,838,7.040572792362768
10934,330380705000016,98,101,89,112,105,62,35,17,567,52,619,8.40064620355412
10935,330380705000017,105,103,137,131,78,55,49,33,609,82,691,11.866859623733719
10936,330380705000018,18,16,20,15,18,11,5,2,98,7,105,6.666666666666667
10937,330380705000019,155,137,147,177,161,94,51,25,871,76,947,8.025343189017951
10938,330380705000020,70,79,82,101,88,79,50,26,499,76,575,13.217391304347826
10939,330380705000021,66,81,132,96,78,73,43,38,526,81,607,13.344316309719934
10940,330380705000022,30,37,54,39,58,49,23,41,267,64,331,19.335347432024168
10941,330380705000023,77,101,85,78,92,62,42,29,495,71,566,12.54416961130742
10942,330380705000024,135,166,169,157,136,107,48,28,870,76,946,8.033826638477802
10943,330380705000025,162,158,132,129,120,91,32,36,792,68,860,7.906976744186046
10944,330380705000026,128,135,85,126,91,53,21,19,618,40,658,6.079027355623101
10945,330380705000027,6,4,4,9,11,8,4,3,42,7,49,14.285714285714286
10946,330380705000028,40,30,29,38,25,19,16,16,181,32,213,15.023474178403756
10947,330380705000029,0,2,0,0,4,3,2,0,9,2,11,18.181818181818183
10948,330380705000032,112,142,129,107,99,99,46,30,688,76,764,9.947643979057592
10949,330380705000033,19,19,13,16,11,12,7,9,90,16,106,15.09433962264151
10950,330380705000034,158,198,187,147,155,100,54,35,945,89,1034,8.607350096711798
10951,330380705000035,0,1,0,2,4,0,5,0,7,5,12,41.666666666666664
10952,330380705000037,57,79,68,69,46,46,25,16,365,41,406,10.098522167487685
10953,330380705000038,160,159,150,132,118,86,55,38,805,93,898,10.356347438752785
10954,330380705000039,217,232,185,230,136,114,70,33,1114,103,1217,8.463434675431388
10955,330380705000040,134,131,132,156,144,96,45,35,793,80,873,9.163802978235967
10956,330380705000041,241,270,204,235,167,102,51,32,1219,83,1302,6.374807987711214
10957,330380705000042,27,40,25,32,25,18,8,7,167,15,182,8.241758241758241
10958,330380705000043,46,62,40,34,55,34,20,19,271,39,310,12.580645161290322
10959,330380705000044,39,54,42,50,45,33,19,16,263,35,298,11.74496644295302
10960,330380705000045,115,138,124,119,98,74,45,43,668,88,756,11.640211640211641
10961,330380705000046,61,64,60,60,64,40,25,25,349,50,399,12.531328320802006
10962,330380705000047,97,76,111,100,80,54,19,17,518,36,554,6.498194945848375
10963,330380705000048,123,139,127,112,91,55,24,15,647,39,686,5.685131195335277
10964,330380705000049,106,95,110,148,119,59,29,17,637,46,683,6.734992679355783
10965,330380710000001,24,31,17,29,10,9,7,2,120,9,129,6.976744186046512
10966,330380710000002,11,16,12,11,9,6,8,2,65,10,75,13.333333333333334
10967,330380710000003,73,81,58,44,37,24,14,5,317,19,336,5.654761904761905
10968,330380710000004,140,177,102,97,63,37,41,14,616,55,671,8.19672131147541
10969,330380710000005,37,41,39,36,30,15,12,8,198,20,218,9.174311926605505
10970,330380710000006,133,165,180,185,120,122,50,30,905,80,985,8.121827411167512
10971,330380710000007,85,135,114,112,82,54,15,18,582,33,615,5.365853658536586
10972,330380710000008,0,2,3,3,5,5,0,2,18,2,20,10.0
10973,330380710000009,5,0,9,7,9,3,0,1,33,1,34,2.9411764705882355
10974,330380710000010,214,294,216,205,169,121,89,44,1219,133,1352,9.837278106508876
10975,330380710000011,43,37,50,39,20,23,19,12,212,31,243,12.757201646090534
10976,330380710000012,7,4,4,0,2,0,0,2,17,2,19,10.526315789473685
10977,330380710000013,41,36,38,45,22,23,16,5,205,21,226,9.29203539823009
10978,330380710000014,50,36,15,14,6,2,4,6,123,10,133,7.518796992481203
10979,330380710000015,168,180,136,129,92,89,48,28,794,76,870,8.735632183908047
10981,330380715000006,88,87,91,122,86,59,15,13,533,28,561,4.991087344028521
10983,330380715000009,74,91,59,87,110,117,38,17,538,55,593,9.27487352445194
10984,330380715000010,44,59,56,73,85,106,12,8,423,20,443,4.514672686230249
10985,330380715000011,58,51,52,56,59,56,8,4,332,12,344,3.488372093023256
10986,330380715000012,81,67,82,60,63,51,26,19,404,45,449,10.022271714922049
10987,330380715000013,50,82,67,68,66,76,29,22,409,51,460,11.08695652173913
10988,330380715000016,88,125,112,106,80,78,43,22,589,65,654,9.938837920489297
10989,330385605000001,55,71,63,57,66,47,25,40,359,65,424,15.330188679245284
10990,330385605000002,5,11,3,0,0,0,0,0,19,0,19,0.0
10991,330385605000003,67,87,81,78,103,70,47,56,486,103,589,17.487266553480474
10992,330385605000004,0,0,0,1,1,1,0,4,3,4,7,57.142857142857146
10993,330385605000005,53,128,92,114,101,90,70,79,578,149,727,20.495185694635488
10994,330385605000006,133,114,159,110,129,94,61,38,739,99,838,11.813842482100238
10995,330385605000007,96,98,115,98,81,88,50,36,576,86,662,12.990936555891238
10996,330385605000008,0,0,0,1,6,7,9,24,14,33,47,70.2127659574468
10997,330385605000009,90,98,88,84,68,67,33,34,495,67,562,11.921708185053381
10998,330385605000010,43,56,60,46,58,41,39,32,304,71,375,18.933333333333334
10999,330385605000011,37,64,58,54,75,39,27,46,327,73,400,18.25
11000,330385605000012,68,107,90,76,80,63,45,36,484,81,565,14.336283185840708
11001,330385605000013,56,58,67,51,55,43,36,25,330,61,391,15.601023017902813
11002,330385605000014,55,87,77,53,48,23,31,25,343,56,399,14.035087719298245
11003,330385605000015,21,30,35,22,28,22,19,21,158,40,198,20.2020202020202
11004,330385605000016,62,49,71,55,50,59,31,34,346,65,411,15.815085158150852
11005,330385605000017,173,247,158,144,129,86,52,45,937,97,1034,9.381044487427467
11006,330385605000018,43,52,75,51,42,49,24,22,312,46,358,12.849162011173185
11007,330385605000019,161,193,146,141,117,99,66,50,857,116,973,11.921891058581705
11008,330385605000020,7,16,12,10,12,13,8,1,70,9,79,11.39240506329114
11009,330385605000021,68,65,57,46,63,36,28,33,335,61,396,15.404040404040405
11010,330385605000022,90,104,110,96,89,65,47,25,554,72,626,11.501597444089457
11011,330385605000023,19,22,21,11,16,3,1,1,92,2,94,2.127659574468085
11012,330385605000024,20,15,19,17,18,13,5,3,102,8,110,7.2727272727272725
11013,330385605000025,42,52,44,41,46,48,13,33,273,46,319,14.420062695924765
11014,330385605000026,129,196,148,116,128,81,56,29,798,85,883,9.626274065685164
11015,330385605000027,59,70,69,55,58,50,26,22,361,48,409,11.7359413202934
11016,330385605000028,76,112,107,71,90,36,36,44,492,80,572,13.986013986013987
11017,330385605000029,25,59,35,30,33,16,6,10,198,16,214,7.4766355140186915
11018,330385605000030,86,94,79,89,58,41,25,19,447,44,491,8.961303462321792
11019,330385605000031,28,41,45,40,44,34,32,23,232,55,287,19.16376306620209
11020,330385605000032,52,71,52,62,83,61,29,31,381,60,441,13.605442176870747
11021,330385605000033,47,61,49,64,48,51,37,16,320,53,373,14.20911528150134
11022,330385605000034,81,89,76,78,84,54,23,21,462,44,506,8.695652173913043
11023,330385605000035,82,95,79,88,71,47,27,17,462,44,506,8.695652173913043
11024,330385605000036,87,91,112,84,55,68,46,30,497,76,573,13.263525305410122
11025,330385605000037,53,63,45,38,50,43,17,19,292,36,328,10.975609756097562
11026,330385605000038,71,84,101,78,100,65,40,34,499,74,573,12.914485165794066
11027,330385605000039,52,89,72,72,78,63,35,35,426,70,496,14.112903225806452
11028,330385605000040,49,82,53,67,60,37,30,31,348,61,409,14.91442542787286
11029,330385605000041,104,117,107,84,80,42,34,19,534,53,587,9.028960817717206
11030,330385605000042,58,70,64,52,43,38,19,24,325,43,368,11.684782608695652
11031,330385605000043,23,38,29,23,33,14,17,9,160,26,186,13.978494623655914
11032,330385605000044,27,58,34,26,28,14,11,12,187,23,210,10.952380952380953
11033,330385605000045,19,14,13,14,5,5,6,3,70,9,79,11.39240506329114
11034,330385605000046,52,61,57,46,31,33,19,13,280,32,312,10.256410256410257
11035,330385610000001,54,89,76,64,66,55,37,43,404,80,484,16.52892561983471
11036,330385610000002,161,215,181,180,176,135,75,78,1048,153,1201,12.739383846794338
11037,330385610000003,89,106,95,90,86,57,33,40,523,73,596,12.248322147651006
11038,330385610000004,129,167,180,136,122,96,56,48,830,104,934,11.13490364025696
11039,330385610000005,47,39,49,30,33,17,16,8,215,24,239,10.0418410041841
11040,330385610000006,27,12,38,23,19,16,14,10,135,24,159,15.09433962264151
11041,330385610000007,32,35,27,17,28,18,9,6,157,15,172,8.720930232558139
11042,330385610000008,65,66,63,51,41,35,25,9,321,34,355,9.577464788732394
11043,330385610000009,29,30,28,16,10,14,8,7,127,15,142,10.56338028169014
11044,330385610000010,40,71,63,54,54,51,34,31,333,65,398,16.331658291457288
11045,330385610000011,31,51,33,24,32,6,19,4,177,23,200,11.5
11046,330385610000012,38,45,41,34,51,24,18,17,233,35,268,13.059701492537313
11047,330385610000013,170,232,187,175,174,116,49,53,1054,102,1156,8.823529411764707
11048,330385610000014,42,39,42,29,35,35,11,23,222,34,256,13.28125
11049,330385610000015,36,45,38,40,24,21,13,14,204,27,231,11.688311688311689
11050,330385610000016,24,34,38,27,16,13,7,3,152,10,162,6.172839506172839
11051,330390605000001,15,38,64,41,51,54,53,59,263,112,375,29.866666666666667
11052,330390605000002,5,8,26,14,7,15,20,28,75,48,123,39.02439024390244
11053,330390605000003,22,45,54,28,59,59,45,86,267,131,398,32.914572864321606
11054,330390605000004,28,33,90,59,45,68,65,122,323,187,510,36.666666666666664
11055,330390605000005,23,28,62,29,53,69,47,101,264,148,412,35.922330097087375
11056,330390605000006,30,41,81,53,50,70,50,88,325,138,463,29.805615550755938
11057,330390605000007,26,51,89,44,59,60,36,75,329,111,440,25.227272727272727
11058,330390605000008,44,62,73,69,66,69,54,48,383,102,485,21.030927835051546
11059,330390605000009,33,54,70,50,72,68,45,80,347,125,472,26.483050847457626
11060,330390605000010,53,65,121,91,77,107,75,95,514,170,684,24.853801169590643
11061,330390605000011,29,50,65,66,62,63,44,95,335,139,474,29.324894514767934
11062,330390605000012,56,93,100,84,90,94,79,78,517,157,674,23.293768545994066
11063,330390605000013,19,38,40,38,40,52,58,102,227,160,387,41.343669250645995
11064,330390605000014,31,63,83,85,74,62,59,50,398,109,507,21.499013806706113
11065,330390605000015,47,83,104,86,100,104,67,69,524,136,660,20.606060606060606
11066,330390605000016,80,72,93,87,122,96,70,101,550,171,721,23.717059639389735
11067,330390605000017,53,69,61,91,81,68,55,58,423,113,536,21.082089552238806
11068,330390605000018,36,52,74,70,57,63,61,58,352,119,471,25.265392781316347
11069,330390605000019,0,1,4,3,1,2,3,11,11,14,25,56.0
11070,330390605000020,26,52,46,31,64,66,52,90,285,142,427,33.25526932084309
11071,330390605000021,46,69,101,68,87,73,79,68,444,147,591,24.873096446700508
11072,330390605000022,22,46,72,50,62,65,69,107,317,176,493,35.699797160243406
11073,330390605000023,32,52,48,56,85,56,79,58,329,137,466,29.399141630901287
11074,330390605000024,39,44,81,64,66,55,48,67,349,115,464,24.78448275862069
11075,330390605000025,123,153,170,156,155,129,66,57,886,123,1009,12.190287413280476
11076,330390605000026,68,85,94,85,90,84,44,47,506,91,597,15.242881072026801
11077,330390605000027,94,146,113,130,104,88,57,38,675,95,770,12.337662337662337
11078,330390605000028,95,141,109,126,100,72,43,40,643,83,726,11.432506887052341
11079,330390605000029,34,41,49,48,69,33,35,28,274,63,337,18.694362017804153
11080,330390605000030,77,93,118,132,111,107,77,73,638,150,788,19.03553299492386
11081,330390605000031,33,53,77,55,67,76,61,55,361,116,477,24.31865828092243
11082,330390605000032,41,70,77,71,87,76,67,60,422,127,549,23.13296903460838
11083,330390605000033,0,0,9,7,7,1,3,2,24,5,29,17.24137931034483
11084,330390605000034,42,54,65,54,75,80,83,81,370,164,534,30.711610486891384
11085,330390605000035,50,82,94,75,89,88,65,76,478,141,619,22.778675282714055
11086,330390605000036,5,13,12,9,18,17,15,11,74,26,100,26.0
11087,330390605000037,31,60,61,63,83,90,79,68,388,147,535,27.476635514018692
11088,330390605000038,36,35,54,59,44,53,42,43,281,85,366,23.224043715846996
11089,330390605000039,14,25,27,31,39,31,39,62,167,101,268,37.6865671641791
11090,330390605000040,14,36,41,39,52,56,72,83,238,155,393,39.44020356234097
11091,330390605000041,35,76,75,63,104,101,78,151,454,229,683,33.52855051244509
11092,330390605000042,100,117,133,97,93,82,42,44,622,86,708,12.146892655367232
11093,330390605000043,93,108,123,96,111,66,59,36,597,95,692,13.728323699421965
11094,330390605000044,158,206,195,183,139,120,73,54,1001,127,1128,11.25886524822695
11095,330390605000045,22,37,51,39,35,34,27,30,218,57,275,20.727272727272727
11096,330390605000046,51,73,106,122,121,128,82,80,601,162,763,21.231979030144167
11097,330390605000047,28,65,66,72,83,79,45,49,393,94,487,19.301848049281315
11098,330390605000048,42,74,74,69,83,68,56,49,410,105,515,20.388349514563107
11099,330390605000049,73,94,98,101,97,114,88,79,577,167,744,22.446236559139784
11100,330390605000050,30,44,51,45,49,61,29,46,280,75,355,21.12676056338028
11101,330390605000051,103,143,169,114,126,106,71,80,761,151,912,16.55701754385965
11102,330390605000052,38,50,38,53,48,47,36,52,274,88,362,24.30939226519337
11103,330390605000053,70,67,69,88,62,62,53,41,418,94,512,18.359375
11104,330390605000054,80,102,121,118,112,80,61,65,613,126,739,17.050067658998646
11105,330390605000055,51,72,79,71,101,76,54,58,450,112,562,19.9288256227758
11106,330390605000056,77,98,130,96,93,101,64,107,595,171,766,22.323759791122715
11107,330390605000057,30,43,55,40,55,45,41,41,268,82,350,23.428571428571427
11108,330390605000058,79,110,180,121,132,127,92,87,749,179,928,19.288793103448278
11109,330390605000059,211,187,179,158,134,91,48,21,960,69,1029,6.705539358600583
11110,330390605000060,103,154,112,132,170,88,67,70,759,137,896,15.290178571428571
11111,330390605000061,62,61,74,58,62,62,35,22,379,57,436,13.073394495412844
11112,330390605000062,67,125,109,131,107,109,80,64,648,144,792,18.181818181818183
11113,330390605000063,24,66,82,48,79,64,51,61,363,112,475,23.57894736842105
11114,330390605000064,44,49,51,74,62,66,43,53,346,96,442,21.71945701357466
11115,330390605000065,69,95,66,85,97,84,58,46,496,104,600,17.333333333333332
11116,330390605000066,115,160,132,150,141,115,80,61,813,141,954,14.779874213836479
11117,330390605000067,122,155,134,136,140,117,59,84,804,143,947,15.100316789862724
11118,330390605000068,75,111,141,118,133,128,104,118,706,222,928,23.92241379310345
11119,330390605000069,72,89,115,109,119,99,70,51,603,121,724,16.712707182320443
11120,330390605000070,27,34,46,44,52,44,37,49,247,86,333,25.825825825825827
11121,330390605000071,57,81,107,98,90,72,84,70,505,154,659,23.368740515933233
11122,330390605000072,104,143,168,157,114,104,62,48,790,110,900,12.222222222222221
11123,330390605000073,91,125,117,95,80,52,35,17,560,52,612,8.49673202614379
11124,330390605000074,106,157,133,121,130,77,70,45,724,115,839,13.70679380214541
11125,330390605000075,118,126,133,140,117,123,68,67,757,135,892,15.134529147982063
11126,330390605000076,47,59,71,77,76,89,86,117,419,203,622,32.636655948553056
11127,330390605000077,36,59,80,63,88,87,95,91,413,186,599,31.051752921535893
11128,330390605000078,115,112,142,115,90,92,41,43,666,84,750,11.2
11129,330390605000079,162,201,221,186,170,155,75,52,1095,127,1222,10.39279869067103
11130,330390605000080,64,109,92,101,94,76,43,46,536,89,625,14.24
11131,330390605000081,118,151,170,139,136,128,86,52,842,138,980,14.081632653061224
11132,330390605000082,107,115,113,118,102,103,58,37,658,95,753,12.616201859229747
11133,330390605000083,31,59,46,47,58,35,40,38,276,78,354,22.033898305084747
11134,330390605000084,56,85,97,101,93,80,56,46,512,102,614,16.612377850162865
11135,330390605000085,81,135,111,129,146,118,88,69,720,157,877,17.90193842645382
11136,330390605000086,102,160,123,164,146,129,108,118,824,226,1050,21.523809523809526
11137,330390605000087,218,193,217,169,143,98,43,50,1038,93,1131,8.222811671087532
11138,330390605000088,94,135,101,131,81,83,43,34,625,77,702,10.968660968660968
11139,330390605000089,26,34,34,33,36,37,31,23,200,54,254,21.25984251968504
11140,330390605000090,67,116,116,133,125,105,53,29,662,82,744,11.021505376344086
11141,330390605000091,84,107,120,123,119,103,53,32,656,85,741,11.470985155195681
11142,330390605000092,29,47,49,38,59,50,39,36,272,75,347,21.613832853025936
11143,330390605000093,143,170,161,152,125,92,58,49,843,107,950,11.263157894736842
11144,330390605000094,111,125,134,145,173,125,92,96,813,188,1001,18.781218781218783
11145,330390605000095,40,59,73,61,90,73,61,69,396,130,526,24.714828897338403
11146,330390605000096,38,66,78,79,85,88,63,51,434,114,548,20.802919708029197
11147,330390605000097,90,90,109,119,150,109,61,76,667,137,804,17.039800995024876
11148,330390605000098,85,114,122,114,161,116,71,56,712,127,839,15.137067938021454
11149,330390605000099,63,95,65,96,109,90,65,60,518,125,643,19.440124416796266
11150,330390605000100,57,61,89,97,100,77,74,78,481,152,633,24.01263823064771
11151,330390605000101,37,68,83,87,85,115,89,86,475,175,650,26.923076923076923
11152,330390605000102,40,30,41,40,52,54,40,40,257,80,337,23.73887240356083
11153,330390605000103,103,110,106,107,120,111,76,110,657,186,843,22.06405693950178
11154,330390605000104,71,72,67,87,100,90,52,52,487,104,591,17.597292724196276
11155,330390605000105,59,100,96,109,98,83,82,59,545,141,686,20.55393586005831
11156,330390605000106,60,76,98,103,87,95,70,61,519,131,650,20.153846153846153
11157,330390605000107,49,86,93,124,94,91,53,45,537,98,635,15.433070866141732
11158,330390605000108,39,60,60,63,68,67,46,34,357,80,437,18.30663615560641
11159,330390605000109,42,72,54,69,97,78,65,56,412,121,533,22.701688555347094
11160,330390605000110,73,142,154,110,169,135,103,93,783,196,979,20.020429009193055
11161,330390605000111,29,63,59,51,79,48,49,42,329,91,420,21.666666666666668
11162,330390605000112,58,79,115,72,89,95,51,49,508,100,608,16.44736842105263
11163,330390605000113,97,138,125,128,122,98,94,67,708,161,869,18.527042577675488
11164,330390605000114,57,85,118,75,82,95,52,43,512,95,607,15.650741350906095
11165,330390605000115,138,147,137,124,100,100,69,41,746,110,856,12.850467289719626
11166,330390605000116,72,61,70,82,68,73,48,35,426,83,509,16.30648330058939
11167,330390605000117,97,151,101,95,97,60,26,23,601,49,650,7.538461538461538
11168,330390605000118,62,82,90,74,72,68,28,30,448,58,506,11.462450592885375
11169,330390605000119,43,45,48,61,68,57,34,42,322,76,398,19.09547738693467
11170,330390605000120,119,151,189,152,147,81,69,60,839,129,968,13.326446280991735
11171,330390605000121,76,90,89,70,99,42,37,38,466,75,541,13.863216266173753
11172,330390605000122,160,191,153,155,141,115,65,56,915,121,1036,11.67953667953668
11173,330390605000123,65,78,68,86,80,66,56,46,443,102,545,18.71559633027523
11174,330390605000124,58,72,78,82,83,64,59,72,437,131,568,23.06338028169014
11175,330390605000125,76,113,112,121,119,92,72,62,633,134,767,17.470664928292045
11176,330390605000126,80,90,101,87,74,68,37,32,500,69,569,12.126537785588752
11177,330390605000127,94,161,107,90,98,66,39,30,616,69,685,10.072992700729927
11178,330390605000128,165,191,138,143,123,78,40,28,838,68,906,7.50551876379691
11179,330390605000129,51,86,91,82,79,78,72,63,467,135,602,22.425249169435215
11180,330390605000130,87,122,101,105,110,79,46,34,604,80,684,11.695906432748538
11181,330390605000131,38,57,54,49,44,51,37,20,293,57,350,16.285714285714285
11182,330390605000132,79,117,97,114,89,81,58,36,577,94,671,14.008941877794337
11183,330390605000133,41,55,64,54,64,60,48,36,338,84,422,19.90521327014218
11184,330390605000134,33,24,25,42,27,36,18,12,187,30,217,13.824884792626728
11185,330390605000135,174,194,187,168,165,100,72,54,988,126,1114,11.310592459605028
11186,330390605000136,160,191,196,190,153,121,62,36,1011,98,1109,8.836789900811542
11187,330390605000137,130,137,102,89,85,46,41,30,589,71,660,10.757575757575758
11188,330390605000138,112,119,124,111,77,74,41,26,617,67,684,9.7953216374269
11189,330390605000139,65,111,110,132,133,130,74,78,681,152,833,18.24729891956783
11190,330390605000140,65,97,88,99,119,82,59,79,550,138,688,20.058139534883722
11191,330390605000141,161,251,200,211,194,138,111,48,1155,159,1314,12.100456621004566
11192,330390605000142,85,121,78,97,70,51,31,13,502,44,546,8.058608058608058
11193,330390605000143,78,110,110,83,82,69,45,33,532,78,610,12.78688524590164
11194,330390605000144,137,209,164,192,148,143,90,52,993,142,1135,12.51101321585903
11195,330390605000145,67,90,96,90,108,101,66,58,552,124,676,18.34319526627219
11196,330390605000146,67,69,94,109,88,95,44,33,522,77,599,12.854757929883139
11197,330390605000147,49,55,105,119,77,73,48,32,478,80,558,14.336917562724015
11198,330390605000148,113,163,120,148,159,116,73,43,819,116,935,12.406417112299465
11199,330390605000149,77,119,117,119,113,103,78,57,648,135,783,17.24137931034483
11200,330390605000150,103,103,141,114,123,89,63,59,673,122,795,15.345911949685535
11201,330390605000151,93,158,155,162,161,130,108,85,859,193,1052,18.346007604562736
11202,330390605000152,23,25,31,44,37,26,29,25,186,54,240,22.5
11203,330390605000153,86,129,83,93,73,48,31,6,512,37,549,6.739526411657559
11204,330390605000154,125,163,125,103,100,70,46,27,686,73,759,9.617918313570488
11205,330390605000155,77,124,111,121,134,111,88,90,678,178,856,20.794392523364486
11206,330390605000156,47,71,75,82,80,67,44,34,422,78,500,15.6
11207,330390605000157,67,107,133,127,130,117,90,69,681,159,840,18.928571428571427
11208,330390605000158,76,138,130,139,172,152,107,68,807,175,982,17.820773930753564
11209,330390605000159,160,218,195,202,173,123,60,55,1071,115,1186,9.696458684654301
11210,330390605000160,150,216,156,197,164,114,60,40,997,100,1097,9.115770282588878
11211,330390605000161,76,80,111,186,97,83,80,21,633,101,734,13.760217983651225
11212,330390605000162,46,73,106,98,79,121,60,32,523,92,615,14.959349593495935
11213,330390605000163,117,135,142,137,154,120,80,91,805,171,976,17.520491803278688
11214,330390605000164,52,60,73,74,75,82,42,41,416,83,499,16.63326653306613
11215,330390605000165,87,136,110,144,136,106,66,47,719,113,832,13.58173076923077
11216,330390605000166,209,263,264,259,251,144,110,56,1390,166,1556,10.668380462724937
11217,330390605000167,39,47,63,53,39,47,21,14,288,35,323,10.8359133126935
11218,330390605000168,119,202,138,143,112,80,46,24,794,70,864,8.101851851851851
11219,330390605000169,181,201,178,147,127,91,48,19,925,67,992,6.754032258064516
11220,330390605000170,113,127,151,157,117,85,69,23,750,92,842,10.926365795724466
11221,330390605000171,193,257,205,207,148,86,83,29,1096,112,1208,9.271523178807946
11222,330390605000172,172,276,210,187,146,130,60,39,1121,99,1220,8.114754098360656
11223,330390605000173,95,139,139,115,99,83,42,39,670,81,751,10.785619174434087
11224,330390605000174,105,138,134,108,115,87,43,44,687,87,774,11.24031007751938
11225,330390605000175,9,20,14,14,25,27,9,18,109,27,136,19.852941176470587
11226,330390605000176,80,74,77,65,40,49,38,10,385,48,433,11.085450346420323
11227,330390605000177,71,83,98,99,106,89,71,63,546,134,680,19.705882352941178
11228,330390605000178,74,123,122,118,114,119,105,59,670,164,834,19.664268585131893
11229,330390605000179,17,34,15,25,31,18,25,19,140,44,184,23.91304347826087
11230,330390605000180,8,12,34,21,21,16,12,14,112,26,138,18.840579710144926
11231,330390605000181,108,172,124,166,150,82,63,52,802,115,917,12.540894220283533
11232,330390605000182,42,61,71,74,63,55,34,20,366,54,420,12.857142857142858
11233,330390605000183,134,157,151,154,153,110,65,45,859,110,969,11.351909184726523
11234,330390605000184,102,126,125,154,101,61,31,21,669,52,721,7.212205270457698
11235,330390605000185,114,172,126,116,138,68,24,31,734,55,789,6.97084917617237
11236,330390605000186,36,22,77,66,58,49,49,64,308,113,421,26.840855106888363
11237,330390605000187,108,114,137,130,113,84,63,38,686,101,787,12.833545108005083
11238,330390605000188,165,216,217,208,147,148,60,39,1101,99,1200,8.25
11239,330390605000189,71,130,103,94,72,60,22,16,530,38,568,6.690140845070423
11240,330390605000190,85,115,63,98,72,55,38,20,488,58,546,10.622710622710622
11241,330390605000191,110,127,118,87,73,68,42,24,583,66,649,10.169491525423728
11242,330390605000192,37,55,53,47,48,39,31,21,279,52,331,15.709969788519638
11243,330390605000193,13,20,22,21,25,12,15,6,113,21,134,15.671641791044776
11244,330390605000194,72,90,103,117,129,100,70,78,611,148,759,19.499341238471672
11245,330390605000195,42,38,58,44,51,28,23,19,261,42,303,13.861386138613861
11246,330390605000196,94,115,92,82,86,39,33,15,508,48,556,8.633093525179856
11247,330390605000197,163,192,165,171,137,92,63,36,920,99,1019,9.71540726202159
11248,330390605000198,75,95,97,95,86,94,34,32,542,66,608,10.855263157894736
11249,330390605000199,94,113,117,133,128,107,63,40,692,103,795,12.955974842767295
11250,330390605000200,24,31,31,30,37,20,22,12,173,34,207,16.42512077294686
11251,330390605000201,47,60,59,59,43,53,24,24,321,48,369,13.008130081300813
11252,330390605000202,74,144,99,126,121,101,87,70,665,157,822,19.099756690997566
11253,330390605000203,93,111,96,86,88,78,53,34,552,87,639,13.615023474178404
11254,330390605000204,62,133,84,107,131,110,76,72,627,148,775,19.096774193548388
11255,330390605000205,105,137,134,154,166,125,88,60,821,148,969,15.273477812177502
11256,330390605000206,69,87,76,117,113,80,71,33,542,104,646,16.09907120743034
11257,330390605000207,19,26,29,41,49,27,33,57,191,90,281,32.02846975088968
11258,330390605000208,100,143,141,139,128,89,56,36,740,92,832,11.057692307692308
11259,330390605000209,45,68,76,64,73,47,44,29,373,73,446,16.367713004484305
11260,330390605000210,63,86,82,103,92,64,57,31,490,88,578,15.22491349480969
11261,330390605000211,125,158,121,129,132,86,38,26,751,64,815,7.852760736196319
11262,330390605000212,83,107,124,193,126,105,107,72,738,179,917,19.520174482006542
11263,330390605000213,52,66,84,82,82,88,65,76,454,141,595,23.69747899159664
11264,330390605000214,110,151,125,130,176,92,72,73,784,145,929,15.608180839612487
11265,330390605000215,52,64,86,74,87,74,58,58,437,116,553,20.976491862567812
11266,330390605000216,47,64,74,68,82,53,45,39,388,84,472,17.796610169491526
11267,330390605000217,97,130,127,146,147,95,67,69,742,136,878,15.489749430523919
11268,330390605000218,61,101,69,109,88,74,38,54,502,92,594,15.488215488215488
11269,330390605000219,103,156,141,130,142,130,62,68,802,130,932,13.948497854077253
11270,330390605000220,72,61,76,99,91,39,32,12,438,44,482,9.12863070539419
11271,330390605000221,65,86,112,94,114,96,81,72,567,153,720,21.25
11272,330390605000222,42,50,59,77,63,60,67,40,351,107,458,23.362445414847162
11273,330390605000223,102,109,102,120,134,63,62,46,630,108,738,14.634146341463415
11274,330390605000224,107,135,139,195,152,145,89,62,873,151,1024,14.74609375
11275,330390605000225,105,124,146,115,116,126,92,70,732,162,894,18.120805369127517
11276,330390605000226,69,88,93,83,112,88,38,42,533,80,613,13.05057096247961
11277,330390605000227,66,112,81,78,103,70,47,29,510,76,586,12.969283276450511
11278,330390605000228,49,73,98,86,100,86,66,50,492,116,608,19.07894736842105
11279,330390605000229,111,142,145,127,176,139,68,46,840,114,954,11.949685534591195
11280,330390605000230,225,226,211,181,147,121,46,39,1111,85,1196,7.107023411371237
11281,330390605000231,183,220,169,157,119,91,48,33,939,81,1020,7.9411764705882355
11282,330390605000232,62,72,65,51,56,32,15,8,338,23,361,6.371191135734072
11283,330390605000233,128,139,123,129,103,75,43,25,697,68,765,8.88888888888889
11284,330390605000234,215,325,190,219,232,101,59,26,1282,85,1367,6.217995610826628
11285,330390605000235,96,125,118,93,110,84,52,41,626,93,719,12.934631432545201
11286,330390605000236,63,87,69,49,59,47,32,17,374,49,423,11.583924349881796
11287,330390605000237,96,108,99,87,65,69,14,17,524,31,555,5.585585585585585
11288,330390605000238,108,135,115,116,87,64,47,29,625,76,701,10.841654778887303
11289,330390605000239,5,10,18,13,15,10,2,0,71,2,73,2.73972602739726
11290,330390605000240,367,429,321,275,225,126,80,46,1743,126,1869,6.741573033707865
11291,330390605000241,130,143,119,85,96,66,29,17,639,46,685,6.7153284671532845
11292,330390605000242,52,92,79,81,75,51,50,23,430,73,503,14.512922465208748
11293,330390605000243,51,88,65,88,113,70,33,33,475,66,541,12.199630314232902
11294,330390605000244,98,151,117,126,111,80,54,30,683,84,767,10.951760104302478
11295,330390605000245,116,144,135,94,86,57,38,10,632,48,680,7.0588235294117645
11296,330390605000246,127,145,141,126,115,76,51,34,730,85,815,10.429447852760736
11297,330390605000247,66,102,87,80,108,70,51,31,513,82,595,13.781512605042018
11298,330390605000248,131,140,150,118,100,86,44,31,725,75,800,9.375
11299,330390605000249,52,67,68,73,83,77,53,46,420,99,519,19.07514450867052
11300,330390605000250,70,71,87,73,67,50,50,23,418,73,491,14.867617107942973
11301,330390605000251,637,628,434,503,371,178,129,67,2751,196,2947,6.65083135391924
11302,330390605000252,85,106,96,108,71,45,40,25,511,65,576,11.284722222222221
11303,330390605000253,122,127,126,107,101,76,44,31,659,75,734,10.217983651226158
11304,330390605000254,115,116,114,119,98,75,46,23,637,69,706,9.773371104815864
11305,330390605000255,174,230,194,157,152,115,65,28,1022,93,1115,8.340807174887892
11306,330390605000256,173,189,184,145,126,90,62,33,907,95,1002,9.481037924151696
11307,330390605000257,219,251,228,221,177,148,76,30,1244,106,1350,7.851851851851852
11308,330390605000258,89,134,91,99,89,48,30,24,550,54,604,8.940397350993377
11309,330390605000259,16,20,12,20,19,23,15,4,110,19,129,14.728682170542635
11310,330390605000260,26,39,42,54,46,44,32,28,251,60,311,19.292604501607716
11311,330390605000261,22,35,47,34,43,55,35,55,236,90,326,27.607361963190183
11312,330390605000262,18,41,47,58,46,49,44,48,259,92,351,26.210826210826212
11313,330390605000263,68,76,86,91,95,71,60,53,487,113,600,18.833333333333332
11314,330390605000264,51,57,87,66,93,59,45,37,413,82,495,16.565656565656564
11315,330390605000265,66,88,63,82,71,58,33,24,428,57,485,11.75257731958763
11316,330390605000266,42,44,63,59,52,41,39,38,301,77,378,20.37037037037037
11317,330390605000267,65,84,89,103,98,73,74,61,512,135,647,20.865533230293664
11318,330390605000268,71,132,118,112,138,108,82,62,679,144,823,17.496962332928312
11319,330390605000269,53,75,48,64,70,42,22,12,352,34,386,8.808290155440414
11320,330390605000270,128,173,91,77,65,41,25,8,575,33,608,5.427631578947368
11321,330390605000271,112,128,116,103,84,52,33,22,595,55,650,8.461538461538462
11322,330390605000272,81,96,73,70,53,48,23,17,421,40,461,8.676789587852495
11323,330390605000273,32,35,32,28,31,18,3,4,176,7,183,3.8251366120218577
11324,330390605000274,41,44,36,75,64,45,50,40,305,90,395,22.78481012658228
11325,330390605000275,8,16,34,22,25,30,19,23,135,42,177,23.728813559322035
11326,330390605000276,73,108,79,102,66,54,35,25,482,60,542,11.07011070110701
11327,330390605000277,100,140,148,150,113,101,39,35,752,74,826,8.958837772397095
11328,330390605000278,70,106,95,86,78,63,26,13,498,39,537,7.262569832402234
11329,330390605000279,94,132,121,94,101,68,43,27,610,70,680,10.294117647058824
11330,330390610000001,47,60,57,67,68,53,48,56,352,104,456,22.80701754385965
11331,330390610000002,64,78,112,87,90,90,64,54,521,118,639,18.46635367762128
11332,330390610000003,51,48,68,78,69,52,49,52,366,101,467,21.62740899357602
11333,330390610000004,115,143,138,130,128,87,72,51,741,123,864,14.23611111111111
11334,330390610000005,101,138,117,120,128,92,43,25,696,68,764,8.900523560209423
11335,330390610000006,157,200,188,156,197,116,72,72,1014,144,1158,12.435233160621761
11336,330390610000007,44,54,66,71,65,65,33,49,365,82,447,18.344519015659955
11337,330390610000008,23,40,35,34,49,43,35,51,224,86,310,27.741935483870968
11338,330390610000009,82,137,107,137,132,121,84,64,716,148,864,17.12962962962963
11339,330390610000010,56,67,65,64,56,46,36,25,354,61,415,14.698795180722891
11340,330390610000011,58,83,84,94,98,78,65,36,495,101,596,16.946308724832214
11341,330390610000012,38,64,50,59,47,34,27,21,292,48,340,14.117647058823529
11342,330390610000013,31,29,38,44,24,37,31,17,203,48,251,19.12350597609562
11343,330390610000014,149,173,187,198,170,131,80,48,1008,128,1136,11.267605633802816
11344,330390610000015,47,74,73,71,91,81,48,65,437,113,550,20.545454545454547
11345,330390610000016,97,123,121,118,133,86,61,47,678,108,786,13.740458015267176
11346,330390610000017,59,95,100,72,74,67,41,35,467,76,543,13.996316758747698
11347,330390610000018,91,121,75,119,86,91,63,43,583,106,689,15.384615384615385
11348,330390610000019,121,183,185,161,166,124,90,70,940,160,1100,14.545454545454545
11349,330390610000020,118,167,96,120,108,83,35,30,692,65,757,8.58652575957728
11350,330390610000021,89,94,137,113,100,90,54,39,623,93,716,12.988826815642458
11351,330390610000022,84,111,96,105,106,77,44,54,579,98,677,14.47562776957164
11352,330390610000023,54,80,72,68,65,60,30,30,399,60,459,13.071895424836601
11353,330390610000024,70,81,79,98,87,71,39,28,486,67,553,12.115732368896927
11354,330390610000025,110,152,147,150,154,97,60,69,810,129,939,13.738019169329073
11355,330390610000026,69,87,73,72,101,73,46,43,475,89,564,15.78014184397163
11356,330390610000027,56,62,56,67,48,33,29,20,322,49,371,13.20754716981132
11357,330390610000028,113,119,133,117,130,108,43,60,720,103,823,12.515188335358445
11358,330390610000029,40,65,55,61,65,54,44,36,340,80,420,19.047619047619047
11359,330390610000030,53,81,84,87,97,79,44,56,481,100,581,17.21170395869191
11360,330390610000031,49,53,41,51,43,28,17,12,265,29,294,9.863945578231293
11361,330390610000032,107,166,85,101,127,58,54,61,644,115,759,15.151515151515152
11362,330390610000033,122,174,194,119,159,90,64,50,858,114,972,11.728395061728396
11363,330390610000034,53,68,69,103,99,103,71,50,495,121,616,19.642857142857142
11364,330390610000035,108,129,122,137,108,81,67,36,685,103,788,13.071065989847716
11365,330390610000036,58,74,70,61,76,50,43,28,389,71,460,15.434782608695652
11366,330390610000037,95,131,161,131,142,136,94,60,796,154,950,16.210526315789473
11367,330390610000038,40,59,61,66,52,66,47,31,344,78,422,18.48341232227488
11368,330390610000039,88,79,92,86,82,51,42,23,478,65,543,11.970534069981584
11369,330390610000040,105,144,87,130,122,97,65,41,685,106,791,13.400758533501897
11370,330390610000041,42,55,74,79,67,69,41,52,386,93,479,19.41544885177453
11371,330390610000042,69,79,94,132,118,98,79,69,590,148,738,20.05420054200542
11372,330390610000043,76,93,81,58,98,47,41,29,453,70,523,13.38432122370937
11373,330390610000044,169,198,171,155,135,87,51,25,915,76,991,7.669021190716448
11374,330390610000045,178,214,148,153,148,91,40,40,932,80,1012,7.905138339920948
11375,330390610000046,129,127,113,114,84,43,33,26,610,59,669,8.819133034379671
11376,330390610000047,124,150,152,127,150,92,76,54,795,130,925,14.054054054054054
11377,330390610000048,125,144,132,98,120,107,50,35,726,85,811,10.480887792848335
11378,330390610000049,88,126,114,81,105,80,58,29,594,87,681,12.775330396475772
11379,330390610000050,48,72,79,86,93,69,71,72,447,143,590,24.23728813559322
11380,330390610000051,81,66,93,92,77,56,48,23,465,71,536,13.246268656716419
11381,330390610000052,78,96,75,64,61,42,31,14,416,45,461,9.761388286334057
11382,330390610000053,106,133,160,133,133,120,56,53,785,109,894,12.192393736017896
11383,330390610000054,71,83,95,86,88,73,34,47,496,81,577,14.038128249566725
11384,330390610000055,84,88,77,97,92,90,43,39,528,82,610,13.442622950819672
11385,330390610000056,204,281,207,196,181,114,65,49,1183,114,1297,8.789514263685428
11386,330390610000057,114,117,152,111,139,98,62,45,731,107,838,12.768496420047732
11387,330390610000058,91,111,87,109,102,68,43,47,568,90,658,13.677811550151976
11388,330390610000059,116,172,145,154,145,80,57,45,812,102,914,11.159737417943107
11389,330390610000060,65,87,87,54,75,60,23,25,428,48,476,10.084033613445378
11390,330390610000061,19,45,22,30,41,21,13,10,178,23,201,11.442786069651742
11391,330390610000062,213,228,208,233,193,123,99,57,1198,156,1354,11.521418020679468
11392,330390610000063,20,36,40,44,41,32,26,13,213,39,252,15.476190476190476
11393,330390610000064,115,124,128,116,135,89,56,48,707,104,811,12.82367447595561
11394,330390610000065,22,45,37,36,46,29,19,8,215,27,242,11.15702479338843
11395,330390610000066,66,73,80,97,99,69,46,29,484,75,559,13.416815742397137
11396,330390610000067,56,69,72,64,87,71,41,20,419,61,480,12.708333333333334
11397,330390610000068,51,55,59,55,46,51,34,21,317,55,372,14.78494623655914
11398,330390610000069,22,32,20,48,29,29,13,8,180,21,201,10.447761194029852
11399,330390610000070,74,108,88,86,100,80,40,40,536,80,616,12.987012987012987
11400,330390610000071,40,72,51,68,69,43,38,26,343,64,407,15.724815724815725
11401,330390610000072,63,73,83,46,80,64,36,18,409,54,463,11.663066954643629
11402,330390610000073,21,59,47,44,56,38,16,26,265,42,307,13.680781758957655
11403,330390610000074,29,64,47,52,45,39,26,16,276,42,318,13.20754716981132
11404,330390610000075,67,84,90,80,64,56,27,18,441,45,486,9.25925925925926
11405,330390610000076,98,103,90,82,71,76,30,18,520,48,568,8.450704225352112
11406,330390610000077,59,50,61,73,60,36,37,12,339,49,388,12.628865979381443
11407,330390610000078,31,56,36,52,47,38,24,14,260,38,298,12.751677852348994
11408,330390610000079,48,42,44,52,53,29,23,24,268,47,315,14.920634920634921
11409,330390610000080,58,82,66,61,62,39,26,15,368,41,409,10.02444987775061
11410,330390610000081,176,223,229,226,162,190,88,45,1206,133,1339,9.932785660941
11411,330390610000082,63,61,59,76,65,35,19,17,359,36,395,9.113924050632912
11412,330390610000083,64,69,60,58,86,56,19,29,393,48,441,10.884353741496598
11413,330390610000084,157,174,148,147,118,79,44,24,823,68,891,7.631874298540965
11414,330390610000085,52,73,67,74,87,76,42,42,429,84,513,16.374269005847953
11415,330390610000086,74,134,74,81,88,61,30,25,512,55,567,9.700176366843033
11416,330390610000087,32,47,51,44,47,41,36,30,262,66,328,20.121951219512194
11417,330390610000088,3,15,10,11,8,9,6,8,56,14,70,20.0
11418,330390610000089,141,208,202,186,169,127,74,49,1033,123,1156,10.640138408304498
11419,330390610000090,44,55,74,41,57,47,26,32,318,58,376,15.425531914893616
11420,330390610000091,85,125,91,93,86,67,47,27,547,74,621,11.916264090177133
11421,330390610000092,182,216,169,156,142,91,53,21,956,74,1030,7.184466019417476
11422,330390610000093,56,55,51,59,51,37,29,13,309,42,351,11.965811965811966
11423,330390610000094,31,56,48,54,63,56,27,20,308,47,355,13.23943661971831
11424,330390610000095,44,49,56,64,38,65,53,44,316,97,413,23.486682808716708
11425,330390610000096,48,58,80,69,71,67,46,54,393,100,493,20.28397565922921
11426,330390610000097,43,56,56,61,52,43,43,30,311,73,384,19.010416666666668
11427,330390610000098,53,86,82,82,73,91,44,28,467,72,539,13.358070500927644
11428,330390610000099,24,27,43,27,40,37,33,22,198,55,253,21.73913043478261
11429,330390610000100,85,120,126,115,146,112,59,52,704,111,815,13.61963190184049
11430,330390610000101,99,111,114,109,101,90,33,48,624,81,705,11.48936170212766
11431,330390610000102,57,75,94,77,92,95,61,51,490,112,602,18.6046511627907
11432,330390610000103,108,97,101,121,107,78,63,39,612,102,714,14.285714285714286
11433,330390610000104,86,97,95,99,93,75,42,30,545,72,617,11.66936790923825
11434,330390610000105,131,151,137,126,109,79,44,27,733,71,804,8.83084577114428
11435,330390610000106,26,28,25,28,27,18,16,10,152,26,178,14.606741573033707
11436,330390610000107,78,76,68,65,64,36,29,13,387,42,429,9.79020979020979
11437,330390615000001,52,88,89,86,109,71,63,51,495,114,609,18.7192118226601
11438,330390615000002,83,122,105,108,84,79,37,26,581,63,644,9.782608695652174
11439,330390615000003,166,194,137,157,145,109,81,68,908,149,1057,14.096499526963104
11440,330390615000004,43,52,38,62,58,59,47,83,312,130,442,29.41176470588235
11441,330390615000005,85,99,99,124,104,84,62,54,595,116,711,16.31504922644163
11442,330390615000006,30,39,38,51,41,36,38,20,235,58,293,19.795221843003414
11443,330390615000007,112,151,146,125,122,101,59,43,757,102,859,11.874272409778813
11444,330390615000008,26,54,42,49,55,45,24,19,271,43,314,13.694267515923567
11445,330390615000009,35,61,47,44,64,44,28,26,295,54,349,15.472779369627506
11446,330390615000010,138,169,187,178,152,102,58,38,926,96,1022,9.393346379647749
11447,330390615000011,52,97,121,85,95,82,43,29,532,72,604,11.920529801324504
11448,330390615000012,82,103,108,104,102,82,48,25,581,73,654,11.162079510703364
11449,330390615000013,60,68,66,65,84,50,24,28,393,52,445,11.685393258426966
11450,330390615000014,42,66,58,46,54,31,15,16,297,31,328,9.451219512195122
11451,330390615000015,61,80,90,85,103,71,60,44,490,104,594,17.50841750841751
11452,330390615000016,81,90,132,107,105,90,62,46,605,108,713,15.147265077138849
11453,330390615000017,36,61,39,49,54,39,24,29,278,53,331,16.012084592145015
11454,330390615000018,46,68,61,81,81,58,37,30,395,67,462,14.502164502164502
11455,330390615000019,143,161,161,148,134,105,55,53,852,108,960,11.25
11456,330390615000020,70,90,99,79,103,80,42,27,521,69,590,11.694915254237289
11457,330390615000021,136,136,98,139,129,100,45,24,738,69,807,8.550185873605948
11458,330390615000022,12,29,25,32,31,23,19,7,152,26,178,14.606741573033707
11459,330390615000023,41,67,53,63,73,40,20,27,337,47,384,12.239583333333334
11460,330390615000024,48,86,70,72,86,70,37,18,432,55,487,11.293634496919918
11461,330390615000025,354,408,401,283,228,181,95,58,1855,153,2008,7.6195219123505975
11462,330390615000026,10,35,20,30,27,19,12,19,141,31,172,18.023255813953487
11463,330390615000027,43,68,57,85,91,41,28,16,385,44,429,10.256410256410257
11464,330390615000028,4,17,4,11,6,7,5,1,49,6,55,10.909090909090908
11465,330390615000029,135,151,130,119,154,105,55,61,794,116,910,12.747252747252746
11466,330390615000030,105,125,124,100,108,89,62,41,651,103,754,13.660477453580901
11467,330390615000031,55,53,73,53,86,41,30,26,361,56,417,13.42925659472422
11468,330390615000032,50,62,93,72,81,85,66,36,443,102,545,18.71559633027523
11469,330390615000033,65,94,64,84,83,75,38,29,465,67,532,12.593984962406015
11470,330390615000034,35,31,26,43,38,32,30,20,205,50,255,19.607843137254903
11471,330390615000035,76,83,75,87,66,61,45,37,448,82,530,15.471698113207546
11472,330390620000001,143,177,122,109,71,73,50,37,695,87,782,11.12531969309463
11473,330390620000002,117,156,128,177,115,107,76,43,800,119,919,12.94885745375408
11474,330390620000003,30,26,37,30,24,25,16,19,172,35,207,16.908212560386474
11475,330390620000004,128,142,161,121,123,101,53,54,776,107,883,12.117780294450736
11476,330390620000005,120,150,160,129,131,97,50,45,787,95,882,10.770975056689343
11477,330390620000006,131,198,192,173,155,114,75,56,963,131,1094,11.974405850091408
11478,330390620000007,55,56,57,68,57,40,34,19,333,53,386,13.73056994818653
11479,330390620000008,142,172,155,157,132,104,72,57,862,129,991,13.01715438950555
11480,330390620000009,98,110,110,94,89,68,49,25,569,74,643,11.508553654743391
11481,330390620000010,118,109,130,99,93,95,50,47,644,97,741,13.090418353576249
11482,330390620000011,95,110,102,85,96,81,43,30,569,73,642,11.370716510903426
11483,330390620000012,139,182,159,171,132,87,65,41,870,106,976,10.860655737704919
11484,330390620000013,128,164,164,138,117,90,97,52,801,149,950,15.68421052631579
11485,330390620000014,134,167,150,126,124,109,58,40,810,98,908,10.79295154185022
11486,330390620000015,24,34,34,37,19,25,9,4,173,13,186,6.989247311827957
11487,330390620000016,69,101,61,67,48,35,16,11,381,27,408,6.617647058823529
11488,330390620000017,16,46,24,26,16,18,3,2,146,5,151,3.3112582781456954
11489,330390620000018,48,66,69,42,58,35,15,14,318,29,347,8.357348703170029
11490,330390620000019,83,84,82,61,52,43,17,13,405,30,435,6.896551724137931
11491,330390620000020,66,84,55,79,56,41,35,28,381,63,444,14.18918918918919
11492,330390620000021,17,46,28,24,15,13,11,11,143,22,165,13.333333333333334
11493,330390620000022,8,8,6,13,9,4,1,1,48,2,50,4.0
11494,330390620000023,29,41,43,28,20,22,5,9,183,14,197,7.106598984771574
11495,330390620000024,14,35,16,29,29,21,13,11,144,24,168,14.285714285714286
11496,330390620000025,70,66,86,80,75,61,41,45,438,86,524,16.412213740458014
11497,330390623000001,112,153,138,125,105,109,68,52,742,120,862,13.921113689095128
11498,330390623000002,88,105,104,102,106,69,55,42,574,97,671,14.456035767511178
11499,330390623000003,194,204,204,182,178,135,80,51,1097,131,1228,10.667752442996743
11500,330390623000004,167,225,184,143,140,93,46,41,952,87,1039,8.373435996150144
11501,330390623000005,107,157,136,99,99,64,27,16,662,43,705,6.099290780141844
11502,330390623000006,193,223,281,203,171,117,76,36,1188,112,1300,8.615384615384615
11503,330390623000007,157,182,151,155,137,107,74,54,889,128,1017,12.586037364798427
11504,330390623000008,27,51,23,42,31,27,18,14,201,32,233,13.733905579399142
11505,330390623000009,135,156,142,142,133,75,52,47,783,99,882,11.224489795918368
11506,330390623000010,19,31,23,21,30,17,17,4,141,21,162,12.962962962962964
11507,330390623000011,117,128,121,129,110,92,58,38,697,96,793,12.105926860025221
11508,330390623000012,30,51,45,34,31,29,20,7,220,27,247,10.931174089068826
11509,330390623000014,29,42,20,24,20,13,3,3,148,6,154,3.896103896103896
11510,330390623000015,60,63,72,68,30,22,26,6,315,32,347,9.221902017291066
11511,330390623000016,90,151,97,101,90,55,42,21,584,63,647,9.737248840803709
11512,330390623000017,52,55,52,44,36,28,21,7,267,28,295,9.491525423728813
11513,330395505000001,55,78,68,73,73,93,44,43,440,87,527,16.50853889943074
11514,330395505000002,53,74,87,76,86,104,52,74,480,126,606,20.792079207920793
11515,330395505000003,69,115,144,120,124,112,77,47,684,124,808,15.346534653465346
11516,330395505000004,49,111,99,94,97,81,47,53,531,100,631,15.847860538827259
11517,330395505000005,94,154,157,132,152,94,36,36,783,72,855,8.421052631578947
11518,330395505000006,169,170,140,146,110,87,38,12,822,50,872,5.73394495412844
11519,330395505000007,208,212,213,216,151,109,65,33,1109,98,1207,8.11930405965203
11520,330395505000008,101,122,146,123,115,86,54,39,693,93,786,11.83206106870229
11521,330395505000009,71,95,89,73,73,76,50,35,477,85,562,15.124555160142348
11522,330395505000010,102,140,129,108,102,72,33,17,653,50,703,7.112375533428165
11523,330395505000011,136,137,163,128,112,96,45,30,772,75,847,8.85478158205431
11524,330395505000012,107,120,108,96,72,66,46,26,569,72,641,11.232449297971918
11525,330395505000013,70,98,117,104,82,93,42,25,564,67,631,10.618066561014263
11526,330395505000014,39,51,72,67,74,81,42,33,384,75,459,16.33986928104575
11527,330395505000015,56,88,96,82,72,86,38,43,480,81,561,14.438502673796792
11528,330395505000016,69,77,85,72,63,58,30,19,424,49,473,10.359408033826638
11529,330395505000017,76,86,81,96,67,85,57,53,491,110,601,18.302828618968388
11530,330395505000018,123,179,189,162,171,160,60,50,984,110,1094,10.054844606946984
11531,330395505000019,123,159,156,137,126,113,42,34,814,76,890,8.539325842696629
11532,330395505000020,86,122,117,91,73,81,36,22,570,58,628,9.235668789808917
11533,330395505000021,88,117,84,78,73,52,24,11,492,35,527,6.641366223908919
11534,330395505000022,54,94,74,78,69,57,21,20,426,41,467,8.779443254817988
11535,330395505000023,79,114,145,105,107,118,50,34,668,84,752,11.170212765957446
11536,330395505000024,43,80,67,72,84,90,55,56,436,111,547,20.29250457038391
11537,330395505000025,9,14,23,9,14,13,17,13,82,30,112,26.785714285714285
11538,330395505000026,80,86,127,69,85,72,32,25,519,57,576,9.895833333333334
11539,330395505000027,185,238,195,160,169,182,89,48,1129,137,1266,10.821484992101105
11540,330395505000028,65,86,86,63,79,48,29,10,427,39,466,8.369098712446352
11541,330395505000029,141,164,161,135,98,87,39,21,786,60,846,7.092198581560283
11542,330395505000030,191,249,197,173,138,73,26,17,1021,43,1064,4.041353383458647
11543,330395505000031,66,73,84,65,71,50,28,21,409,49,458,10.698689956331878
11544,330395505000032,55,64,109,85,65,63,35,23,441,58,499,11.623246492985972
11545,330395505000033,41,83,73,80,77,50,28,20,404,48,452,10.619469026548673
11546,330395505000034,65,55,48,60,33,21,18,5,282,23,305,7.540983606557377
11547,330400305000001,58,70,77,101,102,73,59,86,481,145,626,23.162939297124602
11548,330400305000002,28,62,63,98,79,70,43,48,400,91,491,18.533604887983707
11549,330400305000003,63,86,81,73,92,61,44,32,456,76,532,14.285714285714286
11550,330400305000004,44,74,74,68,69,62,42,27,391,69,460,15.0
11551,330400305000005,152,183,195,201,183,124,93,42,1038,135,1173,11.508951406649617
11552,330400305000006,133,125,166,195,151,122,83,74,892,157,1049,14.966634890371783
11553,330400305000007,95,106,111,128,139,83,48,44,662,92,754,12.20159151193634
11554,330400305000008,34,42,56,38,36,39,32,35,245,67,312,21.474358974358974
11555,330400305000009,121,131,165,142,130,102,70,48,791,118,909,12.98129812981298
11556,330400305000010,164,192,191,179,148,103,44,28,977,72,1049,6.863679694947569
11557,330400305000011,39,82,55,66,63,44,21,28,349,49,398,12.311557788944723
11558,330400305000012,56,66,73,72,61,52,28,17,380,45,425,10.588235294117647
11559,330400305000013,64,90,110,104,98,71,57,46,537,103,640,16.09375
11560,330400305000014,89,86,117,124,94,83,33,33,593,66,659,10.015174506828528
11561,330400305000015,72,90,94,104,82,69,62,40,511,102,613,16.6394779771615
11562,330400305000016,89,114,117,92,116,87,43,36,615,79,694,11.38328530259366
11564,330400305000018,17,28,43,30,38,64,4,9,220,13,233,5.579399141630901
11565,330400305000019,42,49,53,43,49,31,5,3,267,8,275,2.909090909090909
11566,330400305000020,11,28,11,12,23,10,3,2,95,5,100,5.0
11567,330400305000021,82,154,100,127,96,60,37,36,619,73,692,10.54913294797688
11568,330400305000022,93,126,103,86,85,65,31,18,558,49,607,8.072487644151565
11570,330400305000024,28,65,58,45,45,41,14,9,282,23,305,7.540983606557377
11571,330400305000025,58,102,64,78,76,58,39,30,436,69,505,13.663366336633663
11572,330400305000026,35,53,40,39,44,55,30,15,266,45,311,14.469453376205788
11573,330400305000027,39,63,57,63,68,65,51,39,355,90,445,20.224719101123597
11574,330400305000028,126,180,139,145,120,75,48,21,785,69,854,8.079625292740047
11575,330400305000029,83,80,86,95,80,50,35,34,474,69,543,12.707182320441989
11576,330400305000030,104,187,119,137,105,80,38,31,732,69,801,8.614232209737828
11577,330400305000031,54,65,65,62,60,31,17,16,337,33,370,8.91891891891892
11578,330400310000001,88,107,88,128,123,72,33,37,606,70,676,10.355029585798816
11579,330400310000002,54,76,62,77,60,71,27,29,400,56,456,12.280701754385966
11580,330400310000003,94,112,136,109,97,96,51,50,644,101,745,13.557046979865772
11581,330400310000004,88,90,89,127,89,96,70,60,579,130,709,18.33568406205924
11582,330400310000005,30,34,33,28,22,18,12,13,165,25,190,13.157894736842104
11583,330400310000006,101,136,131,132,89,89,47,35,678,82,760,10.789473684210526
11584,330400310000007,115,172,135,122,124,74,41,30,742,71,813,8.733087330873309
11585,330400310000008,10,31,35,24,51,27,15,14,178,29,207,14.009661835748792
11586,330400310000009,45,64,49,65,44,32,34,27,299,61,360,16.944444444444443
11587,330400310000010,110,121,110,118,74,62,39,33,595,72,667,10.794602698650674
11588,330400310000011,149,212,135,189,118,98,51,38,901,89,990,8.98989898989899
11589,330400310000012,74,87,76,64,54,49,21,9,404,30,434,6.912442396313364
11590,330400315000001,52,70,64,60,62,35,18,28,343,46,389,11.825192802056556
11591,330400315000002,80,103,83,103,109,71,61,50,549,111,660,16.818181818181817
11592,330400325000001,51,76,82,75,86,75,59,36,445,95,540,17.59259259259259
11593,330400325000002,70,103,82,97,102,76,64,26,530,90,620,14.516129032258064
11594,330400325000003,14,27,23,22,27,24,19,12,137,31,168,18.452380952380953
11595,330410205000001,34,52,41,45,71,34,47,76,277,123,400,30.75
11596,330410205000002,41,57,73,64,64,67,42,51,366,93,459,20.26143790849673
11597,330410205000003,99,150,129,121,124,96,82,99,719,181,900,20.11111111111111
11598,330410205000004,122,200,170,134,196,116,44,42,938,86,1024,8.3984375
11599,330410205000005,83,102,93,87,93,79,51,26,537,77,614,12.54071661237785
11600,330410205000006,144,160,172,147,136,112,64,69,871,133,1004,13.247011952191235
11601,330410205000007,72,66,86,67,48,52,38,33,391,71,462,15.367965367965368
11602,330410205000008,111,142,132,115,106,65,30,29,671,59,730,8.082191780821917
11603,330410205000009,163,153,155,136,104,64,33,37,775,70,845,8.284023668639053
11604,330410205000010,62,74,101,83,88,67,52,65,475,117,592,19.763513513513512
11605,330410205000011,75,82,99,72,88,89,68,83,505,151,656,23.01829268292683
11606,330410205000012,73,99,99,87,91,68,51,66,517,117,634,18.454258675078865
11607,330410205000013,78,105,85,95,81,60,37,41,504,78,582,13.402061855670103
11608,330410205000014,117,109,159,131,108,119,75,79,743,154,897,17.16833890746934
11609,330410205000015,56,89,71,66,62,49,26,29,393,55,448,12.276785714285714
11610,330410205000016,32,38,32,31,42,27,15,9,202,24,226,10.619469026548673
11611,330410205000017,67,91,68,53,62,74,16,32,415,48,463,10.367170626349893
11612,330410205000018,9,20,15,18,26,18,6,19,106,25,131,19.083969465648856
11613,330410205000019,85,102,101,84,81,73,35,32,526,67,593,11.298482293423271
11614,330410205000020,94,133,88,86,68,50,35,23,519,58,577,10.051993067590988
11615,330410205000021,143,172,165,119,102,58,35,9,759,44,803,5.47945205479452
11616,330410210000001,93,101,106,82,90,106,60,69,578,129,707,18.246110325318245
11617,330410210000002,32,49,14,33,23,17,11,10,168,21,189,11.11111111111111
11618,330410210000003,51,63,27,41,33,26,12,18,241,30,271,11.07011070110701
11619,330410210000004,33,17,18,23,15,17,7,2,123,9,132,6.818181818181818
11620,330410215000001,85,105,114,93,88,66,51,45,551,96,647,14.837712519319938
11621,330410215000002,97,81,77,79,65,38,29,13,437,42,479,8.768267223382045
11622,330410215000003,73,94,66,76,79,47,29,16,435,45,480,9.375
11623,330410215000004,148,138,93,92,72,45,33,16,588,49,637,7.6923076923076925
11624,330410215000005,95,131,101,108,116,75,30,36,626,66,692,9.53757225433526
11625,330410215000006,12,11,12,12,7,9,9,0,63,9,72,12.5
11626,330410215000007,63,74,67,63,58,42,29,18,367,47,414,11.352657004830919
11627,330411005000001,123,143,145,147,149,136,67,64,843,131,974,13.449691991786448
11628,330411005000002,118,131,145,132,134,88,57,51,748,108,856,12.616822429906541
11629,330411005000003,100,121,117,108,109,64,49,37,619,86,705,12.198581560283689
11630,330411005000004,91,100,124,94,72,65,27,13,546,40,586,6.825938566552901
11631,330411005000005,109,119,104,113,76,59,30,30,580,60,640,9.375
11632,330411005000006,61,92,92,79,77,64,39,42,465,81,546,14.835164835164836
11633,330411005000007,168,254,218,175,153,99,58,24,1067,82,1149,7.136640557006093
11634,330411005000008,105,102,118,65,70,61,24,13,521,37,558,6.630824372759856
11635,330411005000009,224,253,256,227,191,113,58,41,1264,99,1363,7.263389581804843
11636,330411005000010,120,137,124,84,92,54,37,19,611,56,667,8.395802098950524
11637,330411005000011,80,111,83,95,76,46,22,10,491,32,523,6.118546845124283
11638,330411005000012,90,147,95,127,101,47,37,27,607,64,671,9.538002980625931
11639,330411005000013,115,146,180,117,104,112,31,21,774,52,826,6.295399515738499
11640,330411005000014,103,122,141,105,95,81,55,40,647,95,742,12.803234501347708
11641,330411005000015,82,105,110,90,84,60,30,23,531,53,584,9.075342465753424
11642,330411005000016,193,223,191,177,130,92,47,24,1006,71,1077,6.59238625812442
11643,330411005000017,28,45,45,37,43,38,15,14,236,29,265,10.943396226415095
11644,330411005000018,229,241,215,290,199,110,68,39,1284,107,1391,7.6923076923076925
11645,330411005000019,141,191,193,184,143,122,62,38,974,100,1074,9.31098696461825
11646,330411005000020,12,24,14,21,14,5,1,4,90,5,95,5.2631578947368425
11647,330411005000021,120,131,146,111,88,63,30,14,659,44,703,6.2588904694167855
11648,330411005000022,111,114,111,95,64,53,35,14,548,49,597,8.207705192629815
11649,330412805000001,55,76,108,115,84,86,75,65,524,140,664,21.08433734939759
11650,330412805000002,52,60,72,65,65,74,47,57,388,104,492,21.13821138211382
11651,330412805000003,34,21,28,23,28,20,16,10,154,26,180,14.444444444444445
11652,330412805000004,130,125,170,157,165,148,59,40,895,99,994,9.959758551307846
11653,330412805000005,74,116,118,105,106,88,53,36,607,89,696,12.78735632183908
11654,330412805000006,68,76,115,91,62,75,54,37,487,91,578,15.7439446366782
11655,330412805000007,50,92,127,92,104,100,45,51,565,96,661,14.523449319213313
11656,330412805000008,34,35,33,43,27,24,17,6,196,23,219,10.502283105022832
11657,330412805000009,62,81,79,94,75,56,43,25,447,68,515,13.20388349514563
11658,330412805000010,164,200,181,155,133,61,55,38,894,93,987,9.422492401215806
11659,330412805000011,139,169,161,148,131,106,44,28,854,72,926,7.775377969762419
11660,330412805000012,94,113,96,77,51,32,13,9,463,22,485,4.536082474226804
11661,330412805000013,59,86,82,68,79,49,35,29,423,64,487,13.141683778234086
11662,330412805000014,118,144,169,113,99,93,42,43,736,85,821,10.353227771010962
11663,330412805000015,96,114,104,79,80,43,16,15,516,31,547,5.6672760511883
11664,330412805000016,41,52,50,45,57,49,32,13,294,45,339,13.274336283185841
11665,330412805000017,80,59,77,57,49,33,14,10,355,24,379,6.332453825857519
11666,330412805000018,2,5,2,4,2,0,0,1,15,1,16,6.25
11668,330412805000020,19,19,12,10,8,7,3,3,75,6,81,7.407407407407407
11669,330412805000021,5,1,1,7,4,2,1,0,20,1,21,4.761904761904762
11672,330412805000024,85,65,87,84,70,51,15,10,442,25,467,5.353319057815845
11673,330412805000025,3,2,1,4,3,1,5,1,14,6,20,30.0
11674,330412805000026,9,11,7,13,6,3,5,3,49,8,57,14.035087719298245
11675,330412805000027,61,69,62,64,31,30,8,8,317,16,333,4.804804804804805
11676,330412805000028,68,73,60,71,39,23,12,7,334,19,353,5.38243626062323
11677,330412805000029,46,33,45,33,31,16,11,5,204,16,220,7.2727272727272725
11679,330412805000033,2,1,2,0,2,3,2,0,10,2,12,16.666666666666668
11680,330412805000034,5,7,10,5,7,2,1,1,36,2,38,5.2631578947368425
11682,330412805000036,20,17,11,21,9,3,4,0,81,4,85,4.705882352941177
11683,330412805000037,42,48,32,48,34,27,25,10,231,35,266,13.157894736842104
11684,330412805000038,18,31,14,13,18,14,7,1,108,8,116,6.896551724137931
11685,330412810000001,15,25,15,22,22,19,21,17,118,38,156,24.358974358974358
11686,330412810000002,14,15,7,10,12,6,6,3,64,9,73,12.32876712328767
11687,330412820000001,22,33,15,32,33,23,22,31,158,53,211,25.118483412322274
11688,330412820000002,36,39,32,33,38,23,12,11,201,23,224,10.267857142857142
11689,330414405010001,61,76,64,57,56,51,23,30,365,53,418,12.679425837320574
11690,330414405010002,35,47,41,37,38,32,15,20,230,35,265,13.20754716981132
11691,330414405010003,65,110,86,85,92,52,36,17,490,53,543,9.760589318600369
11692,330414405010004,61,90,94,85,97,57,42,29,484,71,555,12.792792792792794
11693,330414405010005,80,102,102,106,77,81,35,22,548,57,605,9.421487603305785
11694,330414405010006,54,75,75,74,79,54,32,19,411,51,462,11.03896103896104
11695,330414405010007,44,58,63,84,45,42,33,14,336,47,383,12.27154046997389
11696,330414405010008,43,47,43,48,39,35,26,23,255,49,304,16.11842105263158
11697,330414405010009,77,92,98,106,88,66,34,28,527,62,589,10.526315789473685
11698,330414405010010,25,54,52,57,55,63,44,40,306,84,390,21.53846153846154
11699,330414405010011,74,85,93,87,69,47,37,32,455,69,524,13.16793893129771
11700,330414405010012,76,109,109,111,77,86,34,42,568,76,644,11.801242236024844
11701,330414405010013,180,248,238,186,162,134,74,43,1148,117,1265,9.24901185770751
11702,330414405010014,62,72,57,49,43,20,7,8,303,15,318,4.716981132075472
11703,330414405010015,53,103,93,94,90,84,60,47,517,107,624,17.147435897435898
11704,330414405010016,69,83,81,79,62,70,40,29,444,69,513,13.450292397660819
11705,330414405010017,87,116,92,122,77,65,51,28,559,79,638,12.382445141065832
11706,330414405010018,101,130,126,102,104,93,52,32,656,84,740,11.35135135135135
11707,330414405010019,118,148,111,115,87,51,25,27,630,52,682,7.624633431085044
11708,330414405010020,131,151,127,125,96,84,36,23,714,59,773,7.632600258732213
11709,330414405010021,122,117,152,112,97,72,33,38,672,71,743,9.55585464333782
11710,330414405010022,90,140,99,111,107,67,62,45,614,107,721,14.840499306518725
11711,330414405010023,120,133,123,122,101,98,52,33,697,85,782,10.869565217391305
11712,330414405010024,92,120,93,128,93,72,53,48,598,101,699,14.449213161659513
11713,330414405010025,89,116,104,80,85,86,39,34,560,73,633,11.532385466034755
11714,330414405010026,104,122,136,98,115,93,46,48,668,94,762,12.335958005249344
11715,330414405010027,108,165,142,152,115,95,63,48,777,111,888,12.5
11716,330414405010028,109,113,118,107,101,77,54,41,625,95,720,13.194444444444445
11717,330414405010029,82,120,98,135,68,73,52,22,576,74,650,11.384615384615385
11718,330414405010030,104,135,138,121,106,95,44,34,699,78,777,10.038610038610038
11719,330414405010031,131,146,147,123,116,107,73,48,770,121,891,13.580246913580247
11720,330414405010032,67,106,110,84,103,74,46,33,544,79,623,12.680577849117174
11721,330414405010033,162,178,217,193,170,110,64,43,1030,107,1137,9.410729991204926
11722,330414405010034,122,140,146,154,91,94,64,34,747,98,845,11.597633136094675
11723,330414405010035,94,135,147,147,132,90,85,50,745,135,880,15.340909090909092
11724,330414405010036,145,185,172,153,170,99,61,40,924,101,1025,9.853658536585366
11725,330414405010037,93,140,159,124,110,112,72,37,738,109,847,12.868949232585596
11726,330414405010038,64,107,99,77,117,80,40,40,544,80,624,12.820512820512821
11727,330414405010039,99,131,135,121,111,90,56,46,687,102,789,12.927756653992395
11728,330414405010040,69,104,79,90,88,53,42,23,483,65,548,11.861313868613138
11729,330414405010041,183,260,239,201,189,155,93,70,1227,163,1390,11.726618705035971
11730,330414405010042,43,44,51,37,44,19,13,6,238,19,257,7.392996108949417
11731,330414405010043,37,84,106,57,76,29,16,6,389,22,411,5.35279805352798
11732,330414405010044,79,116,102,109,106,83,40,20,595,60,655,9.16030534351145
11733,330414405010045,77,111,80,97,97,64,53,30,526,83,609,13.628899835796387
11734,330414405010046,50,76,89,67,67,70,45,29,419,74,493,15.010141987829615
11735,330414405010047,31,59,53,48,50,43,40,24,284,64,348,18.39080459770115
11736,330414405010048,66,96,71,68,71,39,28,22,411,50,461,10.845986984815617
11737,330414405010049,35,45,64,45,36,28,23,25,253,48,301,15.946843853820598
11738,330414405010050,20,27,21,26,13,24,6,9,131,15,146,10.273972602739725
11739,330414405010051,147,163,115,123,61,68,28,11,677,39,716,5.446927374301676
11740,330414405010052,80,65,50,63,33,20,9,4,311,13,324,4.012345679012346
11741,330414405020001,79,89,101,82,74,65,24,14,490,38,528,7.196969696969697
11742,330414405020002,175,169,149,153,89,73,45,32,808,77,885,8.700564971751412
11743,330414405020003,79,129,99,90,89,66,26,33,552,59,611,9.656301145662848
11744,330414405020004,97,125,90,100,68,44,35,27,524,62,586,10.580204778156997
11745,330414405020005,54,83,51,58,47,37,19,11,330,30,360,8.333333333333334
11746,330414405020006,116,126,118,93,83,66,36,28,602,64,666,9.60960960960961
11747,330414405020007,70,93,69,73,57,26,20,12,388,32,420,7.619047619047619
11748,330414405020008,114,150,114,100,107,71,33,27,656,60,716,8.379888268156424
11749,330414405020009,115,158,115,117,105,55,35,21,665,56,721,7.766990291262136
11750,330414405020010,122,135,131,117,77,63,34,12,645,46,691,6.657018813314037
11751,330414405020011,122,173,110,118,89,46,43,20,658,63,721,8.737864077669903
11752,330414405020012,149,133,107,116,90,68,31,20,663,51,714,7.142857142857143
11753,330414405020013,59,70,39,57,38,31,22,20,294,42,336,12.5
11754,330414405020014,159,218,170,155,121,94,47,41,917,88,1005,8.756218905472636
11755,330414405020015,73,111,109,114,68,54,20,27,529,47,576,8.159722222222221
11756,330414405020016,154,155,131,106,87,45,31,26,678,57,735,7.755102040816326
11757,330414405020017,200,246,197,173,142,73,33,34,1031,67,1098,6.10200364298725
11758,330414405020018,234,273,216,197,162,103,68,56,1185,124,1309,9.472880061115355
11759,330414405020019,191,230,282,165,244,154,75,54,1266,129,1395,9.24731182795699
11760,330414405020020,162,182,146,165,130,92,41,33,877,74,951,7.781282860147213
11761,330414405020021,113,122,116,120,104,78,59,30,653,89,742,11.994609164420485
11762,330414405020022,72,124,95,90,69,57,29,8,507,37,544,6.801470588235294
11763,330414405020023,58,68,59,61,65,45,17,28,356,45,401,11.221945137157107
11764,330414405020024,63,96,117,75,73,43,20,6,467,26,493,5.273833671399594
11765,330414405020025,82,115,81,67,62,35,18,6,442,24,466,5.150214592274678
11766,330414405020026,13,9,12,4,6,4,3,3,48,6,54,11.11111111111111
11767,330414405020027,241,306,237,251,168,114,52,39,1317,91,1408,6.463068181818182
11768,330414405020028,99,116,91,62,82,47,23,13,497,36,533,6.75422138836773
11769,330414405030001,71,96,81,98,71,41,22,26,458,48,506,9.486166007905139
11770,330414405030002,203,247,217,214,165,118,46,21,1164,67,1231,5.442729488220959
11771,330414405030003,102,125,98,99,94,74,35,30,592,65,657,9.89345509893455
11772,330414405030004,119,132,106,118,84,58,33,21,617,54,671,8.04769001490313
11773,330414405030005,88,113,95,93,93,67,28,21,549,49,598,8.193979933110368
11774,330414405030006,66,100,71,80,73,37,31,17,427,48,475,10.105263157894736
11775,330414405030007,90,125,118,122,100,83,32,32,638,64,702,9.116809116809117
11776,330414405030008,59,74,76,47,82,57,28,24,395,52,447,11.6331096196868
11777,330414405030009,55,80,47,56,49,38,12,14,325,26,351,7.407407407407407
11778,330414405030010,178,246,212,230,153,107,66,50,1126,116,1242,9.339774557165862
11779,330414405030011,121,148,101,95,77,54,25,11,596,36,632,5.69620253164557
11780,330414405030012,118,159,161,155,118,85,36,39,796,75,871,8.610792192881744
11781,330414405030013,73,110,88,92,78,54,35,22,495,57,552,10.326086956521738
11782,330414405030014,63,95,72,63,55,50,33,18,398,51,449,11.35857461024499
11783,330414405030015,21,43,40,34,42,42,30,23,222,53,275,19.272727272727273
11784,330414405030016,83,93,101,90,66,71,46,39,504,85,589,14.431239388794568
11785,330414405030017,132,143,139,119,83,49,37,21,665,58,723,8.022130013831259
11786,330414405040001,95,106,93,86,62,43,23,18,485,41,526,7.79467680608365
11787,330414405040002,90,97,71,83,71,45,25,28,457,53,510,10.392156862745098
11788,330414405040003,59,77,73,68,59,50,23,20,386,43,429,10.023310023310023
11789,330414405040004,69,98,83,70,58,45,23,17,423,40,463,8.639308855291576
11790,330414405040005,173,199,138,155,126,82,36,29,873,65,938,6.929637526652452
11791,330414405040006,145,152,139,147,130,93,59,36,806,95,901,10.543840177580465
11792,330414405040007,44,71,58,69,56,39,30,25,337,55,392,14.03061224489796
11793,330414405040008,129,141,108,114,101,67,40,37,660,77,737,10.447761194029852
11794,330414405040009,105,126,102,96,65,70,29,19,564,48,612,7.8431372549019605
11795,330414405040010,25,53,24,34,28,16,7,2,180,9,189,4.761904761904762
11796,330414405040011,76,111,101,83,72,66,30,13,509,43,552,7.7898550724637685
11797,330414405040012,99,123,108,114,97,70,23,26,611,49,660,7.424242424242424
11798,330414405040013,122,114,110,86,86,62,33,20,580,53,633,8.372827804107425
11799,330414405040014,42,54,52,49,41,25,19,17,263,36,299,12.040133779264215
11800,330414405040015,116,135,100,112,78,54,27,17,595,44,639,6.885758998435055
11801,330414405040016,113,178,162,170,129,112,74,39,864,113,977,11.566018423746161
11802,330414405040017,48,38,50,36,33,37,18,38,242,56,298,18.79194630872483
11803,330414405040018,21,16,14,18,15,13,13,11,97,24,121,19.834710743801654
11804,330414405050001,67,93,80,74,67,52,34,27,433,61,494,12.348178137651821
11805,330414405050002,54,56,52,83,57,54,28,31,356,59,415,14.216867469879517
11806,330414405050003,61,109,93,79,61,53,36,22,456,58,514,11.284046692607005
11807,330414405050004,79,81,92,79,79,46,26,28,456,54,510,10.588235294117647
11808,330414405050005,246,304,208,239,168,103,79,48,1268,127,1395,9.10394265232975
11809,330414405050006,110,163,121,122,89,82,41,29,687,70,757,9.247027741083222
11810,330414405050007,91,104,109,87,82,67,40,31,540,71,611,11.620294599018003
11811,330414405050008,77,126,125,100,104,70,43,35,602,78,680,11.470588235294118
11812,330414405050009,78,106,103,88,86,65,38,20,526,58,584,9.931506849315069
11813,330414405050010,79,83,81,88,66,40,39,31,437,70,507,13.806706114398422
11814,330414405050011,94,147,134,111,94,95,49,30,675,79,754,10.477453580901857
11815,330414405050012,141,186,137,162,130,77,45,54,833,99,932,10.622317596566523
11816,330414405050013,104,164,122,110,99,71,43,24,670,67,737,9.090909090909092
11817,330414405050014,122,149,136,93,103,68,33,28,671,61,732,8.333333333333334
11818,330414405050015,135,144,137,131,103,85,42,31,735,73,808,9.034653465346535
11819,330414405050016,122,147,122,121,73,70,36,23,655,59,714,8.263305322128852
11820,330414405050017,132,125,106,118,57,48,29,22,586,51,637,8.006279434850864
11821,330414405050018,122,141,121,93,79,59,28,10,615,38,653,5.819295558958652
11822,330414405050019,126,132,126,117,105,76,46,42,682,88,770,11.428571428571429
11823,330414405050020,53,73,82,77,53,47,35,16,385,51,436,11.697247706422019
11824,330414405050021,113,145,119,117,81,67,36,25,642,61,703,8.677098150782362
11825,330414405050022,99,115,130,95,84,57,32,25,580,57,637,8.948194662480377
11826,330414405050023,99,156,105,118,90,63,42,26,631,68,699,9.72818311874106
11827,330414405050024,130,171,144,155,92,79,46,22,771,68,839,8.104886769964244
11828,330414405050025,109,137,124,106,90,80,47,35,646,82,728,11.263736263736265
11829,330414405050026,144,184,165,149,118,80,42,29,840,71,911,7.793633369923161
11830,330414405050027,269,311,217,225,168,82,52,35,1272,87,1359,6.401766004415011
11831,330414405050028,115,153,129,127,85,71,31,25,680,56,736,7.608695652173913
11832,330414405050029,202,274,208,199,187,89,78,48,1159,126,1285,9.805447470817121
11833,330414405050030,93,135,103,97,83,48,36,32,559,68,627,10.84529505582137
11834,330414405050031,119,154,142,116,96,68,63,33,695,96,791,12.13653603034134
11835,330414405050032,218,226,193,153,129,75,40,25,994,65,1059,6.137865911237016
11836,330414405050033,184,212,176,180,105,79,59,30,936,89,1025,8.682926829268293
11837,330414405050034,94,95,118,90,58,66,32,10,521,42,563,7.460035523978686
11838,330414405050035,84,103,82,81,56,47,32,7,453,39,492,7.926829268292683
11839,330414405050036,151,164,142,144,105,73,42,25,779,67,846,7.919621749408983
11840,330414405050037,176,193,140,141,129,77,41,47,856,88,944,9.322033898305085
11841,330414405050038,103,103,92,72,76,48,25,28,494,53,547,9.689213893967093
11842,330414405050039,61,70,44,36,43,31,21,14,285,35,320,10.9375
11843,330414405050040,74,90,57,91,57,34,22,11,403,33,436,7.568807339449541
11844,330414405050041,62,108,88,66,69,54,18,11,447,29,476,6.092436974789916
11845,330414405050042,143,154,146,122,120,77,43,42,762,85,847,10.035419126328216
11846,330414405050043,15,26,13,17,18,19,16,9,108,25,133,18.796992481203006
11847,330414405050044,0,1,3,3,10,3,4,3,20,7,27,25.925925925925927
11848,330414405050045,43,57,68,47,63,45,27,31,323,58,381,15.223097112860893
11849,330414405050046,55,106,97,79,75,60,43,33,472,76,548,13.86861313868613
11850,330414405050047,48,67,66,57,49,38,20,15,325,35,360,9.722222222222221
11851,330414405050048,95,102,117,95,89,62,33,24,560,57,617,9.238249594813615
11852,330414405050049,55,78,73,63,78,45,28,15,392,43,435,9.885057471264368
11853,330414405050050,56,67,73,59,55,45,20,17,355,37,392,9.438775510204081
11854,330414405050051,96,120,101,97,96,53,32,32,563,64,627,10.207336523125997
11855,330414405050052,104,125,101,90,82,65,30,20,567,50,617,8.103727714748784
11856,330414405050053,117,168,115,111,103,57,17,30,671,47,718,6.545961002785515
11857,330414405050054,121,147,121,93,91,68,30,22,641,52,693,7.503607503607504
11858,330414405050055,140,152,121,118,95,64,41,20,690,61,751,8.122503328894807
11859,330414405050056,231,336,257,205,238,97,54,32,1364,86,1450,5.931034482758621
11860,330414405050057,74,98,86,102,68,49,44,29,477,73,550,13.272727272727273
11861,330414405050058,190,182,146,140,85,62,54,31,805,85,890,9.55056179775281
11862,330414405050059,148,184,148,140,98,76,37,20,794,57,851,6.698002350176263
11863,330414405050060,154,190,129,168,108,69,41,10,818,51,869,5.868814729574224
11864,330414405050061,141,199,125,125,107,66,42,20,763,62,825,7.515151515151516
11865,330414405050062,100,90,96,148,71,51,29,13,556,42,598,7.023411371237458
11866,330414405050063,57,60,80,61,44,66,21,18,368,39,407,9.582309582309582
11867,330414405050064,93,75,173,107,59,32,20,7,539,27,566,4.770318021201414
11868,330414405050065,99,123,102,95,74,48,22,14,541,36,577,6.239168110918544
11869,330414405050066,87,90,80,78,52,44,27,9,431,36,467,7.708779443254818
11870,330414405050067,136,138,92,117,71,52,35,12,606,47,653,7.197549770290965
11871,330414405050068,67,79,55,48,24,16,11,3,289,14,303,4.62046204620462
11872,330414405050069,102,88,86,103,78,39,22,11,496,33,529,6.238185255198488
11873,330414405050070,106,127,88,107,96,39,33,19,563,52,615,8.455284552845528
11874,330414405060001,145,177,125,145,101,51,50,28,744,78,822,9.489051094890511
11875,330414405060002,196,213,184,151,126,86,64,57,956,121,1077,11.234911792014856
11876,330414405060003,148,152,128,131,83,59,40,30,701,70,771,9.07911802853437
11877,330414405060004,113,133,87,107,74,48,27,17,562,44,606,7.260726072607261
11878,330414405060005,132,164,158,119,99,78,28,24,750,52,802,6.483790523690773
11879,330414405060006,110,140,147,143,94,82,31,23,716,54,770,7.012987012987013
11880,330414405060007,116,142,146,129,103,84,38,24,720,62,782,7.928388746803069
11881,330414405060008,112,112,125,140,84,91,31,16,664,47,711,6.610407876230661
11882,330414405060009,120,237,163,198,156,96,40,32,970,72,1042,6.90978886756238
11883,330414405060010,164,215,192,183,162,122,52,30,1038,82,1120,7.321428571428571
11884,330414405060011,75,131,107,96,105,106,59,8,620,67,687,9.75254730713246
11885,330414405060012,126,144,165,113,114,103,51,23,765,74,839,8.820023837902264
11886,330414405060013,113,160,129,113,141,107,44,27,763,71,834,8.513189448441247
11887,330414405060014,150,206,205,152,120,109,35,33,942,68,1010,6.732673267326732
11888,330414405060015,134,144,160,189,145,66,30,11,838,41,879,4.664391353811149
11889,330414405060016,43,54,46,41,33,22,10,13,239,23,262,8.778625954198473
11890,330414405060017,235,252,243,215,135,79,50,31,1159,81,1240,6.532258064516129
11891,330414405060018,101,115,113,102,82,66,27,24,579,51,630,8.095238095238095
11892,330414405060019,235,253,208,229,171,115,64,50,1211,114,1325,8.60377358490566
11893,330414405060020,73,91,103,98,84,61,39,19,510,58,568,10.211267605633802
11894,330414405060021,39,44,43,21,25,22,10,6,194,16,210,7.619047619047619
11895,330414405070001,84,131,100,89,82,44,28,16,530,44,574,7.665505226480836
11896,330415105000001,100,127,150,120,139,117,98,75,753,173,926,18.682505399568033
11897,330415105000002,93,150,149,124,118,97,58,67,731,125,856,14.602803738317757
11898,330415105000003,74,106,81,86,79,64,35,35,490,70,560,12.5
11899,330415105000004,155,237,162,177,195,98,54,48,1024,102,1126,9.058614564831261
11900,330415105000005,181,216,204,150,169,121,62,38,1041,100,1141,8.76424189307625
11901,330415105000006,109,119,157,112,97,67,60,25,661,85,746,11.394101876675602
11902,330415105000007,93,110,98,116,106,82,54,40,605,94,699,13.447782546494993
11903,330415105000008,79,84,103,66,79,90,46,37,501,83,584,14.212328767123287
11904,330415105000009,119,121,147,120,142,99,51,46,748,97,845,11.479289940828401
11905,330415105000010,164,172,161,158,154,84,52,44,893,96,989,9.706774519716886
11906,330415105000011,110,139,142,124,134,64,42,29,713,71,784,9.056122448979592
11907,330415105000012,68,105,109,96,100,66,40,38,544,78,622,12.540192926045016
11908,330415105000013,95,133,125,118,110,66,41,38,647,79,726,10.881542699724518
11909,330415105000014,37,49,47,33,44,17,12,6,227,18,245,7.346938775510204
11910,330415105000015,153,167,171,140,105,58,44,27,794,71,865,8.208092485549132
11911,330415105000016,92,150,116,88,70,35,14,9,551,23,574,4.006968641114983
11912,330415105000017,18,31,18,26,31,29,18,8,153,26,179,14.525139664804469
11913,330415105000018,62,65,68,60,67,57,25,18,379,43,422,10.189573459715639
11914,330415105000019,66,62,58,63,72,49,50,40,370,90,460,19.565217391304348
11915,330415105000020,1,1,0,5,5,1,2,1,13,3,16,18.75
11916,330415105000021,36,57,35,42,35,24,19,20,229,39,268,14.552238805970148
11917,330415105000022,49,60,60,58,51,46,20,36,324,56,380,14.736842105263158
11918,330415105000023,84,128,83,90,102,79,57,61,566,118,684,17.251461988304094
11919,330415105000024,52,52,58,47,47,39,20,19,295,39,334,11.676646706586826
11920,330415105000025,88,102,93,71,72,69,44,28,495,72,567,12.698412698412698
11921,330415105000026,13,28,11,30,21,19,18,5,122,23,145,15.862068965517242
11922,330415105000027,19,11,17,8,11,4,4,5,70,9,79,11.39240506329114
11923,330415105000028,150,161,121,101,76,36,24,11,645,35,680,5.147058823529412
11924,330415105000029,72,102,82,65,68,37,27,22,426,49,475,10.31578947368421
11925,330415105000030,78,91,65,63,76,63,22,18,436,40,476,8.403361344537815
11926,330415105000031,62,84,67,50,57,45,48,30,365,78,443,17.607223476297968
11927,330415105000032,24,36,32,20,26,28,10,8,166,18,184,9.782608695652174
11928,330415105000033,4,1,0,5,1,1,2,1,12,3,15,20.0
11929,330415105000034,86,82,114,79,82,72,28,22,515,50,565,8.849557522123893
11930,330415105000035,124,99,93,56,34,16,13,11,422,24,446,5.381165919282512
11931,330415105000036,29,35,30,25,27,14,5,3,160,8,168,4.761904761904762
11932,330415105000038,60,91,61,39,40,20,15,6,311,21,332,6.325301204819277
11933,330415105000039,25,34,26,32,28,21,9,16,166,25,191,13.089005235602095
11934,330415105000040,92,99,67,61,55,33,23,15,407,38,445,8.539325842696629
11935,330420105000001,47,67,105,81,86,81,51,54,467,105,572,18.356643356643357
11936,330420105000002,53,65,97,84,77,63,76,67,439,143,582,24.57044673539519
11937,330420105000003,24,51,49,57,46,59,31,38,286,69,355,19.43661971830986
11938,330420105000004,37,78,129,84,98,109,55,83,535,138,673,20.505200594353642
11939,330420105000005,54,72,103,84,72,105,74,73,490,147,637,23.076923076923077
11940,330420105000006,105,125,128,111,107,79,47,35,655,82,737,11.12618724559023
11941,330420105000007,125,143,187,127,129,72,49,38,783,87,870,10.0
11942,330420105000008,136,165,141,114,106,64,32,20,726,52,778,6.683804627249358
11943,330420105000009,189,223,191,157,107,69,35,29,936,64,1000,6.4
11944,330420105000010,136,180,172,133,113,88,59,39,822,98,920,10.652173913043478
11945,330420105000011,40,65,80,63,73,67,29,20,388,49,437,11.212814645308924
11946,330420105000012,49,51,72,47,36,35,17,10,290,27,317,8.517350157728707
11947,330420105000013,94,129,126,87,92,57,46,35,585,81,666,12.162162162162161
11948,330420105000014,112,125,156,109,143,90,47,54,735,101,836,12.08133971291866
11949,330420105000015,63,90,88,74,77,74,44,36,466,80,546,14.652014652014651
11950,330420105000016,176,232,198,173,152,98,58,41,1029,99,1128,8.77659574468085
11951,330420105000017,161,178,178,132,108,79,38,44,836,82,918,8.932461873638344
11952,330420105000018,156,162,170,175,148,91,64,57,902,121,1023,11.827956989247312
11953,330420105000019,140,143,163,174,108,97,62,42,825,104,929,11.194833153928956
11954,330420105000020,124,153,134,149,140,88,70,41,788,111,899,12.347052280311457
11955,330420105000022,141,115,144,205,139,119,53,36,863,89,952,9.34873949579832
11956,330420105000023,30,60,45,43,65,66,40,29,309,69,378,18.253968253968253
11957,330420105000024,0,3,6,3,3,7,6,0,22,6,28,21.428571428571427
11958,330420105000025,60,56,101,98,72,78,42,50,465,92,557,16.51705565529623
11959,330420105000026,46,92,83,70,94,87,58,60,472,118,590,20.0
11960,330420105000027,40,43,37,32,32,41,22,16,225,38,263,14.448669201520913
11961,330420105000028,25,49,35,48,50,32,15,19,239,34,273,12.454212454212454
11962,330420105000029,5,8,9,13,9,11,10,8,55,18,73,24.65753424657534
11963,330420105000030,5,5,13,8,8,18,6,2,57,8,65,12.307692307692308
11964,330420105000031,26,35,70,57,46,52,35,42,286,77,363,21.21212121212121
11965,330420105000032,60,53,121,109,72,61,35,24,476,59,535,11.02803738317757
11966,330420105000033,49,77,105,113,110,59,49,25,513,74,587,12.606473594548552
11967,330420105000034,38,62,65,59,65,81,53,46,370,99,469,21.108742004264393
11968,330420105000035,30,45,54,72,58,48,33,24,307,57,364,15.659340659340659
11969,330420105000036,38,38,80,81,77,75,55,33,389,88,477,18.448637316561843
11970,330420105000037,60,105,118,112,121,98,36,30,614,66,680,9.705882352941176
11971,330420105000038,96,142,142,124,110,84,54,46,698,100,798,12.531328320802006
11972,330420105000039,82,102,125,90,87,58,42,27,544,69,613,11.256117455138662
11973,330420105000040,62,71,144,105,94,58,36,34,534,70,604,11.589403973509933
11974,330420105000041,64,80,138,114,105,103,102,80,604,182,786,23.155216284987276
11975,330420105000042,87,95,210,151,97,75,69,72,715,141,856,16.47196261682243
11976,330420105000043,26,29,71,44,40,47,30,37,257,67,324,20.679012345679013
11977,330420105000044,47,61,71,82,71,69,35,28,401,63,464,13.577586206896552
11978,330420105000045,111,135,149,122,158,92,64,47,767,111,878,12.642369020501139
11979,330420105000046,41,48,55,43,51,51,29,32,289,61,350,17.428571428571427
11980,330420105000047,70,101,89,114,115,105,74,56,594,130,724,17.955801104972377
11981,330420105000048,47,75,104,81,81,87,42,61,475,103,578,17.82006920415225
11982,330420105000049,52,82,94,72,90,75,64,56,465,120,585,20.512820512820515
11983,330420105000050,43,72,68,62,87,68,32,40,400,72,472,15.254237288135593
11984,330420105000051,81,95,144,109,97,93,86,77,619,163,782,20.843989769820972
11985,330420105000052,58,79,73,69,82,58,52,45,419,97,516,18.7984496124031
11986,330420105000053,58,74,94,102,80,83,31,31,491,62,553,11.211573236889693
11987,330420105000054,91,93,114,102,91,66,62,47,557,109,666,16.366366366366368
11988,330420105000055,47,59,81,63,91,52,47,31,393,78,471,16.56050955414013
11989,330420105000056,54,83,107,82,105,72,50,44,503,94,597,15.745393634840871
11990,330420105000057,14,27,27,27,22,27,11,20,144,31,175,17.714285714285715
11991,330420105000058,3,2,8,2,12,4,0,1,31,1,32,3.125
11992,330420105000059,70,87,109,107,98,88,61,31,559,92,651,14.1321044546851
11993,330420105000060,56,52,61,76,40,47,35,13,332,48,380,12.631578947368421
11994,330420105000061,102,129,139,132,110,102,59,47,714,106,820,12.926829268292684
11995,330420105000062,19,32,38,21,29,28,7,11,167,18,185,9.72972972972973
11996,330420105000063,154,126,168,162,119,108,38,39,837,77,914,8.424507658643327
11997,330420105000064,105,138,107,100,90,74,46,32,614,78,692,11.271676300578035
11998,330420105000065,85,120,149,111,103,91,39,25,659,64,723,8.852005532503458
11999,330420105000066,158,166,149,130,88,51,24,22,742,46,788,5.83756345177665
12000,330420105000067,9,15,11,16,17,5,5,0,73,5,78,6.410256410256411
12001,330420105000069,54,104,126,104,105,154,50,39,647,89,736,12.092391304347826
12002,330420105000070,81,80,81,133,104,39,19,16,518,35,553,6.329113924050633
12003,330420105000071,2,4,7,7,3,5,1,0,28,1,29,3.4482758620689653
12004,330420105000072,14,18,7,14,22,20,6,2,95,8,103,7.766990291262136
12005,330420105000073,49,62,19,47,67,26,34,25,270,59,329,17.933130699088146
12006,330420105000074,93,95,96,148,117,44,30,11,593,41,634,6.466876971608833
12007,330420105000075,140,120,136,230,113,69,31,19,808,50,858,5.827505827505828
12008,330420105000076,40,54,52,60,43,15,18,5,264,23,287,8.013937282229966
12009,330420105000077,29,12,18,30,13,11,2,0,113,2,115,1.7391304347826086
12010,330420105000078,98,164,120,104,127,66,29,22,679,51,730,6.986301369863014
12011,330420105000079,116,167,115,127,137,75,27,24,737,51,788,6.472081218274112
12012,330420105000080,139,149,156,135,124,58,28,25,761,53,814,6.511056511056511
12013,330420105000081,85,122,60,93,93,36,22,12,489,34,523,6.500956022944551
12014,330420105000082,112,134,111,129,108,53,31,16,647,47,694,6.772334293948127
12015,330420105000083,106,120,76,115,74,25,12,7,516,19,535,3.5514018691588785
12016,330420105000084,150,231,155,153,136,94,34,18,919,52,971,5.355303810504634
12017,330420105000085,75,119,83,71,103,62,17,9,513,26,539,4.823747680890538
12018,330420105000086,72,117,101,76,123,61,24,12,550,36,586,6.143344709897611
12019,330420105000087,84,114,99,82,135,55,27,12,569,39,608,6.4144736842105265
12020,330420105000088,81,138,99,119,130,57,36,25,624,61,685,8.905109489051094
12021,330420105000089,155,188,144,122,134,72,45,26,815,71,886,8.01354401805869
12022,330420105000090,1,5,1,1,7,1,0,3,16,3,19,15.789473684210526
12023,330420105000091,205,186,245,188,156,117,55,36,1097,91,1188,7.65993265993266
12024,330420105000092,138,178,168,158,135,110,65,32,887,97,984,9.857723577235772
12025,330420105000093,60,103,121,75,73,128,46,29,560,75,635,11.811023622047244
12026,330420105000094,53,59,111,83,73,100,42,40,479,82,561,14.616755793226382
12027,330420105000095,112,164,160,143,125,113,78,44,817,122,939,12.992545260915868
12028,330420105000096,20,31,22,23,28,15,5,1,139,6,145,4.137931034482759
12029,330420105000097,126,141,181,123,134,118,60,29,823,89,912,9.758771929824562
12030,330420105000098,184,159,186,130,95,96,43,8,850,51,901,5.660377358490566
12031,330420105000099,99,112,141,101,90,93,60,32,636,92,728,12.637362637362637
12032,330420105000100,170,169,205,155,104,168,77,36,971,113,1084,10.424354243542435
12033,330420105000101,153,145,202,137,130,113,63,29,880,92,972,9.465020576131687
12034,330420105000102,112,107,163,108,87,91,27,12,668,39,707,5.516265912305516
12035,330420105000103,117,155,136,150,121,117,64,38,796,102,898,11.35857461024499
12036,330420105000104,79,117,153,95,104,95,50,30,643,80,723,11.065006915629322
12037,330420105000105,112,134,204,158,108,181,92,54,897,146,1043,13.998082454458293
12038,330420105000106,129,144,193,145,95,131,68,30,837,98,935,10.481283422459892
12039,330420105000107,114,146,199,129,91,161,70,31,840,101,941,10.73326248671626
12042,330420105000110,91,119,95,110,71,46,20,11,532,31,563,5.506216696269982
12043,330420105000111,76,87,108,78,85,56,28,26,490,54,544,9.926470588235293
12044,330420105000112,47,63,81,66,77,42,25,24,376,49,425,11.529411764705882
12045,330420105000113,58,59,100,72,60,75,51,55,424,106,530,20.0
12046,330420105000114,87,104,103,106,95,72,44,41,567,85,652,13.036809815950921
12047,330420105000115,58,63,68,69,61,58,35,34,377,69,446,15.47085201793722
12048,330420105000116,55,57,76,73,58,36,57,33,355,90,445,20.224719101123597
12049,330420105000117,71,79,79,87,65,60,39,24,441,63,504,12.5
12050,330420105000118,123,151,170,168,117,87,46,23,816,69,885,7.796610169491525
12051,330420105000119,134,112,143,99,49,64,40,13,601,53,654,8.103975535168196
12052,330420105000120,95,128,87,143,132,131,48,23,716,71,787,9.021601016518424
12053,330420105000121,108,82,84,147,115,44,23,11,580,34,614,5.537459283387622
12054,330420105000123,209,206,158,256,149,65,37,15,1043,52,1095,4.748858447488584
12055,330420105000124,141,106,104,166,65,47,22,7,629,29,658,4.407294832826747
12057,330420105000126,78,98,81,91,70,45,26,14,463,40,503,7.952286282306163
12058,330420105000127,84,91,82,77,76,30,14,8,440,22,462,4.761904761904762
12059,330420105000128,115,129,112,127,90,42,28,21,615,49,664,7.379518072289157
12060,330420105000129,102,161,122,100,117,69,32,26,671,58,729,7.956104252400548
12061,330420105000130,56,58,24,63,72,27,13,10,300,23,323,7.120743034055727
12062,330420105000131,61,94,64,50,51,20,13,1,340,14,354,3.9548022598870056
12063,330420105000132,107,89,91,123,66,44,16,6,520,22,542,4.059040590405904
12064,330420105000133,59,55,76,77,44,28,8,4,339,12,351,3.4188034188034186
12065,330420105000134,6,8,16,10,7,8,4,2,55,6,61,9.836065573770492
12066,330420105000135,68,76,60,59,46,30,38,9,339,47,386,12.176165803108809
12067,330420105000136,27,28,20,27,11,9,15,5,122,20,142,14.084507042253522
12068,330420105000137,22,31,25,14,23,16,10,4,131,14,145,9.655172413793103
12069,330420105000138,13,16,15,10,9,8,4,0,71,4,75,5.333333333333333
12070,330420105000139,47,68,50,42,49,35,21,18,291,39,330,11.818181818181818
12071,330420105000141,58,84,101,108,91,68,46,26,510,72,582,12.371134020618557
12072,330420105000142,132,98,167,151,65,29,9,4,642,13,655,1.984732824427481
12073,330420105000144,150,106,207,155,71,46,31,6,735,37,772,4.7927461139896375
12074,330420110000001,27,34,54,60,48,57,45,85,280,130,410,31.70731707317073
12075,330420110000002,15,23,68,37,49,42,16,35,234,51,285,17.894736842105264
12076,330420110000003,40,41,91,81,80,69,42,46,402,88,490,17.959183673469386
12077,330420110000004,32,50,115,96,78,49,30,14,420,44,464,9.482758620689655
12078,330420110000005,30,56,94,62,72,77,53,60,391,113,504,22.42063492063492
12079,330420110000006,33,57,59,55,59,63,55,61,326,116,442,26.244343891402714
12080,330420110000007,54,60,84,68,64,65,47,34,395,81,476,17.016806722689076
12081,330420110000008,4,24,18,20,29,18,18,17,113,35,148,23.64864864864865
12082,330420110000009,39,61,70,78,73,94,70,62,415,132,547,24.13162705667276
12083,330420110000010,14,10,16,17,18,19,12,5,94,17,111,15.315315315315315
12084,330420110000011,33,23,51,65,53,30,14,4,255,18,273,6.593406593406593
12085,330420110000012,35,36,72,69,68,43,28,32,323,60,383,15.66579634464752
12086,330420110000013,97,89,109,95,76,56,48,29,522,77,599,12.854757929883139
12087,330420110000014,85,100,129,113,83,58,44,24,568,68,636,10.69182389937107
12088,330420110000015,105,145,139,144,102,63,40,31,698,71,769,9.232769830949286
12089,330420110000016,150,163,203,145,125,90,52,28,876,80,956,8.368200836820083
12090,330420110000017,127,165,156,140,128,87,39,34,803,73,876,8.333333333333334
12091,330420110000018,81,103,119,107,90,74,45,31,574,76,650,11.692307692307692
12092,330420110000019,130,177,171,161,131,112,52,33,882,85,967,8.790072388831437
12093,330420110000020,166,189,163,176,126,108,53,42,928,95,1023,9.286412512218964
12094,330420110000021,164,185,148,176,163,107,74,69,943,143,1086,13.167587476979742
12095,330420110000022,126,145,138,125,131,84,53,27,749,80,829,9.650180940892641
12096,330420110000023,75,70,94,85,52,78,35,31,454,66,520,12.692307692307692
12097,330420110000024,97,97,125,86,90,58,40,32,553,72,625,11.52
12098,330420110000025,64,59,82,82,57,47,47,23,391,70,461,15.184381778741866
12099,330420110000026,57,79,93,74,75,70,40,33,448,73,521,14.011516314779271
12100,330420110000027,70,119,107,111,128,101,54,51,636,105,741,14.17004048582996
12101,330420110000028,89,84,95,124,111,61,26,17,564,43,607,7.0840197693574956
12102,330420110000029,20,36,18,28,26,10,12,3,138,15,153,9.803921568627452
12103,330420110000030,195,255,206,153,145,85,41,16,1039,57,1096,5.200729927007299
12104,330420110000031,140,158,181,175,130,81,42,25,865,67,932,7.1888412017167385
12105,330420110000032,92,106,108,99,107,80,23,22,592,45,637,7.06436420722135
12107,330420110000034,87,82,106,82,64,69,44,26,490,70,560,12.5
12108,330420110000035,57,94,76,81,55,44,24,14,407,38,445,8.539325842696629
12109,330420110000036,78,89,80,67,85,62,44,33,461,77,538,14.312267657992566
12110,330420110000037,57,65,95,67,65,56,33,21,405,54,459,11.764705882352942
12111,330420110000038,56,68,107,68,64,52,19,14,415,33,448,7.366071428571429
12112,330420110000039,76,99,79,79,82,49,27,27,464,54,518,10.424710424710424
12113,330420110000040,79,95,99,84,85,78,36,34,520,70,590,11.864406779661017
12114,330420110000041,99,101,122,152,112,53,19,11,639,30,669,4.484304932735426
12115,330420110000042,57,56,58,39,36,34,18,6,280,24,304,7.894736842105263
12116,330420110000043,91,107,112,93,78,76,46,28,557,74,631,11.727416798732172
12117,330420110000044,83,125,146,128,100,68,39,29,650,68,718,9.470752089136491
12118,330420110000045,107,103,105,94,60,43,33,19,512,52,564,9.21985815602837
12119,330420110000046,172,176,190,145,114,59,28,17,856,45,901,4.994450610432852
12120,330420110000047,65,105,89,65,70,34,15,12,428,27,455,5.934065934065934
12121,330420110000048,100,125,132,105,87,74,52,31,623,83,706,11.756373937677054
12122,330420110000049,99,129,92,99,113,59,17,18,591,35,626,5.5910543130990416
12123,330420110000050,89,118,105,110,126,72,24,13,620,37,657,5.6316590563165905
12124,330420110000052,152,104,92,202,140,23,2,3,713,5,718,0.6963788300835655
12125,330420110000053,181,239,188,244,217,45,19,6,1114,25,1139,2.194907813871817
12126,330420110000055,52,72,69,98,72,66,36,34,429,70,499,14.02805611222445
12128,330420110000057,24,27,20,23,31,22,8,4,147,12,159,7.547169811320755
12129,330420110000059,33,52,28,36,41,17,5,6,207,11,218,5.045871559633028
12130,330420110000061,34,29,19,24,17,6,5,7,129,12,141,8.51063829787234
12131,330420110000062,13,15,16,14,11,8,5,2,77,7,84,8.333333333333334
12132,330420115000001,89,103,125,129,104,92,52,38,642,90,732,12.295081967213115
12133,330420115000002,153,186,226,148,134,106,83,69,953,152,1105,13.755656108597286
12134,330420115000003,103,117,131,105,94,69,35,27,619,62,681,9.104258443465492
12135,330420115000004,105,145,158,114,98,96,38,33,716,71,787,9.021601016518424
12136,330420115000005,66,77,62,67,57,39,26,10,368,36,404,8.910891089108912
12137,330420115000006,28,26,20,23,24,11,6,10,132,16,148,10.81081081081081
12138,330420115000008,21,24,22,18,15,20,8,5,120,13,133,9.774436090225564
12139,330420120000001,12,39,19,24,38,29,23,16,161,39,200,19.5
12140,330420120000002,42,46,29,47,43,43,31,22,250,53,303,17.49174917491749
12141,330420120000003,30,34,28,24,27,18,21,18,161,39,200,19.5
12142,330420130000001,18,37,28,23,32,17,14,16,155,30,185,16.216216216216218
12143,330420130000002,8,3,8,8,9,12,4,12,48,16,64,25.0
12144,330420130000003,80,115,95,102,66,60,43,27,518,70,588,11.904761904761905
12145,330420130000004,71,81,82,78,70,46,27,23,428,50,478,10.460251046025105
12146,330420130000005,2,13,4,8,10,4,2,0,41,2,43,4.651162790697675
12147,330420130000006,39,41,40,42,39,26,24,21,227,45,272,16.544117647058822
12148,330420130000008,39,51,60,42,58,37,23,16,287,39,326,11.963190184049079
12149,330420130000009,14,17,14,20,12,16,17,11,93,28,121,23.140495867768596
12150,330420130000010,22,26,22,23,26,21,10,8,140,18,158,11.39240506329114
12151,330420130000011,22,17,20,13,11,14,5,5,97,10,107,9.345794392523365
12152,330430005000001,50,73,107,85,88,89,86,118,492,204,696,29.310344827586206
12153,330430005000002,31,39,59,52,50,46,28,55,277,83,360,23.055555555555557
12154,330430005000003,118,134,144,162,109,92,59,72,759,131,890,14.719101123595506
12155,330430005000004,88,136,137,128,136,114,69,60,739,129,868,14.861751152073733
12156,330430005000005,64,97,105,120,80,102,64,44,568,108,676,15.976331360946746
12157,330430005000006,71,86,91,110,83,62,24,18,503,42,545,7.706422018348624
12158,330430005000007,102,127,170,134,140,107,55,45,780,100,880,11.363636363636363
12159,330430005000008,166,188,226,198,158,134,85,43,1070,128,1198,10.684474123539232
12160,330430005000009,143,168,172,173,164,118,71,51,938,122,1060,11.50943396226415
12161,330430005000010,57,59,66,66,74,55,62,82,377,144,521,27.63915547024952
12162,330430005000011,87,104,132,119,91,96,69,63,629,132,761,17.345597897503286
12163,330430005000012,100,137,138,136,121,123,73,46,755,119,874,13.615560640732266
12164,330430005000013,107,162,143,162,136,106,83,67,816,150,966,15.527950310559007
12165,330430005000014,20,44,40,34,55,47,68,65,240,133,373,35.656836461126005
12166,330430005000015,114,130,161,142,148,113,84,71,808,155,963,16.095534787123572
12167,330430005000016,63,130,119,124,109,113,74,63,658,137,795,17.232704402515722
12168,330430005000017,73,101,114,112,92,59,43,26,551,69,620,11.129032258064516
12169,330430005000018,68,86,97,82,87,56,38,21,476,59,535,11.02803738317757
12170,330430005000019,49,70,69,70,56,68,23,19,382,42,424,9.90566037735849
12171,330430005000020,65,76,88,73,63,74,42,39,439,81,520,15.576923076923077
12172,330430005000021,53,74,79,81,56,54,31,26,397,57,454,12.555066079295154
12173,330430005000022,86,112,123,106,97,60,45,34,584,79,663,11.91553544494721
12174,330430005000023,77,97,101,101,85,56,46,37,517,83,600,13.833333333333334
12175,330430005000024,70,107,120,148,108,124,64,72,677,136,813,16.728167281672818
12176,330430005000025,62,121,145,122,117,118,63,57,685,120,805,14.906832298136646
12177,330430005000026,85,129,128,118,118,92,57,43,670,100,770,12.987012987012987
12178,330430005000027,104,117,122,135,100,64,42,41,642,83,725,11.448275862068966
12179,330430005000028,74,87,82,80,99,55,32,42,477,74,551,13.430127041742287
12180,330430005000029,119,169,148,127,143,88,36,42,794,78,872,8.944954128440367
12181,330430005000030,89,146,151,109,115,84,48,48,694,96,790,12.151898734177216
12182,330430005000031,127,136,186,192,156,90,78,37,887,115,1002,11.477045908183634
12183,330430005000032,135,146,152,138,125,100,63,36,796,99,895,11.061452513966481
12184,330430005000033,46,83,89,64,83,56,19,34,421,53,474,11.181434599156118
12185,330430005000034,157,215,176,205,148,130,73,48,1031,121,1152,10.503472222222221
12186,330430005000035,57,90,74,69,84,57,32,20,431,52,483,10.766045548654244
12187,330430005000036,82,71,104,78,71,60,29,27,466,56,522,10.727969348659004
12188,330430005000037,146,219,202,186,192,115,84,48,1060,132,1192,11.073825503355705
12189,330430005000038,111,120,139,145,115,81,55,40,711,95,806,11.786600496277917
12190,330430005000039,74,80,102,84,58,47,55,37,445,92,537,17.13221601489758
12191,330430005000040,56,73,78,101,65,55,27,25,428,52,480,10.833333333333334
12192,330430005000041,64,101,88,91,75,82,36,22,501,58,559,10.37567084078712
12193,330430005000042,222,181,189,254,193,111,47,23,1150,70,1220,5.737704918032787
12194,330430005000043,68,90,73,74,50,48,22,14,403,36,439,8.200455580865604
12195,330430005000044,76,84,67,89,60,33,14,9,409,23,432,5.324074074074074
12196,330430005000045,39,53,59,69,45,38,17,15,303,32,335,9.552238805970148
12197,330430005000046,119,138,113,117,87,60,41,30,634,71,705,10.070921985815604
12198,330430005000047,34,36,27,30,32,23,17,11,182,28,210,13.333333333333334
12199,330430005000048,142,154,146,136,102,80,46,44,760,90,850,10.588235294117647
12200,330430005000049,162,164,195,177,108,79,32,31,885,63,948,6.6455696202531644
12201,330430005000050,86,82,77,69,61,37,32,30,412,62,474,13.080168776371307
12202,330430005000051,103,176,90,153,178,62,50,71,762,121,883,13.703284258210646
12203,330430005000052,31,88,67,83,98,58,34,35,425,69,494,13.96761133603239
12204,330430005000053,74,119,88,81,64,44,42,28,470,70,540,12.962962962962964
12205,330430005000054,119,211,192,248,129,96,57,34,995,91,1086,8.37937384898711
12206,330430005000055,0,0,18,38,144,104,53,14,304,67,371,18.059299191374663
12207,330430005000056,80,114,135,142,91,83,61,33,645,94,739,12.719891745602165
12208,330430005000057,95,106,99,109,113,69,27,27,591,54,645,8.372093023255815
12209,330430005000058,64,61,103,49,52,44,17,22,373,39,412,9.466019417475728
12210,330430005000059,34,46,51,52,46,22,14,9,251,23,274,8.394160583941606
12211,330430005000060,30,50,39,34,38,16,16,11,207,27,234,11.538461538461538
12212,330430007000001,10,14,13,14,15,12,4,2,78,6,84,7.142857142857143
12213,330430007000002,5,8,6,7,10,4,0,1,40,1,41,2.4390243902439024
12214,330430007000003,102,100,128,99,95,56,36,29,580,65,645,10.077519379844961
12215,330430007000004,63,75,71,54,67,40,15,9,370,24,394,6.091370558375634
12216,330430007000005,52,77,78,73,75,65,24,9,420,33,453,7.28476821192053
12217,330430007000006,75,117,94,96,109,66,34,39,557,73,630,11.587301587301587
12218,330430007000007,117,154,117,146,101,65,37,32,700,69,769,8.972691807542263
12219,330430007000008,71,74,67,67,71,49,23,22,399,45,444,10.135135135135135
12220,330430007000009,45,62,52,62,44,30,18,15,295,33,328,10.060975609756097
12221,330430007000010,14,28,17,25,9,21,12,15,114,27,141,19.148936170212767
12222,330430007000011,24,68,25,51,59,23,16,14,250,30,280,10.714285714285714
12223,330430007000012,32,71,36,50,43,29,14,15,261,29,290,10.0
12224,330430007000013,58,89,71,65,59,37,32,25,379,57,436,13.073394495412844
12225,330430007000014,10,22,11,15,21,14,10,5,93,15,108,13.88888888888889
12226,330430007000015,30,50,33,59,32,22,10,7,226,17,243,6.995884773662551
12227,330430007000016,30,31,28,27,38,27,14,9,181,23,204,11.27450980392157
12228,330430007000017,25,31,36,31,27,17,12,7,167,19,186,10.21505376344086
12229,330430007000018,58,83,68,62,41,34,19,12,346,31,377,8.222811671087532
12230,330430010000001,96,109,126,123,77,62,42,36,593,78,671,11.624441132637854
12231,330430010000002,178,189,156,148,88,82,44,28,841,72,913,7.886089813800657
12232,330430010000003,196,224,221,184,112,85,47,34,1022,81,1103,7.343608340888486
12233,330430010000004,122,149,129,128,89,65,36,38,682,74,756,9.788359788359788
12234,330430010000005,33,66,58,64,46,39,31,27,306,58,364,15.934065934065934
12235,330430010000006,76,107,89,81,65,46,32,19,464,51,515,9.902912621359222
12236,330430010000007,54,73,52,54,34,21,17,13,288,30,318,9.433962264150944
12237,330430010000008,66,126,71,78,77,35,29,28,453,57,510,11.176470588235293
12238,330430010000009,66,84,80,72,52,41,23,21,395,44,439,10.022779043280183
12239,330430010000010,50,50,48,46,37,21,13,14,252,27,279,9.67741935483871
12240,330430010000011,111,56,73,57,36,41,17,7,374,24,398,6.030150753768845
12241,330430010000012,50,71,40,33,37,30,9,10,261,19,280,6.785714285714286
12242,330430010000013,40,52,39,30,33,22,10,9,216,19,235,8.085106382978724
12243,330430010000014,44,61,40,27,24,20,7,8,216,15,231,6.4935064935064934
12244,330430010000015,144,194,173,151,111,107,60,41,880,101,981,10.295616717635067
12245,330430010000016,85,107,100,52,71,65,25,39,480,64,544,11.764705882352942
12246,330440905000001,121,148,121,142,124,95,51,55,751,106,857,12.36872812135356
12247,330440905000002,98,127,98,102,89,54,45,32,568,77,645,11.937984496124031
12248,330440905000003,116,108,98,109,71,41,31,26,543,57,600,9.5
12249,330440905000004,35,45,59,52,53,59,55,53,303,108,411,26.277372262773724
12250,330440905000005,45,75,70,94,104,70,41,44,458,85,543,15.65377532228361
12251,330440905000006,50,81,68,64,101,49,32,25,413,57,470,12.127659574468085
12252,330440905000007,66,108,79,64,64,40,30,9,421,39,460,8.478260869565217
12253,330440905000008,115,141,159,143,145,101,64,55,804,119,923,12.892741061755146
12254,330440905000009,15,12,13,16,10,6,4,3,72,7,79,8.860759493670885
12255,330440905000010,12,17,8,7,7,5,3,1,56,4,60,6.666666666666667
12256,330440905000011,11,16,8,10,10,5,7,0,60,7,67,10.447761194029852
12257,330440905000012,5,7,9,6,4,6,5,8,37,13,50,26.0
12258,330440905000013,56,69,40,46,30,28,14,11,269,25,294,8.503401360544217
12259,330440905000014,10,8,6,12,13,7,9,3,56,12,68,17.647058823529413
12260,330440905000015,30,39,29,33,31,25,15,15,187,30,217,13.824884792626728
12261,330440905000016,93,94,69,74,52,28,9,10,410,19,429,4.428904428904429
12262,330440905000017,82,66,103,88,73,72,44,38,484,82,566,14.487632508833922
12263,330440910000001,66,87,71,73,67,53,24,31,417,55,472,11.652542372881356
12264,330440910000002,29,37,22,28,32,29,15,6,177,21,198,10.606060606060606
12265,330440910000003,26,52,28,29,27,30,22,10,192,32,224,14.285714285714286
12266,330440910000004,13,11,10,13,20,10,7,6,77,13,90,14.444444444444445
12267,330440910000005,33,44,28,32,27,11,9,12,175,21,196,10.714285714285714
12268,330440910000006,26,30,6,15,13,7,5,2,97,7,104,6.730769230769231
12269,330440915000001,88,86,73,95,88,63,42,47,493,89,582,15.292096219931272
12270,330440915000002,160,156,176,177,125,125,43,34,919,77,996,7.730923694779117
12271,330440915000003,42,69,56,59,72,41,29,35,339,64,403,15.88089330024814
12272,330440915000004,99,137,138,139,133,110,62,47,756,109,865,12.601156069364162
12273,330440915000005,84,101,87,91,77,44,34,24,484,58,542,10.70110701107011
12274,330440915000006,97,112,123,114,98,69,55,35,613,90,703,12.802275960170697
12275,330440915000007,1,3,4,0,5,0,2,3,13,5,18,27.77777777777778
12276,330440915000008,4,7,8,8,10,5,5,3,42,8,50,16.0
12277,330440915000009,67,63,56,64,40,36,20,12,326,32,358,8.938547486033519
12278,330440915000010,2,3,4,5,2,1,2,0,17,2,19,10.526315789473685
12279,330440915000011,20,24,24,16,17,13,10,7,114,17,131,12.977099236641221
12280,330440915000012,20,17,18,20,10,14,8,5,99,13,112,11.607142857142858
12281,330440915000013,28,34,30,22,21,14,19,10,149,29,178,16.292134831460675
12282,330440915000014,8,7,9,8,9,10,5,6,51,11,62,17.741935483870968
12283,330440915000015,89,90,83,87,66,58,41,13,473,54,527,10.246679316888045
12284,330440920000001,97,133,132,132,105,110,64,59,709,123,832,14.783653846153847
12285,330440920000002,50,94,74,83,98,61,48,55,460,103,563,18.294849023090585
12286,330440920000003,4,10,4,7,1,6,1,1,32,2,34,5.882352941176471
12287,330440920000004,12,14,8,17,10,4,6,1,65,7,72,9.722222222222221
12288,330440920000005,27,45,31,29,30,25,12,3,187,15,202,7.425742574257426
12289,330440920000006,12,21,11,16,10,8,2,5,78,7,85,8.235294117647058
12290,330440920000007,22,33,16,31,22,21,20,18,145,38,183,20.76502732240437
12291,330440920000008,0,0,1,3,5,2,4,0,11,4,15,26.666666666666668
12292,330440920000009,19,17,17,11,9,8,3,6,81,9,90,10.0
12293,330440920000010,7,14,8,7,4,9,3,4,49,7,56,12.5
12294,330440920000011,9,16,4,8,19,7,1,3,63,4,67,5.970149253731344
12295,330440920000012,4,5,7,2,4,0,0,0,22,0,22,0.0
12296,330440920000013,83,114,88,89,85,89,41,48,548,89,637,13.971742543171114
12297,330440920000014,27,30,17,16,17,17,6,1,124,7,131,5.343511450381679
12298,330440925000001,19,35,30,17,36,10,13,10,147,23,170,13.529411764705882
12299,330440925000002,8,2,7,3,8,7,2,2,35,4,39,10.256410256410257
12300,330440925000004,0,1,2,0,5,3,1,0,11,1,12,8.333333333333334
12301,330440925000005,32,61,34,32,49,38,24,11,246,35,281,12.455516014234876
12302,330440925000006,45,75,59,55,49,42,24,16,325,40,365,10.95890410958904
12303,330450805000001,119,162,214,123,161,101,48,49,880,97,977,9.92835209825998
12304,330450805000002,58,87,85,88,100,69,66,56,487,122,609,20.032840722495894
12305,330450805000003,136,147,122,163,118,74,80,53,760,133,893,14.893617021276595
12306,330450805000004,64,99,91,70,97,72,44,49,493,93,586,15.870307167235495
12307,330450805000005,142,179,87,128,109,68,31,16,713,47,760,6.184210526315789
12308,330450805000006,38,68,47,33,37,16,15,9,239,24,263,9.125475285171103
12309,330450805000007,58,68,51,57,48,47,34,27,329,61,390,15.64102564102564
12310,330450810000002,8,10,8,4,8,8,1,4,46,5,51,9.803921568627452
12311,330450810000004,17,25,10,17,15,10,5,2,94,7,101,6.930693069306931
12312,330450810000005,13,22,12,13,6,6,3,1,72,4,76,5.2631578947368425
12313,330450810000006,13,19,13,6,15,9,5,1,75,6,81,7.407407407407407
12314,330450810000007,10,14,11,8,6,9,6,2,58,8,66,12.121212121212121
12315,330450815000001,76,125,103,83,82,73,49,37,542,86,628,13.694267515923567
12316,330450815000002,28,31,17,25,21,15,7,8,137,15,152,9.868421052631579
12317,330450815000003,26,19,27,23,18,6,11,5,119,16,135,11.851851851851851
12318,330450815000004,58,69,64,47,48,28,22,15,314,37,351,10.54131054131054
12319,330450815000005,36,38,31,48,46,23,23,20,222,43,265,16.22641509433962
12320,330450820000001,117,142,139,114,123,85,54,53,720,107,827,12.938331318016928
12321,330450820000002,126,161,131,145,96,99,58,43,758,101,859,11.757857974388823
12322,330450820000003,23,29,18,19,10,16,14,10,115,24,139,17.26618705035971
12323,330450820000004,25,16,15,5,14,16,9,2,91,11,102,10.784313725490197
12324,330450820000005,32,35,35,47,36,26,23,16,211,39,250,15.6
12325,330452405000001,31,27,44,35,34,39,20,14,210,34,244,13.934426229508198
12326,330452405000002,65,68,77,52,47,34,37,18,343,55,398,13.819095477386934
12327,330452405000003,37,55,47,53,38,29,20,10,259,30,289,10.380622837370241
12328,330452405000004,76,103,108,93,75,70,34,39,525,73,598,12.207357859531772
12329,330452405000005,44,44,76,59,68,61,41,31,352,72,424,16.9811320754717
12330,330452405000006,54,94,72,61,89,48,35,15,418,50,468,10.683760683760683
12331,330452405000007,37,44,47,41,40,34,43,26,243,69,312,22.115384615384617
12332,330452405000008,4,10,13,12,10,21,17,3,70,20,90,22.22222222222222
12333,330452405000009,29,29,42,37,35,33,15,17,205,32,237,13.50210970464135
12334,330452405000010,32,51,53,48,61,39,38,47,284,85,369,23.035230352303522
12335,330452405000011,18,32,26,31,29,27,17,19,163,36,199,18.09045226130653
12336,330452405000012,15,28,26,17,28,20,15,11,134,26,160,16.25
12337,330452405000013,13,23,23,24,11,21,18,20,115,38,153,24.836601307189543
12338,330452405000014,23,25,17,28,28,25,15,9,146,24,170,14.117647058823529
12339,330452405000015,32,39,46,53,34,35,31,26,239,57,296,19.256756756756758
12340,330452405000016,23,35,40,37,46,37,28,22,218,50,268,18.65671641791045
12341,330452405000017,102,98,136,103,92,56,29,33,587,62,649,9.553158705701078
12342,330452405000018,16,29,32,32,27,22,22,16,158,38,196,19.387755102040817
12343,330452405000019,93,108,101,106,86,50,27,20,544,47,591,7.952622673434856
12344,330452405000020,92,125,115,120,85,54,35,17,591,52,643,8.087091757387247
12345,330452405000021,93,84,122,91,58,54,27,19,502,46,548,8.394160583941606
12346,330452405000022,64,65,64,69,59,40,22,18,361,40,401,9.975062344139651
12347,330452405000023,59,68,78,76,62,55,29,19,398,48,446,10.762331838565023
12348,330452405000024,58,76,46,88,88,42,30,15,398,45,443,10.15801354401806
12349,330452405000025,80,92,90,125,81,46,37,18,514,55,569,9.666080843585238
12350,330452405000026,59,68,68,82,66,49,30,17,392,47,439,10.70615034168565
12351,330452405000027,47,30,42,55,39,34,14,23,247,37,284,13.028169014084508
12352,330452405000028,32,46,45,57,58,47,33,19,285,52,337,15.43026706231454
12353,330452405000029,49,55,64,61,68,67,35,46,364,81,445,18.202247191011235
12354,330452405000030,27,29,47,33,29,21,17,16,186,33,219,15.068493150684931
12355,330452405000031,34,40,50,39,42,31,33,22,236,55,291,18.900343642611684
12356,330452405000032,46,46,79,43,69,55,32,23,338,55,393,13.994910941475826
12357,330452405000033,50,77,77,51,84,48,26,20,387,46,433,10.623556581986143
12358,330452405000034,40,56,52,47,74,40,32,18,309,50,359,13.927576601671309
12359,330452405000035,47,72,87,78,65,43,22,22,392,44,436,10.091743119266056
12360,330452405000036,59,70,84,84,64,36,21,20,397,41,438,9.360730593607306
12361,330452405000037,92,119,103,114,89,61,28,11,578,39,617,6.3209076175040515
12362,330452405000038,141,160,141,152,109,60,27,16,763,43,806,5.33498759305211
12363,330452405000039,147,141,164,137,116,63,25,8,768,33,801,4.119850187265918
12364,330452405000040,139,155,144,150,121,57,30,22,766,52,818,6.356968215158925
12365,330452405000041,78,97,109,75,66,45,26,15,470,41,511,8.023483365949119
12366,330452405000042,84,118,129,115,106,69,30,24,621,54,675,8.0
12367,330452405000043,74,88,120,81,66,46,24,14,475,38,513,7.407407407407407
12368,330452405000044,81,66,87,69,58,38,17,15,399,32,431,7.424593967517401
12369,330452405000045,35,35,57,47,42,32,22,10,248,32,280,11.428571428571429
12370,330452405000046,50,47,77,58,53,36,39,17,321,56,377,14.854111405835544
12371,330452405000047,44,52,76,51,54,37,21,12,314,33,347,9.510086455331413
12372,330452405000048,57,63,65,46,45,27,7,9,303,16,319,5.015673981191223
12373,330452405000049,35,56,46,49,40,30,20,17,256,37,293,12.627986348122867
12374,330452405000050,64,70,81,66,57,57,23,16,395,39,434,8.986175115207374
12375,330452405000051,92,93,118,91,88,57,21,24,539,45,584,7.705479452054795
12376,330452405000052,46,53,55,68,61,47,24,10,330,34,364,9.340659340659341
12377,330452405000053,73,69,101,90,72,50,21,17,455,38,493,7.707910750507099
12378,330452405000054,122,90,128,139,96,58,34,20,633,54,687,7.860262008733624
12379,330452405000055,75,82,91,118,73,67,29,15,506,44,550,8.0
12380,330452405000056,76,81,130,131,85,68,38,31,571,69,640,10.78125
12381,330452405000057,116,101,170,164,99,61,42,19,711,61,772,7.901554404145077
12382,330452405000058,134,126,158,147,98,64,33,18,727,51,778,6.5552699228791775
12383,330452405000059,119,119,145,125,95,30,22,7,633,29,662,4.380664652567976
12384,330452405000060,74,72,65,94,72,45,21,10,422,31,453,6.843267108167771
12385,330452405000061,31,33,46,46,48,24,17,13,228,30,258,11.627906976744185
12386,330452405000062,50,47,72,69,46,41,28,17,325,45,370,12.162162162162161
12387,330452405000063,78,80,110,103,83,83,25,20,537,45,582,7.731958762886598
12388,330452405000064,60,51,95,99,64,61,31,13,430,44,474,9.282700421940929
12389,330452405000065,44,35,73,46,43,35,18,15,276,33,309,10.679611650485437
12390,330452405000066,36,53,53,53,56,47,37,27,298,64,362,17.679558011049725
12391,330452405000067,73,57,86,77,71,59,25,30,423,55,478,11.506276150627615
12392,330452405000068,41,41,49,51,73,55,47,43,310,90,400,22.5
12393,330452405000069,79,108,99,122,118,75,39,25,601,64,665,9.62406015037594
12394,330452405000070,34,43,59,57,48,39,22,12,280,34,314,10.828025477707007
12395,330452405000071,33,37,33,37,40,30,22,5,210,27,237,11.39240506329114
12396,330452405000072,74,76,89,108,80,36,34,16,463,50,513,9.746588693957115
12397,330452405000073,60,74,80,68,58,51,28,24,391,52,443,11.738148984198645
12398,330452405000074,100,86,92,116,91,69,36,18,554,54,608,8.881578947368421
12399,330452405000075,114,144,129,124,91,77,42,21,679,63,742,8.49056603773585
12400,330452405000076,46,61,64,70,70,45,30,22,356,52,408,12.745098039215685
12401,330452405000077,172,247,150,165,105,76,41,14,915,55,970,5.670103092783505
12402,330452405000078,147,157,155,176,167,105,44,31,907,75,982,7.637474541751527
12403,330452405000079,10,18,18,15,13,14,9,8,88,17,105,16.19047619047619
12404,330452405000080,102,114,124,96,111,66,31,23,613,54,667,8.095952023988007
12405,330452405000081,57,80,75,74,70,69,16,12,425,28,453,6.181015452538631
12406,330452405000082,120,170,109,139,114,70,35,19,722,54,776,6.958762886597938
12407,330452405000083,82,87,80,94,75,61,15,15,479,30,509,5.893909626719057
12408,330452405000084,80,83,106,89,73,46,20,13,477,33,510,6.470588235294118
12409,330452405000085,171,181,166,160,100,61,27,22,839,49,888,5.518018018018018
12410,330452405000086,36,32,38,34,30,25,11,8,195,19,214,8.878504672897197
12411,330452405000087,59,68,90,81,66,52,42,21,416,63,479,13.152400835073069
12412,330452405000088,83,69,91,94,44,49,24,19,430,43,473,9.090909090909092
12413,330452405000089,87,107,101,99,76,60,26,14,530,40,570,7.017543859649122
12414,330452405000090,9,8,22,15,17,22,10,14,93,24,117,20.512820512820515
12415,330452405000091,14,23,36,26,26,31,13,18,156,31,187,16.577540106951872
12416,330452405000092,20,38,28,42,39,36,27,28,203,55,258,21.31782945736434
12417,330452405000093,22,25,44,37,32,32,15,17,192,32,224,14.285714285714286
12418,330452405000094,30,58,52,59,53,46,26,19,298,45,343,13.119533527696793
12419,330452405000095,47,58,56,54,43,41,30,27,299,57,356,16.01123595505618
12420,330452405000096,23,40,36,40,38,40,8,23,217,31,248,12.5
12421,330452405000097,48,51,39,65,46,20,12,10,269,22,291,7.560137457044673
12422,330452405000098,68,86,95,89,92,60,33,24,490,57,547,10.420475319926874
12423,330452405000099,84,120,88,92,79,38,38,16,501,54,555,9.72972972972973
12424,330452405000100,78,95,77,81,74,26,21,9,431,30,461,6.507592190889371
12425,330452405000101,72,55,80,55,50,37,16,14,349,30,379,7.915567282321899
12426,330452405000102,76,78,73,107,79,64,28,13,477,41,518,7.915057915057915
12427,330452405000103,28,30,41,28,31,38,18,6,196,24,220,10.909090909090908
12428,330452405000104,41,57,55,53,61,53,25,24,320,49,369,13.279132791327914
12429,330452405000105,44,65,84,82,74,54,27,27,403,54,457,11.816192560175054
12430,330452405000106,45,57,66,58,38,40,16,23,304,39,343,11.370262390670554
12431,330452405000107,22,21,23,25,27,20,14,12,138,26,164,15.853658536585366
12432,330452405000108,82,91,98,101,83,72,28,24,527,52,579,8.981001727115716
12433,330452405000109,47,50,48,44,77,49,28,18,315,46,361,12.742382271468143
12434,330452405000110,46,61,62,77,51,38,19,10,335,29,364,7.967032967032967
12435,330452405000111,80,84,98,98,75,61,26,23,496,49,545,8.990825688073395
12436,330452405000112,121,102,135,107,79,63,31,26,607,57,664,8.58433734939759
12437,330452405000113,64,67,61,72,43,28,6,5,335,11,346,3.179190751445087
12438,330452405000114,172,169,182,158,118,60,28,20,859,48,907,5.2921719955898565
12439,330452405000115,103,112,139,110,92,51,25,11,607,36,643,5.598755832037325
12440,330452405000116,65,52,71,51,50,48,9,7,337,16,353,4.53257790368272
12441,330452405000117,93,126,157,95,81,52,32,18,604,50,654,7.6452599388379205
12442,330452405000118,42,35,22,28,16,2,4,2,145,6,151,3.9735099337748343
12443,330452405000119,54,73,82,77,60,48,35,31,394,66,460,14.347826086956522
12444,330452405000120,46,53,57,56,38,25,16,12,275,28,303,9.24092409240924
12445,330452405000121,13,16,22,23,11,18,13,7,103,20,123,16.260162601626018
12446,330452405000122,56,58,65,55,58,43,18,11,335,29,364,7.967032967032967
12447,330452405000123,21,15,39,24,14,16,9,6,129,15,144,10.416666666666666
12448,330452405000124,99,93,139,96,76,52,17,11,555,28,583,4.802744425385935
12449,330452405000125,101,118,100,124,102,51,24,24,596,48,644,7.453416149068323
12450,330452405000126,61,60,76,64,60,33,20,7,354,27,381,7.086614173228346
12451,330452405000127,92,106,96,80,52,38,14,2,464,16,480,3.3333333333333335
12452,330452405000128,50,71,71,67,65,63,30,23,387,53,440,12.045454545454545
12453,330452405000129,87,70,100,117,72,61,26,23,507,49,556,8.81294964028777
12454,330452405000130,58,69,73,118,87,65,31,11,470,42,512,8.203125
12455,330452405000131,77,54,119,93,56,49,33,16,448,49,497,9.859154929577464
12456,330452405000132,183,186,211,322,155,105,58,29,1162,87,1249,6.965572457966373
12457,330452405000133,55,50,61,81,52,41,26,15,340,41,381,10.761154855643044
12458,330452405000134,109,106,120,155,92,75,33,26,657,59,716,8.240223463687151
12459,330452405000135,100,84,120,140,95,61,34,15,600,49,649,7.550077041602465
12460,330452405000136,52,64,78,75,68,61,30,29,398,59,457,12.910284463894968
12461,330452405000137,139,136,165,207,123,85,54,31,855,85,940,9.042553191489361
12462,330452405000138,71,95,83,113,81,33,24,8,476,32,508,6.299212598425197
12463,330452405000139,91,110,79,114,64,41,21,7,499,28,527,5.313092979127135
12464,330452405000140,94,78,125,138,100,48,25,8,583,33,616,5.357142857142857
12465,330452405000141,109,69,100,114,56,39,20,15,487,35,522,6.704980842911877
12466,330452405000142,164,139,224,154,71,49,17,12,801,29,830,3.4939759036144578
12467,330452405000143,99,89,84,79,72,34,28,10,457,38,495,7.6767676767676765
12468,330452405000144,134,118,144,146,93,40,22,14,675,36,711,5.063291139240507
12469,330452405000145,168,157,211,214,134,112,46,27,996,73,1069,6.828811973807296
12470,330452405000146,147,146,156,149,114,67,21,16,779,37,816,4.534313725490196
12471,330452405000147,133,119,126,124,71,47,20,7,620,27,647,4.1731066460587325
12472,330452405000148,181,177,175,170,114,66,24,2,883,26,909,2.8602860286028604
12473,330452405000149,139,106,106,113,71,47,11,7,582,18,600,3.0
12474,330452405000150,147,128,178,142,110,67,33,11,772,44,816,5.392156862745098
12475,330452405000151,140,118,156,137,75,41,28,10,667,38,705,5.390070921985815
12476,330452405000152,163,144,168,136,95,58,35,22,764,57,821,6.942752740560293
12477,330452405000153,146,134,121,111,79,38,11,3,629,14,643,2.177293934681182
12478,330452405000154,120,80,135,110,71,57,17,10,573,27,600,4.5
12479,330452405000155,79,76,93,115,94,53,32,6,510,38,548,6.934306569343065
12480,330452405000156,63,64,85,108,68,55,27,18,443,45,488,9.221311475409836
12481,330452405000157,129,84,147,170,90,85,43,14,705,57,762,7.480314960629921
12482,330452405000158,65,84,92,107,86,63,24,12,497,36,533,6.75422138836773
12483,330452405000159,61,54,54,62,50,41,19,7,322,26,348,7.471264367816092
12484,330452405000160,75,75,90,80,64,58,29,17,442,46,488,9.426229508196721
12485,330452405000161,31,46,45,54,59,35,17,16,270,33,303,10.891089108910892
12486,330452405000162,73,77,104,100,91,60,27,20,505,47,552,8.514492753623188
12487,330452405000163,38,45,33,46,43,31,13,12,236,25,261,9.578544061302683
12488,330452405000164,95,86,99,133,84,66,42,25,563,67,630,10.634920634920634
12489,330452405000165,52,52,59,81,52,36,27,13,332,40,372,10.75268817204301
12490,330452405000166,50,57,83,84,63,66,36,15,403,51,454,11.233480176211454
12491,330452405000167,22,27,23,32,27,14,12,7,145,19,164,11.585365853658537
12492,330452405000168,44,58,63,78,77,72,42,24,392,66,458,14.410480349344978
12493,330452405000169,22,36,41,50,45,32,26,25,226,51,277,18.411552346570396
12494,330452405000170,44,42,54,60,57,48,22,17,305,39,344,11.337209302325581
12495,330452405000171,19,32,28,37,36,20,10,9,172,19,191,9.947643979057592
12496,330452405000172,34,38,41,25,43,36,8,11,217,19,236,8.05084745762712
12497,330452405000173,65,60,72,74,64,46,25,12,381,37,418,8.851674641148325
12498,330452405000174,44,73,82,73,70,74,47,27,416,74,490,15.10204081632653
12499,330452405000175,47,74,86,74,75,52,30,24,408,54,462,11.688311688311689
12500,330452405000176,92,119,156,131,103,72,30,15,673,45,718,6.2674094707520895
12501,330452405000177,97,94,141,108,113,56,42,18,609,60,669,8.968609865470851
12502,330452405000178,89,97,79,110,79,40,19,20,494,39,533,7.317073170731708
12503,330452405000179,52,89,73,77,76,56,38,20,423,58,481,12.058212058212058
12504,330452405000180,60,84,54,78,78,38,29,18,392,47,439,10.70615034168565
12505,330452405000181,80,94,74,77,71,47,22,18,443,40,483,8.281573498964804
12506,330452405000182,99,97,102,116,84,42,25,17,540,42,582,7.216494845360825
12507,330452405000183,140,186,133,140,144,71,37,19,814,56,870,6.436781609195402
12508,330452405000184,145,121,124,111,98,62,30,22,661,52,713,7.293127629733521
12509,330452405000185,115,139,144,130,103,72,50,24,703,74,777,9.523809523809524
12510,330452405000186,101,122,144,134,130,91,54,33,722,87,809,10.754017305315204
12511,330452405000187,155,150,144,140,72,61,25,18,722,43,765,5.620915032679738
12512,330452405000188,110,110,135,150,75,63,20,6,643,26,669,3.8863976083707024
12513,330452405000189,154,190,153,184,131,70,35,14,882,49,931,5.2631578947368425
12514,330452405000190,60,78,55,79,45,25,15,12,342,27,369,7.317073170731708
12515,330452405000191,125,152,158,130,114,94,32,23,773,55,828,6.642512077294686
12516,330452405000192,89,87,76,88,59,43,27,19,442,46,488,9.426229508196721
12517,330452405000193,154,137,181,135,116,57,27,18,780,45,825,5.454545454545454
12518,330452405000194,45,38,31,103,57,40,24,8,314,32,346,9.248554913294798
12519,330452405000195,38,34,50,59,28,24,8,6,233,14,247,5.668016194331984
12520,330452405000196,66,55,44,80,55,38,24,15,338,39,377,10.344827586206897
12521,330452405000197,85,90,88,117,111,88,46,19,579,65,644,10.093167701863354
12522,330452405000198,57,79,60,67,55,38,11,11,356,22,378,5.8201058201058204
12523,330452405000199,47,36,27,44,42,43,13,5,239,18,257,7.003891050583658
12524,330452405000200,47,36,46,45,50,40,21,12,264,33,297,11.11111111111111
12525,330452405000201,36,43,50,41,35,31,21,7,236,28,264,10.606060606060606
12526,330452405000202,95,93,104,107,77,66,34,21,542,55,597,9.212730318257956
12527,330452405000203,12,5,12,10,8,3,3,1,50,4,54,7.407407407407407
12528,330452405000204,50,84,76,67,67,54,21,18,398,39,437,8.924485125858123
12529,330452405000205,122,144,124,146,116,77,58,58,729,116,845,13.727810650887575
12530,330452405000206,109,125,125,94,90,57,33,19,600,52,652,7.975460122699387
12531,330452405000207,17,16,15,19,13,7,2,4,87,6,93,6.451612903225806
12532,330452405000208,23,26,22,35,40,29,7,9,175,16,191,8.37696335078534
12533,330452405000209,14,10,21,10,13,7,3,0,75,3,78,3.8461538461538463
12534,330452405000210,10,22,11,10,17,18,2,9,88,11,99,11.11111111111111
12535,330452405000211,101,72,100,69,41,38,9,2,421,11,432,2.5462962962962963
12536,330452405000212,206,227,242,187,103,60,11,7,1025,18,1043,1.725790987535954
12537,330452405000213,129,108,113,110,64,30,24,6,554,30,584,5.136986301369863
12539,330452405000215,24,27,15,14,15,14,2,2,109,4,113,3.5398230088495577
12540,330452405000217,60,60,47,49,39,48,13,13,303,26,329,7.90273556231003
12541,330452405000218,183,182,159,153,125,85,39,19,887,58,945,6.137566137566138
12542,330452405000219,81,93,86,87,69,54,20,17,470,37,507,7.297830374753452
12544,330452405000221,84,65,148,151,64,56,23,28,568,51,619,8.239095315024233
12545,330455705060001,100,133,128,123,139,83,51,34,706,85,791,10.745891276864729
12546,330455705060002,176,212,244,164,145,65,36,10,1006,46,1052,4.3726235741444865
12547,330455705060003,47,79,48,51,36,24,20,15,285,35,320,10.9375
12548,330455705060004,63,67,89,60,57,41,27,31,377,58,435,13.333333333333334
12549,330455705060005,147,145,91,90,69,49,27,30,591,57,648,8.796296296296296
12550,330455705060006,244,222,209,194,124,73,41,12,1066,53,1119,4.736371760500447
12551,330455705060008,76,124,91,105,74,33,23,7,503,30,533,5.628517823639775
12552,330455705060009,78,90,98,107,85,67,54,36,525,90,615,14.634146341463415
12553,330455705060010,164,128,196,125,102,66,16,14,781,30,811,3.6991368680641186
12554,330455705060011,216,163,273,209,127,99,42,28,1087,70,1157,6.050129645635264
12555,330455705060012,132,187,178,133,98,82,38,16,810,54,864,6.25
12556,330455705060013,156,153,213,153,109,74,35,27,858,62,920,6.739130434782608
12557,330455705060014,128,148,212,145,126,92,63,40,851,103,954,10.79664570230608
12558,330455705060015,50,74,73,84,84,54,54,69,419,123,542,22.69372693726937
12559,330455705060016,67,58,87,67,71,87,81,238,437,319,756,42.195767195767196
12560,330455705060017,164,189,200,199,183,120,69,77,1055,146,1201,12.15653621981682
12561,330455705060018,60,109,157,129,131,105,70,81,691,151,842,17.93349168646081
12562,330455705060019,90,89,157,79,131,89,74,40,635,114,749,15.220293724966622
12563,330455705060020,29,29,34,33,35,34,24,12,194,36,230,15.652173913043478
12564,330455705060021,42,45,50,53,58,49,47,50,297,97,394,24.619289340101524
12565,330455705060022,135,122,143,153,83,92,46,30,728,76,804,9.45273631840796
12566,330455705060023,93,126,104,141,90,82,48,48,636,96,732,13.114754098360656
12567,330455705060024,50,55,60,62,39,31,18,11,297,29,326,8.895705521472392
12568,330455705060025,83,89,134,104,92,101,45,77,603,122,725,16.82758620689655
12569,330455705060026,105,102,144,114,130,108,67,82,703,149,852,17.488262910798124
12570,330455705060027,78,131,125,117,96,92,62,50,639,112,751,14.913448735019973
12571,330455705060028,62,86,84,102,65,59,38,32,458,70,528,13.257575757575758
12572,330455705060029,78,129,214,195,171,151,49,46,938,95,1033,9.19651500484027
12573,330455705060030,122,139,169,127,138,136,55,69,831,124,955,12.984293193717278
12574,330455705060031,20,18,35,37,19,24,13,7,153,20,173,11.560693641618498
12575,330455705060032,126,138,122,145,125,87,40,20,743,60,803,7.4719800747198
12576,330455705060033,159,166,233,183,109,68,44,8,918,52,970,5.360824742268041
12577,330455705060034,93,133,130,120,121,104,58,50,701,108,809,13.349814585908529
12578,330455705060035,91,97,111,123,87,73,48,51,582,99,681,14.537444933920705
12579,330455705060036,82,72,108,84,89,76,53,63,511,116,627,18.50079744816587
12580,330455705060037,60,61,68,62,67,49,33,27,367,60,427,14.05152224824356
12581,330455705060038,16,24,21,23,17,19,10,5,120,15,135,11.11111111111111
12582,330455705060039,46,69,42,26,35,21,15,6,239,21,260,8.076923076923077
12583,330455705060040,85,82,63,55,56,24,13,14,365,27,392,6.887755102040816
12584,330455705060041,142,192,174,166,149,75,42,25,898,67,965,6.94300518134715
12585,330455705060042,113,116,124,109,91,60,37,18,613,55,668,8.233532934131736
12586,330455705060043,173,230,200,131,103,76,37,40,913,77,990,7.777777777777778
12587,330455705060044,124,132,154,129,80,83,37,23,702,60,762,7.874015748031496
12588,330455705060045,45,63,100,119,111,107,58,34,545,92,637,14.442700156985872
12589,330455705060046,223,238,217,218,153,143,81,50,1192,131,1323,9.901738473167045
12590,330455705060047,59,79,117,107,78,78,59,51,518,110,628,17.515923566878982
12591,330455705060048,60,59,85,86,62,35,25,27,387,52,439,11.845102505694761
12592,330455705060049,82,93,87,81,81,49,40,25,473,65,538,12.0817843866171
12593,330455705060050,60,86,77,76,49,58,24,20,406,44,450,9.777777777777779
12594,330455705060051,132,172,192,148,153,130,65,71,927,136,1063,12.793979303857009
12595,330455705060052,84,113,123,137,117,84,43,27,658,70,728,9.615384615384615
12596,330455705060053,86,118,138,116,95,66,40,17,619,57,676,8.431952662721894
12597,330455705060054,64,61,82,73,61,48,31,25,389,56,445,12.584269662921349
12598,330455705060055,29,41,68,47,51,25,30,20,261,50,311,16.077170418006432
12599,330455705060056,43,59,71,45,38,48,25,21,304,46,350,13.142857142857142
12600,330455705060057,116,116,161,122,109,89,50,50,713,100,813,12.300123001230013
12601,330455705060058,57,83,118,129,83,67,34,25,537,59,596,9.899328859060402
12602,330455705060059,31,41,65,41,46,41,27,29,265,56,321,17.445482866043612
12603,330455705060060,45,81,168,123,91,80,53,51,588,104,692,15.028901734104046
12604,330455705060061,13,11,20,24,20,12,6,13,100,19,119,15.966386554621849
12605,330455705060062,15,22,48,41,19,23,19,21,168,40,208,19.23076923076923
12606,330455705060063,59,62,49,46,34,24,22,21,274,43,317,13.564668769716087
12607,330455705060064,302,294,354,278,142,88,48,9,1458,57,1515,3.762376237623762
12608,330455705060065,72,87,132,58,74,50,29,37,473,66,539,12.244897959183673
12609,330455705060066,148,198,199,172,118,82,31,38,917,69,986,6.9979716024340775
12610,330455705060067,20,17,22,34,26,23,19,13,142,32,174,18.39080459770115
12611,330455705060068,42,42,54,60,49,55,27,33,302,60,362,16.574585635359117
12612,330455705060069,64,61,80,74,59,47,22,27,385,49,434,11.290322580645162
12613,330455705060070,89,63,63,64,29,13,5,0,321,5,326,1.5337423312883436
12614,330455705060071,27,52,27,44,35,8,5,11,193,16,209,7.655502392344498
12615,330455705060073,179,212,264,177,148,90,31,18,1070,49,1119,4.378909740840036
12616,330455705060074,239,263,297,226,149,93,41,12,1267,53,1320,4.015151515151516
12617,330455705060075,135,137,160,157,63,49,17,7,701,24,725,3.310344827586207
12618,330455705070001,13,13,17,31,18,28,12,9,120,21,141,14.893617021276595
12619,330455705070002,49,69,78,61,59,50,22,14,366,36,402,8.955223880597014
12620,330455705070003,76,86,137,138,97,87,39,21,621,60,681,8.810572687224669
12621,330455705070004,41,42,68,46,39,35,19,16,271,35,306,11.437908496732026
12622,330455705070005,30,35,95,61,66,36,26,28,323,54,377,14.323607427055704
12623,330455705070006,0,0,10,13,5,11,7,9,39,16,55,29.09090909090909
12624,330455705070007,7,10,14,12,18,6,4,8,67,12,79,15.189873417721518
12625,330455705070008,2,3,2,2,1,1,1,2,11,3,14,21.428571428571427
12626,330455705070009,13,17,39,50,47,56,40,26,222,66,288,22.916666666666668
12628,330455705070012,21,24,34,15,19,23,11,10,136,21,157,13.375796178343949
12630,330455705070015,4,7,4,6,6,6,3,0,33,3,36,8.333333333333334
12631,330455705070016,12,12,15,22,16,18,11,9,95,20,115,17.391304347826086
12632,330455705070017,27,20,41,33,40,38,21,8,199,29,228,12.719298245614034
12633,330455705070018,7,22,34,29,20,22,14,14,134,28,162,17.28395061728395
12634,330455705070019,5,9,52,42,45,39,20,22,192,42,234,17.94871794871795
12635,330455705070020,3,7,22,19,19,15,10,6,85,16,101,15.841584158415841
12636,330455705070021,48,58,115,135,117,99,61,88,572,149,721,20.665742024965326
12637,330455705070022,31,37,96,65,60,67,57,53,356,110,466,23.605150214592275
12638,330455705070023,10,19,63,45,61,71,49,36,269,85,354,24.01129943502825
12639,330455705070024,26,60,83,87,84,74,42,37,414,79,493,16.024340770791074
12640,330455705070025,33,36,74,54,41,49,26,23,287,49,336,14.583333333333334
12641,330455705070026,22,44,68,63,67,54,26,18,318,44,362,12.154696132596685
12642,330455705070027,16,24,45,49,53,32,34,37,219,71,290,24.482758620689655
12643,330455705070028,37,42,96,77,83,91,62,65,426,127,553,22.965641952983724
12644,330455705070029,6,4,8,9,13,20,4,9,60,13,73,17.80821917808219
12645,330455705070030,29,38,70,67,67,52,48,37,323,85,408,20.833333333333332
12646,330455705070031,26,23,89,77,73,77,52,59,365,111,476,23.319327731092436
12647,330455705070032,19,20,55,60,54,48,31,22,256,53,309,17.15210355987055
12648,330455705070033,33,58,118,85,117,134,70,76,545,146,691,21.1287988422576
12649,330455705070034,21,39,94,81,61,58,46,36,354,82,436,18.807339449541285
12650,330455705070035,36,42,107,69,63,33,17,9,350,26,376,6.914893617021277
12651,330455705070036,45,45,98,104,72,112,43,58,476,101,577,17.504332755632582
12652,330455705070037,36,72,117,87,93,99,45,52,504,97,601,16.139767054908486
12653,330455705070038,29,33,48,78,65,59,61,72,312,133,445,29.8876404494382
12654,330455705070039,40,48,93,84,81,93,77,95,439,172,611,28.150572831423894
12655,330455705070040,48,94,124,107,113,123,88,127,609,215,824,26.09223300970874
12656,330455705070041,42,56,93,76,98,96,62,63,461,125,586,21.331058020477816
12657,330455705070042,46,71,145,145,121,123,106,79,651,185,836,22.129186602870814
12658,330455705070043,35,30,81,110,84,63,54,67,403,121,524,23.091603053435115
12659,330455705070044,37,47,89,82,85,73,59,61,413,120,533,22.5140712945591
12660,330455705070045,12,27,49,44,51,50,42,30,233,72,305,23.60655737704918
12661,330455705070046,23,37,86,85,77,63,73,73,371,146,517,28.239845261121857
12662,330455705070047,10,38,58,50,58,61,42,39,275,81,356,22.752808988764045
12663,330455705070048,32,40,100,108,98,85,79,49,463,128,591,21.658206429780034
12664,330455705070049,14,28,53,65,55,54,66,63,269,129,398,32.41206030150754
12665,330455705070050,47,67,85,61,72,79,51,43,411,94,505,18.613861386138613
12666,330455705070051,37,56,96,99,71,70,68,49,429,117,546,21.428571428571427
12667,330455705070052,37,62,121,101,101,91,66,67,513,133,646,20.58823529411765
12668,330455705070053,19,34,59,36,49,55,35,32,252,67,319,21.003134796238246
12669,330455705070054,30,33,80,78,76,80,66,104,377,170,547,31.078610603290677
12670,330455705070055,41,57,123,123,111,99,78,92,554,170,724,23.480662983425415
12671,330455705070056,41,61,142,165,118,122,109,87,649,196,845,23.19526627218935
12672,330455705070057,33,48,89,89,93,79,53,65,431,118,549,21.493624772313296
12673,330455705070058,45,45,87,104,82,82,69,100,445,169,614,27.52442996742671
12674,330455705070059,17,25,46,52,51,52,48,53,243,101,344,29.36046511627907
12675,330455705070060,10,20,44,47,56,62,62,73,239,135,374,36.096256684491976
12676,330455705070061,18,28,69,73,57,62,54,71,307,125,432,28.935185185185187
12677,330455705070062,35,33,72,64,66,67,49,69,337,118,455,25.934065934065934
12678,330455705070063,37,47,97,101,85,89,72,79,456,151,607,24.87644151565074
12679,330455705070064,13,20,57,57,50,54,51,53,251,104,355,29.295774647887324
12680,330455705070065,31,48,85,68,84,92,60,57,408,117,525,22.285714285714285
12681,330455705070066,37,36,98,109,94,90,54,66,464,120,584,20.54794520547945
12682,330455705070067,14,29,67,52,51,41,35,49,254,84,338,24.85207100591716
12683,330455705070068,38,46,73,76,65,54,52,58,352,110,462,23.80952380952381
12684,330455705070069,18,28,58,80,57,66,44,53,307,97,404,24.00990099009901
12685,330455705070070,43,57,86,83,77,92,51,52,438,103,541,19.038817005545287
12686,330455705070071,37,56,89,86,90,79,60,41,437,101,538,18.773234200743495
12687,330455705070072,42,44,96,112,73,86,66,55,453,121,574,21.0801393728223
12688,330455705070073,28,28,52,43,42,42,29,24,235,53,288,18.40277777777778
12689,330455705070074,38,58,106,107,93,99,66,62,501,128,629,20.349761526232115
12690,330455705070075,12,14,54,21,28,36,7,10,165,17,182,9.340659340659341
12691,330455705070076,44,95,152,100,110,128,78,87,629,165,794,20.7808564231738
12692,330455705070077,25,31,54,63,49,62,45,62,284,107,391,27.365728900255753
12693,330455705070078,18,29,76,68,51,57,58,54,299,112,411,27.25060827250608
12694,330455705070079,34,41,87,104,76,81,72,58,423,130,553,23.508137432188065
12695,330455705070080,28,31,81,80,65,57,55,53,342,108,450,24.0
12696,330455705070081,43,56,110,93,89,83,57,65,474,122,596,20.469798657718123
12697,330455705070082,23,36,79,68,59,61,40,48,326,88,414,21.256038647342994
12698,330455705070083,58,65,95,103,93,80,63,45,494,108,602,17.940199335548172
12699,330455705070084,27,38,102,66,59,66,31,43,358,74,432,17.12962962962963
12700,330455705070085,20,31,67,57,60,61,46,57,296,103,399,25.81453634085213
12701,330455705070086,29,50,56,70,62,36,16,23,303,39,342,11.403508771929825
12702,330455705070087,13,27,50,35,38,36,27,20,199,47,246,19.10569105691057
12703,330455705070088,19,29,55,43,50,52,31,21,248,52,300,17.333333333333332
12704,330455705070089,30,30,76,65,57,64,42,37,322,79,401,19.700748129675812
12705,330455705070090,4,4,5,4,5,1,0,1,23,1,24,4.166666666666667
12706,330455705070091,41,56,100,119,104,91,71,90,511,161,672,23.958333333333332
12707,330455705070092,35,43,55,43,67,70,25,25,313,50,363,13.774104683195592
12708,330455705070093,26,32,82,68,73,69,53,59,350,112,462,24.242424242424242
12709,330455705070094,31,41,95,104,85,75,49,67,431,116,547,21.206581352833638
12710,330455705070095,47,51,88,87,83,78,60,68,434,128,562,22.775800711743774
12711,330455705070096,59,53,154,169,139,62,31,16,636,47,683,6.881405563689604
12712,330455705070097,36,23,114,126,49,57,25,17,405,42,447,9.395973154362416
12713,330455705070098,13,20,24,23,9,12,3,4,101,7,108,6.481481481481482
12714,330455705070099,26,29,50,51,41,40,37,44,237,81,318,25.471698113207548
12715,330455705070100,14,20,35,30,28,24,12,13,151,25,176,14.204545454545455
12716,330455705070101,1,2,20,23,17,5,5,0,68,5,73,6.8493150684931505
12717,330455705080001,50,65,79,86,116,78,72,106,474,178,652,27.300613496932517
12718,330455705080002,57,95,86,119,115,103,112,119,575,231,806,28.66004962779156
12719,330455705080003,26,28,39,41,27,51,24,38,212,62,274,22.62773722627737
12720,330455705080004,74,81,87,101,101,100,69,106,544,175,719,24.339360222531294
12721,330455705080005,94,121,120,142,103,85,49,57,665,106,771,13.748378728923475
12722,330455705080006,56,107,56,66,63,29,20,13,377,33,410,8.048780487804878
12723,330455705080007,76,61,102,87,47,38,17,16,411,33,444,7.4324324324324325
12724,330455705080008,89,76,88,81,64,50,35,22,448,57,505,11.287128712871286
12725,330455705080009,67,108,58,64,60,40,30,16,397,46,443,10.383747178329571
12726,330455705080010,66,68,66,58,48,32,22,12,338,34,372,9.13978494623656
12727,330455705080011,24,19,21,22,18,21,11,4,125,15,140,10.714285714285714
12728,330455705080013,186,187,178,154,111,72,47,23,888,70,958,7.306889352818372
12729,330455705080014,89,102,96,58,56,58,24,17,459,41,500,8.2
12730,330455705080015,140,139,99,73,66,54,20,27,571,47,618,7.605177993527508
12731,330455705080016,80,65,79,63,50,35,22,27,372,49,421,11.63895486935867
12732,330455705080017,16,23,23,17,10,6,10,3,95,13,108,12.037037037037036
12733,330455705080018,59,78,86,85,81,87,60,84,476,144,620,23.225806451612904
12734,330455705080019,91,91,119,137,84,112,79,80,634,159,793,20.05044136191677
12735,330455705080020,102,111,121,123,120,126,84,82,703,166,869,19.102416570771002
12736,330455705080021,34,45,38,34,15,21,8,6,187,14,201,6.965174129353234
12737,330455705080022,14,14,10,13,3,8,3,3,62,6,68,8.823529411764707
12738,330455705080023,156,178,222,139,121,108,47,41,924,88,1012,8.695652173913043
12739,330455705080024,97,117,162,132,118,125,64,53,751,117,868,13.47926267281106
12740,330455705080025,78,54,104,131,125,120,48,49,612,97,709,13.681241184767277
12741,330455705080026,0,0,0,0,0,0,0,30,0,30,30,100.0
12742,330455705080027,108,145,112,151,86,41,31,12,643,43,686,6.2682215743440235
12743,330455705080028,41,59,49,36,28,30,16,14,243,30,273,10.989010989010989
12744,330455705080029,40,62,170,86,73,60,32,48,491,80,571,14.010507880910684
12745,330455705080030,66,77,89,67,61,38,32,55,398,87,485,17.938144329896907
12746,330455705080031,57,66,103,97,107,105,64,122,535,186,721,25.79750346740638
12747,330455705080032,35,36,58,64,51,54,43,48,298,91,389,23.39331619537275
12748,330455705080033,28,42,53,59,72,44,24,59,298,83,381,21.78477690288714
12749,330455705080034,36,56,91,72,84,70,51,65,409,116,525,22.095238095238095
12750,330455705080035,67,113,122,140,125,93,74,92,660,166,826,20.09685230024213
12751,330455705080036,0,0,0,0,0,0,0,41,0,41,41,100.0
12752,330455705080037,60,60,71,84,75,65,55,54,415,109,524,20.801526717557252
12753,330455705080038,51,76,96,89,53,68,33,43,433,76,509,14.931237721021612
12754,330455705080039,51,56,65,79,43,79,29,35,373,64,437,14.645308924485127
12755,330455705080040,92,101,101,69,71,49,24,23,483,47,530,8.867924528301886
12756,330455705080041,8,19,24,10,14,26,14,66,101,80,181,44.19889502762431
12757,330455705080042,189,194,178,140,88,68,53,15,857,68,925,7.351351351351352
12758,330455705080043,137,131,146,82,54,40,7,15,590,22,612,3.5947712418300655
12759,330455705080044,142,152,155,98,92,70,31,9,709,40,749,5.34045393858478
12760,330455705080045,145,166,149,127,91,67,50,25,745,75,820,9.146341463414634
12761,330455705080046,106,125,154,112,84,73,48,38,654,86,740,11.621621621621621
12762,330455705080047,53,71,112,86,98,93,55,55,513,110,623,17.656500802568218
12763,330455705080048,65,67,134,78,72,80,46,63,496,109,605,18.016528925619834
12764,330455705080049,33,41,74,64,84,60,54,72,356,126,482,26.141078838174273
12765,330455705080050,40,72,100,90,75,104,47,72,481,119,600,19.833333333333332
12766,330455705080051,95,131,184,154,164,157,85,86,885,171,1056,16.193181818181817
12767,330455705080052,44,66,65,62,69,44,36,42,350,78,428,18.22429906542056
12768,330455705080053,31,54,73,64,59,82,47,47,363,94,457,20.568927789934353
12769,330455705080054,387,464,448,490,396,293,133,73,2478,206,2684,7.6751117734724295
12770,330455705080055,141,149,166,123,76,82,33,24,737,57,794,7.178841309823677
12771,330455705080056,140,132,196,198,180,109,70,38,955,108,1063,10.159924741298212
12772,330455705080057,215,236,290,302,223,107,63,23,1373,86,1459,5.894448252227553
12773,330455705080058,37,54,49,64,59,43,39,21,306,60,366,16.39344262295082
12774,330455705080059,83,110,142,154,123,77,52,41,689,93,782,11.892583120204604
12775,330455705080060,71,78,92,92,64,40,37,17,437,54,491,10.9979633401222
12776,330455705080061,77,73,84,71,62,53,32,34,420,66,486,13.580246913580247
12777,330455705080062,36,39,53,44,40,42,30,30,254,60,314,19.10828025477707
12778,330455705080063,52,54,82,79,70,62,46,53,399,99,498,19.879518072289155
12779,330455705080064,59,90,103,80,67,47,43,21,446,64,510,12.549019607843137
12780,330455705080065,98,108,158,76,76,65,36,29,581,65,646,10.061919504643964
12781,330455705080066,72,98,99,97,68,36,28,15,470,43,513,8.382066276803119
12782,330455705080067,6,12,8,8,7,3,1,3,44,4,48,8.333333333333334
12783,330455705080069,53,84,84,101,90,86,59,68,498,127,625,20.32
12784,330455705080070,48,53,110,66,68,54,33,59,399,92,491,18.73727087576375
12785,330455705080071,55,54,86,94,85,93,58,52,467,110,577,19.064124783362217
12786,330455705080072,40,56,108,91,71,88,38,50,454,88,542,16.236162361623617
12787,330455705080073,37,61,107,81,90,102,66,81,478,147,625,23.52
12788,330455705080074,37,78,96,101,94,94,87,93,500,180,680,26.470588235294116
12789,330455705080075,64,96,110,113,108,124,105,113,615,218,833,26.17046818727491
12790,330455705080076,76,82,135,130,115,127,75,60,665,135,800,16.875
12791,330455705080077,60,80,74,75,64,53,23,11,406,34,440,7.7272727272727275
12792,330455705080078,83,118,120,86,119,76,46,34,602,80,682,11.730205278592376
12793,330455705080079,57,77,81,89,103,105,69,88,512,157,669,23.467862481315397
12794,330455705080080,60,54,100,95,86,103,86,115,498,201,699,28.755364806866954
12795,330455705080081,31,40,56,56,61,76,54,62,320,116,436,26.605504587155963
12796,330455705080082,41,58,103,82,91,97,65,92,472,157,629,24.96025437201908
12797,330455705080083,41,46,78,75,79,84,64,64,403,128,531,24.105461393596986
12798,330455705080084,56,90,111,125,122,106,73,95,610,168,778,21.59383033419023
12799,330455705080085,45,61,99,92,77,98,56,66,472,122,594,20.53872053872054
12800,330455705080086,54,89,56,44,42,27,14,9,312,23,335,6.865671641791045
12801,330455705080087,99,141,69,82,75,39,24,14,505,38,543,6.998158379373849
12802,330455705080088,96,165,114,73,80,40,17,11,568,28,596,4.697986577181208
12803,330455705080089,60,61,69,101,50,56,26,24,397,50,447,11.185682326621924
12804,330455705080090,83,118,139,121,108,70,54,38,639,92,731,12.585499316005471
12805,330455705080091,133,178,151,128,123,92,37,23,805,60,865,6.936416184971098
12806,330455705080092,74,65,118,112,71,85,43,50,525,93,618,15.048543689320388
12807,330455705080093,101,156,173,157,132,121,71,69,840,140,980,14.285714285714286
12808,330455705080094,18,21,44,34,28,42,34,42,187,76,263,28.897338403041825
12809,330455705080095,73,67,103,115,79,96,70,72,533,142,675,21.037037037037038
12810,330455705080096,24,28,66,58,48,64,55,60,288,115,403,28.535980148883375
12811,330455705080097,53,70,93,70,64,54,27,32,404,59,463,12.742980561555076
12812,330455705080101,0,0,14,32,33,13,9,1,92,10,102,9.803921568627452
12813,330455705080102,57,66,85,54,52,34,23,19,348,42,390,10.76923076923077
12814,330455705080103,103,104,91,89,64,44,23,16,495,39,534,7.303370786516854
12815,330455705080104,61,80,73,70,58,34,26,12,376,38,414,9.178743961352657
12816,330455705080105,189,196,186,170,130,92,68,43,963,111,1074,10.335195530726256
12817,330455705080106,76,70,73,83,58,37,25,13,397,38,435,8.735632183908047
12818,330455705080107,36,42,35,32,34,16,19,16,195,35,230,15.217391304347826
12819,330455705080108,23,18,11,10,20,10,5,7,92,12,104,11.538461538461538
12820,330455705080109,65,28,58,52,23,18,14,10,244,24,268,8.955223880597014
12821,330455705080110,73,73,72,80,74,55,24,26,427,50,477,10.482180293501049
12822,330455705080111,55,35,72,63,36,29,33,17,290,50,340,14.705882352941176
12823,330455705080112,79,149,151,150,104,68,45,30,701,75,776,9.664948453608247
12824,330455705080113,134,129,184,151,127,87,78,44,812,122,934,13.062098501070663
12825,330455705080114,106,149,146,163,81,79,44,36,724,80,804,9.950248756218905
12826,330455705080115,30,47,63,66,66,69,57,66,341,123,464,26.50862068965517
12827,330455705080116,45,63,123,71,68,47,30,33,417,63,480,13.125
12828,330455705080117,62,60,116,99,87,79,51,44,503,95,598,15.88628762541806
12829,330455705080118,33,37,41,24,30,31,20,23,196,43,239,17.99163179916318
12830,330455705080119,50,50,42,43,58,38,22,25,281,47,328,14.329268292682928
12831,330455705080120,45,81,100,107,116,90,51,43,539,94,633,14.849921011058452
12832,330455705080121,37,81,94,72,74,83,47,41,441,88,529,16.6351606805293
12833,330455705080122,50,96,107,95,93,78,60,44,519,104,623,16.693418940609952
12834,330455705080123,56,60,127,115,110,107,71,105,575,176,751,23.435419440745672
12835,330455705080124,31,46,88,49,54,67,26,49,335,75,410,18.29268292682927
12836,330455705080125,29,25,47,56,47,48,34,45,252,79,331,23.867069486404834
12837,330455705080126,38,73,81,67,102,75,82,96,436,178,614,28.990228013029316
12838,330455705080127,92,105,139,109,122,101,89,80,668,169,837,20.19115890083632
12839,330455705080128,59,50,43,60,21,20,9,7,253,16,269,5.947955390334572
12840,330455705080129,53,64,54,47,42,24,21,12,284,33,317,10.410094637223974
12841,330455705080130,200,194,163,142,121,84,43,20,904,63,967,6.514994829369183
12842,330455705080131,90,138,168,144,129,96,44,43,765,87,852,10.211267605633802
12843,330455705080132,56,66,82,127,106,84,47,27,521,74,595,12.436974789915967
12844,330455705080133,33,36,58,63,61,50,36,47,301,83,384,21.614583333333332
12845,330455705080135,87,89,60,90,68,52,16,22,446,38,484,7.851239669421488
12846,330455705080136,35,43,57,60,70,70,46,53,335,99,434,22.8110599078341
12847,330455705080137,86,95,120,91,58,53,32,19,503,51,554,9.205776173285198
12848,330455705080138,13,4,7,11,11,13,9,12,59,21,80,26.25
12849,330455705080139,51,42,87,54,41,41,26,12,316,38,354,10.734463276836157
12850,330455705080140,62,63,96,71,56,39,23,10,387,33,420,7.857142857142857
12851,330455705080141,39,35,45,33,23,21,13,8,196,21,217,9.67741935483871
12852,330455705080142,21,28,25,27,16,30,9,6,147,15,162,9.25925925925926
12853,330455705080143,25,27,29,32,15,13,8,3,141,11,152,7.2368421052631575
12854,330455705080144,87,86,70,71,60,25,11,8,399,19,418,4.545454545454546
12855,330455705080145,54,70,72,54,44,29,17,14,323,31,354,8.757062146892656
12856,330455705080146,14,22,18,14,11,10,6,3,89,9,98,9.183673469387756
12857,330455705080147,64,72,71,44,37,33,16,13,321,29,350,8.285714285714286
12858,330455705080148,74,87,63,61,29,28,21,9,342,30,372,8.064516129032258
12859,330455705080149,17,17,22,33,17,19,11,21,125,32,157,20.38216560509554
12860,330455705080150,78,69,98,69,74,60,20,16,448,36,484,7.43801652892562
12861,330455705080151,18,11,18,21,9,3,7,0,80,7,87,8.045977011494253
12862,330455705090001,23,23,64,61,53,61,50,42,285,92,377,24.40318302387268
12863,330455705090002,82,130,85,93,184,84,27,38,658,65,723,8.990318118948824
12864,330455705090003,43,88,90,86,117,109,87,86,533,173,706,24.504249291784703
12865,330455705090004,34,41,80,91,66,78,65,73,390,138,528,26.136363636363637
12866,330455705090005,28,35,57,55,52,60,48,44,287,92,379,24.274406332453825
12867,330455705090006,27,12,55,68,62,61,37,63,285,100,385,25.974025974025974
12868,330455705090007,32,33,68,81,66,80,65,66,360,131,491,26.680244399185337
12869,330455705090008,47,53,88,72,76,75,52,69,411,121,532,22.74436090225564
12870,330455705090009,231,223,59,377,248,26,7,4,1164,11,1175,0.9361702127659575
12871,330455705090010,30,33,77,73,75,79,48,108,367,156,523,29.82791586998088
12872,330455705090011,56,188,225,89,118,117,95,110,793,205,998,20.541082164328657
12873,330455705090012,17,32,52,29,36,36,25,17,202,42,244,17.21311475409836
12874,330455705090013,79,54,131,170,115,113,101,54,662,155,817,18.9718482252142
12875,330455705090014,47,57,102,102,106,114,86,60,528,146,674,21.661721068249257
12876,330455705090015,28,35,86,87,48,61,50,45,345,95,440,21.59090909090909
12877,330455705090016,35,32,76,54,53,64,37,66,314,103,417,24.700239808153476
12878,330455705090017,7,11,46,47,34,24,31,33,169,64,233,27.467811158798284
12879,330455705090018,13,8,60,54,32,34,25,41,201,66,267,24.719101123595507
12880,330455705090019,12,20,72,37,29,36,33,46,206,79,285,27.719298245614034
12881,330455705090020,36,72,167,120,108,122,95,150,625,245,870,28.160919540229884
12882,330455705090021,30,43,95,75,68,80,41,56,391,97,488,19.87704918032787
12883,330455705090022,31,46,122,106,92,85,62,83,482,145,627,23.125996810207337
12884,330455705090023,23,40,92,93,67,61,37,53,376,90,466,19.313304721030043
12885,330455705090024,26,27,73,76,52,66,51,48,320,99,419,23.627684964200476
12886,330455705090025,54,66,132,102,98,86,105,105,538,210,748,28.074866310160427
12887,330455705090026,40,39,70,76,67,70,74,63,362,137,499,27.45490981963928
12888,330455705090027,29,31,72,74,54,64,69,55,324,124,448,27.678571428571427
12889,330455705090028,55,52,89,97,99,90,43,60,482,103,585,17.60683760683761
12890,330455705090029,65,78,127,111,88,80,54,109,549,163,712,22.89325842696629
12891,330455705090030,50,68,96,113,109,111,46,49,547,95,642,14.797507788161994
12892,330455705090031,73,98,118,87,97,80,32,29,553,61,614,9.93485342019544
12893,330455705090032,14,17,19,19,18,15,15,9,102,24,126,19.047619047619047
12894,330455705090034,93,117,161,126,114,98,68,52,709,120,829,14.475271411338962
12895,330455705090035,37,55,82,67,52,34,23,25,327,48,375,12.8
12896,330455705090036,21,21,31,45,29,38,21,14,185,35,220,15.909090909090908
12897,330455705090037,41,59,77,82,79,67,51,38,405,89,494,18.016194331983804
12898,330455705090038,52,61,39,86,88,37,27,46,363,73,436,16.743119266055047
12899,330455705090039,31,29,87,79,48,78,53,77,352,130,482,26.970954356846473
12900,330455705090040,52,54,111,125,90,88,39,44,520,83,603,13.764510779436153
12901,330455705090041,27,29,73,88,77,63,46,78,357,124,481,25.77962577962578
12902,330455705090042,46,42,55,81,55,45,39,57,324,96,420,22.857142857142858
12903,330455705090043,34,48,57,74,67,84,60,90,364,150,514,29.182879377431906
12904,330455705090044,78,76,98,117,121,122,87,89,612,176,788,22.33502538071066
12905,330455705090045,51,47,73,92,70,93,96,70,426,166,592,28.04054054054054
12906,330455705090046,22,51,67,61,73,76,44,68,350,112,462,24.242424242424242
12907,330455705090047,30,53,65,65,56,70,51,64,339,115,454,25.330396475770925
12908,330455705090048,12,20,47,28,41,30,16,34,178,50,228,21.92982456140351
12909,330455705090049,43,42,74,88,73,79,69,106,399,175,574,30.48780487804878
12910,330455705090050,33,37,76,76,83,85,70,94,390,164,554,29.6028880866426
12911,330455705090051,30,38,93,86,72,77,50,114,396,164,560,29.285714285714285
12912,330455705090052,38,46,82,74,72,59,53,71,371,124,495,25.050505050505052
12913,330455705090053,18,35,65,84,62,70,46,37,334,83,417,19.904076738609113
12914,330455705090054,40,49,92,92,69,77,40,31,419,71,490,14.489795918367347
12915,330455705090055,23,47,87,96,71,70,44,66,394,110,504,21.825396825396826
12916,330455705090056,76,68,91,98,128,102,45,47,563,92,655,14.045801526717558
12917,330455705090057,22,17,58,57,65,50,39,44,269,83,352,23.579545454545453
12918,330455705090058,49,68,111,112,105,91,48,57,536,105,641,16.380655226209047
12919,330455705090059,80,70,216,225,131,102,73,98,824,171,995,17.185929648241206
12920,330455705090060,15,29,72,74,39,39,37,39,268,76,344,22.093023255813954
12921,330455705090061,37,48,75,71,57,58,39,62,346,101,447,22.595078299776286
12922,330455705090062,29,39,46,62,59,50,29,40,285,69,354,19.491525423728813
12923,330455705090063,17,25,68,87,41,68,40,52,306,92,398,23.115577889447238
12924,330455705090064,53,70,125,130,98,85,55,56,561,111,672,16.517857142857142
12925,330455705090065,40,59,122,88,89,112,93,101,510,194,704,27.556818181818183
12926,330455705090066,33,40,126,109,78,82,52,53,468,105,573,18.32460732984293
12927,330455705090067,38,37,92,95,63,72,78,96,397,174,571,30.472854640980735
12928,330455705090068,28,43,112,80,65,90,67,93,418,160,578,27.68166089965398
12929,330455705090069,25,39,54,46,82,66,58,95,312,153,465,32.903225806451616
12930,330455705090070,53,56,74,115,107,79,50,70,484,120,604,19.867549668874172
12931,330455705090071,31,45,78,93,79,105,52,68,431,120,551,21.77858439201452
12932,330455705090072,43,47,103,127,113,112,51,82,545,133,678,19.616519174041297
12933,330455705090073,33,44,65,82,58,58,35,71,340,106,446,23.766816143497756
12934,330455705090074,47,49,93,99,82,94,46,54,464,100,564,17.73049645390071
12935,330455705090075,20,42,60,52,61,57,35,38,292,73,365,20.0
12936,330455705090076,24,33,100,81,80,89,57,54,407,111,518,21.428571428571427
12937,330455705090077,16,36,64,72,57,65,57,65,310,122,432,28.24074074074074
12938,330455705090078,27,41,75,65,54,61,53,66,323,119,442,26.923076923076923
12939,330455705090079,31,42,79,80,54,86,38,60,372,98,470,20.851063829787233
12940,330455705090080,18,36,57,62,51,50,42,53,274,95,369,25.745257452574524
12941,330455705090081,35,43,101,94,57,87,55,72,417,127,544,23.345588235294116
12942,330455705090082,60,85,111,140,128,116,72,100,640,172,812,21.182266009852217
12943,330455705090083,41,66,111,112,112,83,71,89,525,160,685,23.357664233576642
12944,330455705090084,51,90,146,131,113,120,69,61,651,130,781,16.645326504481435
12945,330455705090085,27,47,66,57,65,72,55,78,334,133,467,28.4796573875803
12946,330455705090086,47,44,73,99,73,81,69,63,417,132,549,24.043715846994534
12947,330455705090087,28,38,85,102,63,65,46,44,381,90,471,19.10828025477707
12948,330455705090088,22,40,60,66,65,51,33,54,304,87,391,22.25063938618926
12949,330455705090089,42,47,106,101,80,84,56,51,460,107,567,18.871252204585538
12950,330455705090090,7,17,80,42,40,38,30,47,224,77,301,25.58139534883721
12951,330455705090091,22,25,65,67,62,55,42,52,296,94,390,24.102564102564102
12952,330455705090092,12,25,53,64,57,49,43,74,260,117,377,31.03448275862069
12953,330455705090093,32,32,92,85,54,68,47,87,363,134,497,26.961770623742456
12954,330455705090094,6,16,54,72,51,49,29,38,248,67,315,21.26984126984127
12955,330455705090095,44,43,131,127,87,80,65,90,512,155,667,23.238380809595203
12956,330455705090096,37,51,118,113,74,79,37,61,472,98,570,17.19298245614035
12957,330455705090097,7,23,79,69,52,48,22,31,278,53,331,16.012084592145015
12958,330455705090098,10,22,109,49,51,31,36,48,272,84,356,23.59550561797753
12959,330455705090099,23,38,116,88,74,99,67,69,438,136,574,23.693379790940767
12960,330455705090100,24,41,87,71,82,75,67,98,380,165,545,30.275229357798164
12961,330455705090101,22,25,115,85,77,67,59,84,391,143,534,26.779026217228463
12962,330455705090102,21,32,67,64,60,74,37,49,318,86,404,21.287128712871286
12963,330455705090103,17,24,65,64,48,53,59,68,271,127,398,31.90954773869347
12964,330455705090104,86,79,76,108,118,91,44,47,558,91,649,14.021571648690292
12965,330455705090105,24,35,91,84,62,80,56,55,376,111,487,22.792607802874745
12966,330455705090106,34,44,100,116,83,85,64,75,462,139,601,23.12811980033278
12967,330455705090107,34,65,138,98,96,78,50,59,509,109,618,17.637540453074433
12968,330455705090108,29,42,89,77,81,79,49,63,397,112,509,22.00392927308448
12969,330455705090109,67,50,56,106,102,58,50,42,439,92,531,17.325800376647834
12970,330455705090110,9,30,40,37,46,37,30,44,199,74,273,27.106227106227106
12971,330455705090111,92,88,116,159,163,122,72,77,740,149,889,16.76040494938133
12972,330455705090112,19,30,39,47,38,32,30,40,205,70,275,25.454545454545453
12973,330455705090113,72,78,92,123,131,111,57,57,607,114,721,15.811373092926491
12974,330455705090114,71,112,111,121,143,122,78,80,680,158,838,18.85441527446301
12975,330455705090115,74,81,182,247,144,117,75,81,845,156,1001,15.584415584415584
12976,330455705090116,40,38,66,56,65,58,45,46,323,91,414,21.980676328502415
12977,330455705090117,102,131,126,121,94,40,36,21,614,57,671,8.49478390461997
12978,330455705090118,127,155,189,113,109,71,43,35,764,78,842,9.263657957244655
12979,330455705090119,134,200,174,162,122,78,24,32,870,56,926,6.047516198704104
12980,330455705090120,198,190,238,146,120,66,49,36,958,85,1043,8.149568552253116
12981,330455705090121,83,87,89,70,52,21,11,18,402,29,431,6.728538283062645
12982,330455705090122,55,84,125,112,109,125,101,91,610,192,802,23.940149625935163
12983,330455705090123,58,90,101,98,106,86,49,60,539,109,648,16.820987654320987
12984,330455705090124,22,56,62,48,73,66,62,86,327,148,475,31.157894736842106
12985,330455705090125,18,27,57,42,52,45,29,41,241,70,311,22.508038585209004
12986,330455705090126,51,63,128,132,102,100,57,52,576,109,685,15.912408759124087
12987,330455705090127,47,39,86,111,85,103,52,22,471,74,545,13.577981651376147
12988,330455705090129,4,4,4,11,9,6,7,0,38,7,45,15.555555555555555
12989,330455705090130,61,55,101,85,82,79,56,43,463,99,562,17.615658362989326
12990,330455705090131,42,50,109,123,94,92,51,54,510,105,615,17.073170731707318
12991,330455705090132,22,26,78,58,51,49,34,48,284,82,366,22.404371584699454
12992,330455705090133,26,32,74,55,73,58,42,67,318,109,427,25.526932084309134
12993,330455705090134,36,39,118,69,85,89,46,58,436,104,540,19.25925925925926
12994,330455705090135,26,31,73,57,70,83,49,75,340,124,464,26.724137931034484
12995,330455705090136,25,47,134,87,76,92,65,92,461,157,618,25.40453074433657
12996,330455705090137,20,45,91,72,57,75,40,52,360,92,452,20.353982300884955
12997,330455705090138,39,38,73,77,66,66,52,31,359,83,442,18.778280542986426
12998,330455705090139,16,16,51,29,33,32,21,21,177,42,219,19.17808219178082
12999,330455705090140,7,15,32,21,31,28,17,23,134,40,174,22.988505747126435
13000,330455705090141,19,26,93,63,50,47,39,23,298,62,360,17.22222222222222
13001,330455705090142,32,40,108,87,96,75,54,72,438,126,564,22.340425531914892
13002,330455705090143,7,23,119,78,54,62,50,74,343,124,467,26.552462526766597
13003,330455705090144,13,21,62,54,39,49,36,44,238,80,318,25.157232704402517
13004,330455705090145,18,29,84,56,47,64,32,55,298,87,385,22.5974025974026
13005,330455705090146,3,13,67,45,26,25,29,18,179,47,226,20.79646017699115
13006,330455705090147,35,27,108,109,60,58,58,87,397,145,542,26.752767527675278
13007,330455705090148,18,29,78,63,53,64,49,86,305,135,440,30.681818181818183
13008,330455705090149,26,35,67,59,51,56,28,64,294,92,386,23.83419689119171
13009,330455705090150,46,76,135,123,97,83,59,74,560,133,693,19.19191919191919
13010,330455705090151,38,45,75,79,75,92,72,47,404,119,523,22.753346080305928
13011,330455705090152,13,15,64,64,48,52,37,38,256,75,331,22.658610271903324
13012,330455705090153,18,23,69,41,43,64,27,45,258,72,330,21.818181818181817
13013,330455705090154,54,37,77,99,92,93,78,65,452,143,595,24.03361344537815
13014,330455705090155,32,30,92,124,75,104,71,42,457,113,570,19.82456140350877
13015,330455705090156,38,22,61,93,55,77,69,64,346,133,479,27.76617954070981
13016,330455705090157,15,12,62,69,52,53,22,21,263,43,306,14.052287581699346
13017,330455705090158,26,26,70,58,53,54,46,56,287,102,389,26.22107969151671
13018,330455705090159,55,53,117,150,103,125,77,50,603,127,730,17.397260273972602
13019,330455705090160,17,26,69,50,58,87,36,58,307,94,401,23.44139650872818
13020,330455705090161,23,26,71,107,65,59,54,58,351,112,463,24.190064794816415
13021,330455705090162,38,57,99,88,87,103,48,56,472,104,576,18.055555555555557
13022,330455705090163,54,73,79,102,95,87,56,87,490,143,633,22.59083728278041
13023,330455705090164,44,50,78,110,82,85,57,102,449,159,608,26.151315789473685
13024,330455705090165,17,37,60,57,57,75,53,78,303,131,434,30.18433179723502
13025,330455705090166,34,45,67,66,73,77,53,51,362,104,466,22.317596566523605
13026,330455705090167,14,20,46,39,33,47,29,48,199,77,276,27.89855072463768
13027,330455705090168,74,60,79,143,93,101,63,91,550,154,704,21.875
13028,330455705090169,25,19,64,77,50,54,34,66,289,100,389,25.70694087403599
13029,330455705090170,7,11,17,16,27,19,11,5,97,16,113,14.15929203539823
13030,330455705090171,17,23,49,58,41,58,42,73,246,115,361,31.85595567867036
13031,330455705090172,36,29,81,102,67,69,50,54,384,104,488,21.311475409836067
13032,330455705090173,29,55,109,86,76,122,75,88,477,163,640,25.46875
13033,330455705090174,28,55,70,72,74,68,70,58,367,128,495,25.858585858585858
13034,330455705090175,34,37,36,69,61,62,43,31,299,74,373,19.839142091152816
13035,330455705090176,32,25,69,88,57,59,63,68,330,131,461,28.41648590021692
13036,330455705090177,33,49,57,48,38,56,14,14,281,28,309,9.06148867313916
13037,330455705090178,38,19,47,75,69,56,45,43,304,88,392,22.448979591836736
13038,330455705090179,60,43,113,116,77,135,81,36,544,117,661,17.700453857791224
13039,330455705090180,29,45,61,49,65,91,65,99,340,164,504,32.53968253968254
13040,330455705090181,11,24,46,21,38,39,40,45,179,85,264,32.196969696969695
13041,330455705090182,52,71,43,50,110,107,90,114,433,204,637,32.025117739403456
13042,330455705090183,51,40,71,75,57,84,55,66,378,121,499,24.248496993987978
13043,330455705090184,28,29,55,45,48,66,42,55,271,97,368,26.358695652173914
13044,330455705090185,21,20,60,61,50,45,45,44,257,89,346,25.722543352601157
13045,330455705090186,38,34,69,100,67,67,64,86,375,150,525,28.571428571428573
13046,330455705090187,35,47,76,58,73,124,86,88,413,174,587,29.642248722316864
13047,330455705090188,11,13,51,75,51,72,59,78,273,137,410,33.41463414634146
13048,330455705090189,45,32,83,93,74,63,73,84,390,157,547,28.70201096892139
13049,330455705090190,32,30,64,54,62,75,80,100,317,180,497,36.21730382293762
13050,330455705090191,29,51,53,49,37,47,41,55,266,96,362,26.519337016574585
13051,330455705090192,32,59,109,97,94,101,74,113,492,187,679,27.540500736377027
13052,330455705090193,18,23,117,105,57,76,64,88,396,152,548,27.73722627737226
13053,330455705090194,19,39,110,89,94,75,60,88,426,148,574,25.78397212543554
13054,330455705090195,8,23,67,49,39,41,39,67,227,106,333,31.83183183183183
13055,330455705090196,4,6,54,48,27,22,24,36,161,60,221,27.149321266968325
13056,330455705090197,36,44,63,47,68,59,65,55,317,120,437,27.45995423340961
13057,330455705090198,25,32,71,61,58,55,41,58,302,99,401,24.688279301745634
13058,330455705090199,27,35,77,65,73,53,46,62,330,108,438,24.65753424657534
13059,330455705090200,21,32,97,63,68,78,67,76,359,143,502,28.48605577689243
13060,330455705090201,24,52,130,93,87,81,91,99,467,190,657,28.919330289193304
13061,330455705090202,26,40,82,65,57,77,68,93,347,161,508,31.69291338582677
13062,330455705090203,15,23,79,51,48,55,37,90,271,127,398,31.90954773869347
13063,330455705090204,25,54,84,76,77,72,59,114,388,173,561,30.83778966131907
13064,330455705090205,11,12,90,96,47,46,34,45,302,79,381,20.73490813648294
13065,330455705090206,22,42,71,87,60,63,47,100,345,147,492,29.878048780487806
13066,330455705090207,38,29,68,71,58,71,58,87,335,145,480,30.208333333333332
13067,330455705090208,17,17,58,48,45,49,24,63,234,87,321,27.102803738317757
13068,330455705090209,39,35,64,76,74,58,64,106,346,170,516,32.945736434108525
13069,330455705090210,39,38,68,89,76,81,92,125,391,217,608,35.69078947368421
13070,330455705090211,23,40,62,52,61,69,56,104,307,160,467,34.261241970021416
13071,330455705090212,11,24,50,39,40,68,45,60,232,105,337,31.15727002967359
13072,330455705090213,18,23,67,62,49,54,69,68,273,137,410,33.41463414634146
13073,330455705090214,25,37,64,63,72,63,61,83,324,144,468,30.76923076923077
13074,330455705090215,47,45,102,99,106,89,87,121,488,208,696,29.885057471264368
13075,330455705090216,42,52,83,78,77,102,77,138,434,215,649,33.12788906009245
13076,330455705090217,18,19,66,65,56,57,63,45,281,108,389,27.763496143958868
13077,330455705090218,40,54,85,76,89,101,94,134,445,228,673,33.87815750371471
13078,330455705090219,21,16,68,81,57,63,59,90,306,149,455,32.747252747252745
13079,330455705090220,25,38,37,43,43,54,46,80,240,126,366,34.42622950819672
13080,330455705090221,31,38,71,70,69,76,60,117,355,177,532,33.27067669172932
13081,330455705090222,19,52,108,58,73,67,50,75,377,125,502,24.900398406374503
13082,330455705090223,11,37,73,60,44,70,56,81,295,137,432,31.712962962962962
13083,330455705090224,37,43,89,63,69,64,62,78,365,140,505,27.722772277227723
13084,330455705090225,9,34,53,31,41,52,42,50,220,92,312,29.487179487179485
13085,330455705090226,75,105,105,75,76,78,28,17,514,45,559,8.050089445438283
13086,330455705090227,88,107,111,101,93,74,24,26,574,50,624,8.012820512820513
13087,330455705090228,26,49,64,72,57,57,51,115,325,166,491,33.80855397148676
13088,330455705090229,48,66,105,135,83,110,68,95,547,163,710,22.95774647887324
13089,330455705090230,17,24,61,60,39,58,54,58,259,112,371,30.18867924528302
13090,330455705090231,30,39,122,88,76,72,59,83,427,142,569,24.956063268892795
13091,330455705090232,23,35,73,54,50,70,51,70,305,121,426,28.4037558685446
13092,330455705090233,15,18,59,49,31,51,46,55,223,101,324,31.17283950617284
13093,330455705090234,65,39,50,71,61,37,30,29,323,59,382,15.44502617801047
13094,330455705090235,27,39,82,67,81,85,62,116,381,178,559,31.842576028622542
13095,330455705090236,9,15,36,22,24,39,33,38,145,71,216,32.870370370370374
13096,330455705090237,20,33,57,50,59,71,53,88,290,141,431,32.71461716937355
13097,330455705090238,6,8,46,63,58,44,23,36,225,59,284,20.774647887323944
13098,330455705090239,11,18,82,63,38,59,31,45,271,76,347,21.902017291066283
13099,330455705090240,24,31,62,70,81,69,58,94,337,152,489,31.083844580777097
13100,330455705090241,26,41,79,87,58,91,61,110,382,171,553,30.922242314647377
13101,330455705090242,37,52,134,130,111,136,110,168,600,278,878,31.662870159453302
13102,330455705090243,20,8,33,32,34,25,17,40,152,57,209,27.272727272727273
13103,330455705090244,28,35,74,62,75,69,68,101,343,169,512,33.0078125
13104,330455705090245,17,34,53,54,65,53,50,76,276,126,402,31.34328358208955
13105,330455705090246,6,13,45,36,19,21,18,32,140,50,190,26.31578947368421
13106,330455705090247,28,30,63,61,53,52,49,97,287,146,433,33.71824480369515
13107,330455705090248,19,39,50,44,52,70,53,100,274,153,427,35.831381733021075
13108,330455705090249,6,7,44,43,27,29,26,43,156,69,225,30.666666666666668
13109,330455705090250,14,30,85,56,46,57,61,91,288,152,440,34.54545454545455
13110,330455705090251,7,6,62,53,19,33,25,38,180,63,243,25.925925925925927
13111,330455705090252,40,40,72,61,69,89,86,107,371,193,564,34.219858156028366
13112,330455705090253,27,37,89,54,48,61,43,65,316,108,424,25.471698113207548
13113,330455705090254,16,34,69,49,46,59,44,87,273,131,404,32.42574257425743
13114,330455705090255,18,32,61,63,77,51,45,72,302,117,419,27.9236276849642
13115,330455705090256,15,35,71,70,56,61,74,129,308,203,511,39.726027397260275
13116,330455705090257,28,39,79,77,69,81,83,121,373,204,577,35.35528596187175
13117,330455705090258,16,30,62,52,51,60,50,72,271,122,393,31.043256997455472
13118,330455705090259,39,75,99,91,102,119,85,103,525,188,713,26.367461430575034
13119,330455705090260,36,35,92,79,86,68,61,87,396,148,544,27.205882352941178
13120,330455705090261,6,17,106,62,34,44,43,40,269,83,352,23.579545454545453
13121,330455705090262,19,34,66,62,58,71,66,118,310,184,494,37.24696356275304
13122,330455705090263,26,39,95,98,91,98,76,111,447,187,634,29.49526813880126
13123,330455705090264,6,13,93,69,46,53,43,44,280,87,367,23.705722070844686
13124,330455705090265,13,23,48,48,59,44,43,78,235,121,356,33.98876404494382
13125,330455705090266,21,30,52,43,49,52,31,56,247,87,334,26.047904191616766
13126,330455705090267,21,35,87,64,62,67,54,76,336,130,466,27.896995708154506
13127,330455705090268,25,24,73,60,59,66,49,82,307,131,438,29.908675799086758
13128,330455705090269,12,21,68,71,60,72,45,69,304,114,418,27.272727272727273
13129,330455705090270,20,26,69,91,59,72,58,99,337,157,494,31.781376518218625
13130,330455705090271,7,10,63,59,53,51,34,52,243,86,329,26.13981762917933
13131,330455705090272,20,26,81,40,61,62,50,85,290,135,425,31.764705882352942
13132,330455705090273,25,26,77,85,63,68,58,73,344,131,475,27.57894736842105
13133,330455705090274,15,29,70,76,70,57,50,82,317,132,449,29.398663697104677
13134,330455705090275,14,40,68,70,67,59,55,95,318,150,468,32.05128205128205
13135,330455705090276,18,23,80,80,53,55,42,51,309,93,402,23.134328358208954
13136,330455705090277,33,45,59,72,62,65,63,72,336,135,471,28.662420382165607
13137,330455705090278,19,33,52,55,71,74,56,112,304,168,472,35.59322033898305
13138,330455705090279,14,36,103,78,79,80,61,82,390,143,533,26.829268292682926
13139,330455705090280,5,9,41,61,36,29,26,49,181,75,256,29.296875
13140,330455705090281,6,8,45,41,47,32,31,44,179,75,254,29.52755905511811
13141,330455705090282,20,24,52,59,64,65,51,69,284,120,404,29.702970297029704
13142,330455705090283,39,34,60,67,58,53,43,82,311,125,436,28.6697247706422
13143,330455705090284,29,46,56,78,67,59,46,36,335,82,417,19.664268585131893
13144,330455705090285,34,58,139,108,100,121,74,90,560,164,724,22.65193370165746
13145,330455705090286,27,46,73,63,62,89,56,78,360,134,494,27.125506072874494
13146,330455705090287,12,25,64,63,50,58,38,44,272,82,354,23.163841807909606
13147,330455705090288,9,9,23,27,22,29,29,25,119,54,173,31.213872832369944
13148,330455705090289,17,15,66,38,44,51,38,61,231,99,330,30.0
13149,330455705090290,23,28,52,49,50,41,25,24,243,49,292,16.78082191780822
13150,330455705090291,25,29,59,65,54,65,46,41,297,87,384,22.65625
13151,330455705090292,24,43,79,71,94,77,53,107,388,160,548,29.197080291970803
13152,330455705090293,26,22,67,74,52,54,46,46,295,92,387,23.772609819121445
13153,330455705090294,23,39,84,73,95,79,52,71,393,123,516,23.837209302325583
13154,330455705090295,3,19,48,38,36,43,25,39,187,64,251,25.49800796812749
13155,330455705090296,10,17,43,51,60,43,29,51,224,80,304,26.31578947368421
13156,330455705090297,44,58,97,102,87,82,71,68,470,139,609,22.824302134646963
13157,330455705090298,11,19,41,43,42,56,36,45,212,81,293,27.64505119453925
13158,330455705090299,21,41,48,63,69,71,57,98,313,155,468,33.11965811965812
13159,330455705090300,27,42,135,112,85,101,54,87,502,141,643,21.928460342146188
13160,330455705090301,43,46,137,76,83,98,50,48,483,98,581,16.867469879518072
13161,330455705090302,10,22,65,56,49,55,43,69,257,112,369,30.352303523035232
13162,330455705090303,19,36,92,74,85,72,53,53,378,106,484,21.90082644628099
13163,330455705090304,40,32,59,55,46,29,30,31,261,61,322,18.944099378881987
13164,330455705090305,78,91,130,96,52,47,12,9,494,21,515,4.077669902912621
13165,330455705090306,86,112,140,137,118,93,52,42,686,94,780,12.051282051282051
13166,330455705090307,43,61,92,88,96,97,62,98,477,160,637,25.11773940345369
13167,330455705090308,11,16,42,43,20,39,49,37,171,86,257,33.463035019455255
13168,330455705090309,27,47,86,103,81,76,53,55,420,108,528,20.454545454545453
13169,330455705090310,30,50,80,59,64,45,30,47,328,77,405,19.012345679012345
13170,330455705090311,33,32,84,73,63,66,42,45,351,87,438,19.863013698630137
13171,330455705090312,17,11,46,37,25,38,26,39,174,65,239,27.196652719665273
13172,330455705090313,13,24,64,59,34,55,42,68,249,110,359,30.64066852367688
13173,330455705090314,30,27,54,68,47,51,50,65,277,115,392,29.336734693877553
13174,330455705090315,18,14,53,55,32,44,41,49,216,90,306,29.41176470588235
13175,330455705090316,23,19,65,67,58,62,46,60,294,106,400,26.5
13176,330455705090317,30,29,44,54,58,67,47,91,282,138,420,32.857142857142854
13177,330455705090318,17,38,54,45,53,59,58,71,266,129,395,32.65822784810127
13178,330455705090319,14,32,72,62,45,58,52,78,283,130,413,31.476997578692494
13179,330455705090320,12,10,41,48,29,39,31,31,179,62,241,25.726141078838175
13180,330455705090321,9,16,74,77,50,48,51,47,274,98,372,26.344086021505376
13181,330455705090323,29,28,82,67,64,90,72,83,360,155,515,30.097087378640776
13182,330455705090324,25,58,76,79,79,91,67,82,408,149,557,26.75044883303411
13183,330455705090325,23,36,103,86,71,96,75,94,415,169,584,28.938356164383563
13184,330455705090326,14,19,48,47,40,46,38,43,214,81,295,27.45762711864407
13185,330455705090327,49,66,114,121,111,110,102,129,571,231,802,28.802992518703242
13186,330455705090328,58,86,143,149,134,126,103,116,696,219,915,23.934426229508198
13187,330455705090329,39,52,66,60,73,51,26,33,341,59,400,14.75
13188,330455705090330,38,50,103,62,76,65,34,34,394,68,462,14.718614718614718
13189,330455705090331,14,23,68,59,55,47,50,63,266,113,379,29.815303430079155
13190,330455705090332,37,55,109,103,89,109,66,104,502,170,672,25.297619047619047
13191,330455705090333,26,31,53,62,62,65,53,84,299,137,436,31.422018348623855
13192,330455705090334,24,25,47,40,61,42,40,45,239,85,324,26.234567901234566
13193,330455705090335,35,40,99,98,90,99,78,144,461,222,683,32.503660322108345
13194,330455705090336,17,39,75,77,49,68,75,91,325,166,491,33.80855397148676
13195,330455705090337,34,34,81,89,72,52,46,56,362,102,464,21.982758620689655
13196,330455705090338,22,36,80,65,70,83,46,59,356,105,461,22.7765726681128
13197,330455705090339,18,32,61,64,67,60,46,93,302,139,441,31.519274376417233
13198,330455705090340,15,34,55,35,63,54,61,77,256,138,394,35.025380710659896
13199,330455705090341,11,24,68,63,49,62,57,88,277,145,422,34.360189573459714
13200,330455705090342,28,40,102,70,81,95,61,103,416,164,580,28.275862068965516
13201,330455705090343,31,39,92,73,70,85,68,95,390,163,553,29.475587703435806
13202,330455705090344,15,29,65,51,62,69,48,107,291,155,446,34.75336322869955
13203,330455705090345,15,20,42,44,48,51,46,62,220,108,328,32.926829268292686
13204,330455705090346,14,20,36,67,51,47,40,68,235,108,343,31.486880466472304
13205,330455705090347,14,24,68,60,48,53,56,55,267,111,378,29.365079365079364
13206,330455705090349,137,174,216,181,141,119,83,49,968,132,1100,12.0
13207,330455705090350,8,25,40,49,41,47,43,43,210,86,296,29.054054054054053
13208,330455705090351,12,16,31,32,20,18,19,41,129,60,189,31.746031746031747
13209,330455705090352,10,20,41,40,44,55,42,71,210,113,323,34.98452012383901
13210,330455705090353,8,13,57,73,36,42,47,61,229,108,337,32.047477744807125
13211,330455705090354,14,19,55,54,53,35,51,79,230,130,360,36.111111111111114
13212,330455705090355,24,34,105,107,78,80,77,125,428,202,630,32.06349206349206
13213,330455705090356,29,47,75,78,83,67,49,80,379,129,508,25.393700787401574
13214,330455705090357,34,33,63,75,67,79,57,129,351,186,537,34.63687150837989
13215,330455705090358,28,59,107,76,81,111,82,97,462,179,641,27.92511700468019
13216,330455705090359,42,37,101,107,81,63,63,110,431,173,604,28.642384105960264
13217,330455705090360,33,38,58,76,85,63,38,51,353,89,442,20.13574660633484
13218,330455705090361,17,15,38,43,28,37,31,42,178,73,251,29.083665338645417
13219,330455705090362,32,40,57,89,96,78,45,105,392,150,542,27.675276752767527
13220,330455705090363,50,69,94,98,82,102,83,73,495,156,651,23.963133640552996
13221,330455705090364,41,24,85,86,81,69,74,96,386,170,556,30.575539568345324
13222,330455705090365,63,65,115,119,109,90,63,57,561,120,681,17.621145374449338
13223,330455705090366,64,55,85,82,106,100,48,35,492,83,575,14.434782608695652
13224,330455705090367,54,53,96,118,103,91,97,92,515,189,704,26.84659090909091
13225,330455705090368,29,30,71,69,57,82,57,66,338,123,461,26.68112798264642
13226,330455705090369,27,41,47,49,77,61,42,61,302,103,405,25.432098765432098
13227,330455705090370,21,25,52,48,59,66,40,46,271,86,357,24.089635854341736
13228,330455705090371,17,44,72,78,49,72,44,74,332,118,450,26.22222222222222
13229,330455705090372,45,40,90,81,80,97,66,71,433,137,570,24.035087719298247
13230,330455705090373,19,33,64,51,55,56,37,54,278,91,369,24.661246612466126
13231,330455705090374,50,58,100,91,103,114,81,108,516,189,705,26.80851063829787
13232,330455705090375,29,28,45,39,52,49,32,65,242,97,339,28.613569321533923
13233,330455705090376,37,49,95,93,101,75,73,74,450,147,597,24.623115577889447
13234,330455705090377,37,33,69,59,53,64,54,92,315,146,461,31.670281995661604
13235,330455705090378,60,85,108,115,153,127,107,132,648,239,887,26.944757609921083
13236,330455705090379,20,29,68,62,69,79,64,92,327,156,483,32.298136645962735
13237,330455705090380,28,34,61,72,63,69,61,97,327,158,485,32.577319587628864
13238,330455705090381,34,41,78,89,71,65,60,122,378,182,560,32.5
13239,330455705090382,11,31,27,46,36,25,23,25,176,48,224,21.428571428571427
13240,330455705090383,42,34,69,80,73,84,67,50,382,117,499,23.44689378757515
13241,330455705090384,28,32,75,56,42,76,47,45,309,92,401,22.942643391521198
13242,330455705090385,34,31,54,59,55,43,41,51,276,92,368,25.0
13243,330455705090386,31,51,51,62,55,63,47,67,313,114,427,26.697892271662763
13244,330455705090387,51,68,82,49,104,92,53,92,446,145,591,24.534686971235196
13245,330455705090388,85,92,128,141,128,119,94,71,693,165,858,19.23076923076923
13246,330455705090389,35,53,79,85,57,80,46,41,389,87,476,18.277310924369747
13247,330455705090390,45,59,65,86,75,71,73,41,401,114,515,22.135922330097088
13248,330455705090391,34,59,51,68,75,70,45,47,357,92,449,20.489977728285076
13249,330455705090392,37,59,77,73,85,74,62,43,405,105,510,20.58823529411765
13250,330455705090393,44,37,103,104,85,91,83,139,464,222,686,32.36151603498542
13251,330455705090394,36,40,108,77,92,97,65,92,450,157,607,25.86490939044481
13252,330455705090395,47,38,62,69,55,55,51,41,326,92,418,22.00956937799043
13253,330455705090396,25,36,72,54,65,87,52,62,339,114,453,25.165562913907284
13254,330455705090397,71,101,107,127,138,103,69,99,647,168,815,20.613496932515336
13255,330455705090398,74,92,103,126,105,138,108,120,638,228,866,26.32794457274827
13256,330455705090399,51,77,92,126,122,96,73,55,564,128,692,18.497109826589597
13257,330455705090400,40,55,91,106,104,69,65,33,465,98,563,17.406749555950267
13258,330455705090401,67,57,87,67,99,120,80,82,497,162,659,24.582701062215477
13259,330455705090402,51,58,63,56,80,83,75,100,391,175,566,30.918727915194346
13260,330455705090403,58,75,115,130,138,127,61,88,643,149,792,18.81313131313131
13261,330455705090404,64,56,135,168,131,125,74,75,679,149,828,17.995169082125603
13262,330455705090405,36,55,59,58,87,84,60,91,379,151,530,28.49056603773585
13263,330455705090406,19,26,70,71,43,52,29,48,281,77,358,21.508379888268156
13264,330455705090407,17,33,55,60,52,46,28,54,263,82,345,23.768115942028984
13265,330455705090408,40,62,56,75,77,80,54,74,390,128,518,24.71042471042471
13266,330455705090409,36,55,68,66,94,72,48,56,391,104,495,21.01010101010101
13267,330455705090410,47,74,93,87,105,69,61,66,475,127,602,21.096345514950166
13268,330455705090411,36,64,108,89,82,71,45,73,450,118,568,20.774647887323944
13269,330455705090412,38,50,95,83,84,93,54,58,443,112,555,20.18018018018018
13270,330455705090413,29,24,67,60,29,60,25,50,269,75,344,21.802325581395348
13271,330455705090414,44,46,135,116,97,105,66,92,543,158,701,22.53922967189729
13272,330455705090415,49,85,119,77,111,128,59,64,569,123,692,17.77456647398844
13273,330455705090416,31,40,43,63,56,45,39,69,278,108,386,27.979274611398964
13274,330455705090417,39,50,61,82,69,67,54,62,368,116,484,23.96694214876033
13275,330455705090418,58,83,102,102,107,113,108,129,565,237,802,29.551122194513717
13276,330455705090419,67,97,102,114,121,117,82,112,618,194,812,23.891625615763548
13277,330455705090420,34,52,111,86,80,79,40,69,442,109,551,19.782214156079856
13278,330455705090421,30,29,137,89,73,79,54,58,437,112,549,20.40072859744991
13279,330455705090422,40,57,130,127,97,82,86,65,533,151,684,22.076023391812864
13280,330455705090423,37,48,63,71,61,86,46,41,366,87,453,19.205298013245034
13281,330455705090424,197,209,235,222,158,128,50,46,1149,96,1245,7.710843373493976
13282,330455705090425,25,27,51,36,50,44,22,16,233,38,271,14.022140221402214
13283,330455705090426,14,37,41,37,59,33,32,25,221,57,278,20.503597122302157
13284,330455705090427,57,63,83,109,86,85,64,104,483,168,651,25.806451612903224
13285,330455705090428,31,55,92,82,78,85,59,83,423,142,565,25.13274336283186
13286,330455705090429,43,62,80,81,103,84,50,72,453,122,575,21.217391304347824
13287,330455705090430,81,91,193,150,118,170,95,48,803,143,946,15.116279069767442
13288,330455705090431,20,38,68,53,62,70,56,70,311,126,437,28.83295194508009
13289,330455705090432,10,13,41,26,34,33,20,37,157,57,214,26.635514018691588
13290,330455705090433,25,70,69,54,95,82,61,97,395,158,553,28.571428571428573
13291,330455705090434,43,50,85,101,75,107,47,40,461,87,548,15.875912408759124
13292,330455705090435,35,34,68,49,36,55,29,45,277,74,351,21.08262108262108
13293,330455705090436,20,40,53,60,64,53,52,86,290,138,428,32.242990654205606
13294,330455705090437,39,51,60,93,73,83,75,51,399,126,525,24.0
13295,330455705090438,16,41,50,34,54,62,54,35,257,89,346,25.722543352601157
13296,330455705090439,59,62,105,105,84,106,81,76,521,157,678,23.156342182890857
13297,330455705090441,51,49,73,65,78,82,54,29,398,83,481,17.255717255717254
13298,330455705090442,12,21,26,26,18,30,9,9,133,18,151,11.920529801324504
13299,330455705090443,25,56,51,57,68,67,48,35,324,83,407,20.393120393120395
13300,330455705090444,120,140,158,90,83,67,29,21,658,50,708,7.062146892655368
13301,330455705090445,37,38,57,43,58,55,24,21,288,45,333,13.513513513513514
13302,330455705090446,229,273,260,224,178,120,74,66,1284,140,1424,9.831460674157304
13303,330455705090447,133,134,107,102,85,50,33,29,611,62,673,9.212481426448736
13304,330455705090448,9,14,71,66,36,52,32,55,248,87,335,25.970149253731343
13305,330455705090449,30,31,103,90,77,64,32,56,395,88,483,18.21946169772257
13306,330455705090450,27,35,58,97,69,89,49,65,375,114,489,23.312883435582823
13307,330455705090451,34,31,42,58,48,40,44,32,253,76,329,23.10030395136778
13308,330455705090452,35,47,86,86,93,103,42,48,450,90,540,16.666666666666668
13309,330455705090453,22,30,91,96,92,88,64,73,419,137,556,24.640287769784173
13310,330455705090454,151,222,222,172,137,71,55,29,975,84,1059,7.932011331444759
13311,330455705090455,198,222,253,185,126,76,34,23,1060,57,1117,5.102954341987466
13312,330455705090456,80,51,102,180,111,63,40,32,587,72,659,10.925644916540213
13313,330455705090457,33,44,117,82,76,62,36,71,414,107,521,20.53742802303263
13314,330455705090458,45,71,101,67,90,112,57,53,486,110,596,18.456375838926174
13315,330455705090459,81,109,139,137,129,118,74,78,713,152,865,17.572254335260116
13316,330455705090460,23,39,115,89,60,87,64,95,413,159,572,27.797202797202797
13317,330455705090461,65,72,115,110,114,92,63,73,568,136,704,19.318181818181817
13318,330455705090462,64,33,57,125,101,63,28,21,443,49,492,9.959349593495935
13319,330455705090463,50,41,66,91,81,47,17,27,376,44,420,10.476190476190476
13320,330455705090464,105,94,142,91,57,55,29,12,544,41,585,7.0085470085470085
13321,330455705090465,8,9,65,40,24,25,28,36,171,64,235,27.23404255319149
13322,330455705090466,57,31,78,137,79,64,47,39,446,86,532,16.165413533834588
13323,330455705090467,63,43,44,85,67,40,8,14,342,22,364,6.043956043956044
13324,330455705090468,15,31,49,41,41,54,42,63,231,105,336,31.25
13325,330455705090469,35,19,71,68,48,32,33,23,273,56,329,17.02127659574468
13326,330455705090470,24,38,48,73,62,46,50,47,291,97,388,25.0
13327,330455705090471,22,38,53,60,48,57,45,27,278,72,350,20.571428571428573
13328,330455705090472,2,7,17,23,17,20,21,27,86,48,134,35.82089552238806
13329,330455705090473,21,9,22,33,16,8,3,6,109,9,118,7.627118644067797
13330,330455705090474,29,17,39,87,46,31,10,13,249,23,272,8.455882352941176
13331,330455705090475,33,32,50,57,47,43,30,36,262,66,328,20.121951219512194
13332,330455705090476,24,15,50,51,37,40,32,63,217,95,312,30.44871794871795
13333,330455705090477,17,15,36,33,35,49,15,30,185,45,230,19.565217391304348
13334,330455705090478,22,27,29,33,49,32,14,14,192,28,220,12.727272727272727
13335,330455705090479,17,19,22,30,43,38,37,46,169,83,252,32.93650793650794
13336,330455705090480,33,23,69,117,76,59,75,99,377,174,551,31.57894736842105
13337,330455705090481,89,40,86,154,90,66,25,22,525,47,572,8.216783216783217
13338,330455705090482,82,60,103,179,95,70,26,29,589,55,644,8.540372670807454
13339,330455705090483,74,51,82,147,94,48,27,14,496,41,537,7.635009310986964
13340,330455705090484,77,52,63,144,100,51,29,23,487,52,539,9.647495361781075
13341,330455705090485,22,23,59,69,60,50,27,52,283,79,362,21.823204419889503
13342,330455705090486,23,40,66,63,66,46,48,43,304,91,395,23.037974683544302
13343,330455705090487,7,9,18,8,9,9,1,2,60,3,63,4.761904761904762
13344,330455705090488,132,129,170,139,94,53,27,14,717,41,758,5.408970976253298
13345,330455705090489,9,26,20,26,36,24,15,16,141,31,172,18.023255813953487
13346,330455705090498,1,6,10,2,7,4,7,2,30,9,39,23.076923076923077
13347,330455705100001,23,39,40,38,53,56,22,43,249,65,314,20.70063694267516
13348,330455705100002,23,32,71,64,55,63,49,96,308,145,453,32.00883002207505
13349,330455705100003,177,240,234,214,163,150,65,46,1178,111,1289,8.61132660977502
13350,330455705100004,25,32,77,43,51,72,75,66,300,141,441,31.972789115646258
13351,330455705100005,22,34,20,25,54,46,77,73,201,150,351,42.73504273504273
13352,330455705100006,25,21,50,48,45,66,44,78,255,122,377,32.36074270557029
13353,330455705100007,17,15,17,32,27,14,8,5,122,13,135,9.62962962962963
13354,330455705100008,18,45,66,64,67,82,61,87,342,148,490,30.20408163265306
13355,330455705100009,11,21,39,34,32,44,37,46,181,83,264,31.439393939393938
13356,330455705100010,44,61,111,103,82,99,78,102,500,180,680,26.470588235294116
13357,330455705100011,16,26,67,52,49,51,33,67,261,100,361,27.700831024930746
13358,330455705100012,31,51,60,68,66,84,92,106,360,198,558,35.483870967741936
13359,330455705100013,21,19,44,34,47,60,38,67,225,105,330,31.818181818181817
13360,330455705100014,6,7,39,41,28,14,26,23,135,49,184,26.630434782608695
13361,330455705100015,15,26,69,80,50,72,66,89,312,155,467,33.190578158458244
13362,330455705100016,7,22,46,50,33,41,29,41,199,70,269,26.022304832713754
13363,330455705100017,24,32,65,57,52,68,64,84,298,148,446,33.18385650224215
13364,330455705100018,60,55,102,72,101,27,9,6,417,15,432,3.4722222222222223
13365,330455705100019,12,18,64,35,39,53,34,46,221,80,301,26.578073089700997
13366,330455705100020,16,19,33,42,30,31,41,36,171,77,248,31.048387096774192
13367,330455705100021,2,3,32,28,20,30,20,32,115,52,167,31.137724550898202
13368,330455705100022,24,48,95,81,86,98,91,110,432,201,633,31.753554502369667
13369,330455705100023,15,32,38,45,51,48,53,68,229,121,350,34.57142857142857
13370,330455705100024,7,13,31,22,25,19,12,20,117,32,149,21.476510067114095
13371,330455705100025,23,25,70,65,53,65,63,58,301,121,422,28.672985781990523
13372,330455705100026,16,32,47,53,49,67,64,72,264,136,400,34.0
13373,330455705100027,14,15,40,37,42,29,37,39,177,76,253,30.039525691699605
13374,330455705100028,34,33,63,65,56,74,74,89,325,163,488,33.40163934426229
13375,330455705100029,21,11,30,53,29,31,47,53,175,100,275,36.36363636363637
13376,330455705100030,13,29,51,31,46,57,47,66,227,113,340,33.23529411764706
13377,330455705100031,14,17,54,47,43,54,61,70,229,131,360,36.388888888888886
13378,330455705100032,19,28,49,31,36,54,50,80,217,130,347,37.46397694524496
13379,330455705100033,10,18,28,24,22,31,37,36,133,73,206,35.43689320388349
13380,330455705100034,12,30,35,36,43,49,42,80,205,122,327,37.308868501529055
13381,330455705100035,6,11,55,49,37,40,45,36,198,81,279,29.032258064516128
13382,330455705100036,5,14,41,31,16,21,32,20,128,52,180,28.88888888888889
13383,330455705100037,13,25,57,40,50,49,42,61,234,103,337,30.56379821958457
13384,330455705100038,17,29,62,66,52,68,59,59,294,118,412,28.640776699029125
13385,330455705100039,10,4,22,19,19,19,25,35,93,60,153,39.21568627450981
13386,330455705100040,7,31,52,44,41,48,40,35,223,75,298,25.16778523489933
13387,330455705100041,16,32,59,51,57,43,43,48,258,91,349,26.074498567335244
13388,330455705100042,3,13,48,37,41,44,42,52,186,94,280,33.57142857142857
13389,330455705100043,48,68,50,87,92,48,30,58,393,88,481,18.295218295218294
13390,330455705100044,21,71,21,38,77,10,3,6,238,9,247,3.6437246963562755
13391,330455705100045,18,30,22,13,49,29,24,50,161,74,235,31.48936170212766
13392,330455705100046,12,15,29,52,32,30,27,39,170,66,236,27.966101694915253
13393,330455705100047,23,33,55,46,56,49,63,96,262,159,421,37.76722090261283
13394,330455705100048,21,22,59,41,42,57,40,64,242,104,346,30.057803468208093
13395,330455705100049,20,24,51,64,48,40,33,56,247,89,336,26.488095238095237
13396,330455705100050,18,23,48,54,61,45,43,65,249,108,357,30.252100840336134
13397,330455705100051,7,15,43,28,36,39,31,33,168,64,232,27.586206896551722
13398,330455705100052,14,23,26,29,38,33,32,76,163,108,271,39.85239852398524
13399,330455705100053,12,24,59,50,49,47,46,58,241,104,345,30.144927536231883
13400,330455705100054,14,27,43,51,43,56,59,60,234,119,353,33.711048158640224
13401,330455705100055,9,19,32,26,34,38,30,45,158,75,233,32.18884120171674
13402,330455705100056,26,24,49,64,49,61,49,68,273,117,390,30.0
13403,330455705100057,21,37,74,63,50,72,54,94,317,148,465,31.827956989247312
13404,330455705100058,11,13,77,39,31,44,51,72,215,123,338,36.3905325443787
13405,330455705100059,14,16,47,40,38,38,30,41,193,71,264,26.893939393939394
13406,330455705100060,12,22,41,45,38,58,43,55,216,98,314,31.21019108280255
13407,330455705100061,21,31,64,43,49,73,42,71,281,113,394,28.68020304568528
13408,330455705100062,25,30,83,50,68,63,71,58,319,129,448,28.794642857142858
13409,330455705100063,9,16,16,22,21,31,26,45,115,71,186,38.17204301075269
13410,330455705100064,15,23,50,54,47,57,38,67,246,105,351,29.914529914529915
13411,330455705100065,25,42,81,59,70,73,76,120,350,196,546,35.8974358974359
13412,330455705100066,6,11,34,25,26,39,37,46,141,83,224,37.05357142857143
13413,330455705100067,15,28,61,54,44,65,33,60,267,93,360,25.833333333333332
13414,330455705100068,5,16,23,23,35,33,38,54,135,92,227,40.52863436123348
13415,330455705100069,7,13,26,28,32,42,34,38,148,72,220,32.72727272727273
13416,330455705100070,19,22,41,49,42,42,41,33,215,74,289,25.60553633217993
13417,330455705100071,22,24,61,28,34,50,44,61,219,105,324,32.407407407407405
13418,330455705100072,8,18,45,46,32,49,52,60,198,112,310,36.12903225806452
13419,330455705100073,8,21,44,31,47,50,50,54,201,104,305,34.09836065573771
13420,330455705100074,16,18,74,43,54,67,55,79,272,134,406,33.004926108374384
13421,330455705100075,11,19,50,38,32,53,30,75,203,105,308,34.09090909090909
13422,330455705100076,19,26,73,61,51,76,61,105,306,166,472,35.16949152542373
13423,330455705100077,6,17,33,24,29,35,25,39,144,64,208,30.76923076923077
13424,330455705100078,12,18,56,49,34,56,40,70,225,110,335,32.83582089552239
13425,330455705100079,7,31,82,53,57,50,30,56,280,86,366,23.497267759562842
13426,330455705100080,11,30,60,33,38,69,58,75,241,133,374,35.56149732620321
13427,330455705100081,21,27,76,60,69,47,31,30,300,61,361,16.897506925207757
13428,330455705100082,18,33,86,61,61,48,30,35,307,65,372,17.473118279569892
13429,330455705100083,14,19,34,37,33,43,29,33,180,62,242,25.619834710743802
13430,330455705100084,17,30,67,43,53,48,40,90,258,130,388,33.50515463917526
13431,330455705100085,24,41,124,62,74,99,72,98,424,170,594,28.61952861952862
13432,330455705100086,12,24,79,58,75,56,54,77,304,131,435,30.114942528735632
13433,330455705100087,23,28,45,45,43,62,42,70,246,112,358,31.28491620111732
13434,330455705100088,2,17,29,28,22,28,29,33,126,62,188,32.97872340425532
13435,330455705100089,17,30,61,53,60,66,56,112,287,168,455,36.92307692307692
13436,330455705100090,22,28,76,62,56,72,73,101,316,174,490,35.51020408163265
13437,330455705100091,14,21,47,30,40,40,34,53,192,87,279,31.182795698924732
13438,330455705100092,14,21,30,31,48,47,39,68,191,107,298,35.90604026845637
13439,330455705100093,19,17,46,47,68,74,71,92,271,163,434,37.55760368663594
13440,330455705100094,12,31,42,36,47,34,28,36,202,64,266,24.06015037593985
13441,330455705100095,15,31,40,34,29,44,31,43,193,74,267,27.715355805243444
13442,330455705100096,18,20,72,45,31,67,40,72,253,112,365,30.684931506849313
13443,330455705100097,12,32,49,44,55,62,56,86,254,142,396,35.85858585858586
13444,330455705100098,26,37,82,65,61,67,85,116,338,201,539,37.291280148423006
13445,330455705100099,16,16,39,50,44,42,55,92,207,147,354,41.52542372881356
13446,330455705100100,40,55,84,62,82,97,85,61,420,146,566,25.795053003533567
13447,330455705100101,25,18,40,68,41,51,31,19,243,50,293,17.064846416382252
13448,330455705100102,29,31,33,45,43,42,37,43,223,80,303,26.402640264026402
13449,330455705100103,27,40,68,59,89,69,53,65,352,118,470,25.106382978723403
13450,330455705100104,22,33,56,47,45,50,29,67,253,96,349,27.507163323782233
13451,330455705100105,7,10,52,35,36,33,39,46,173,85,258,32.945736434108525
13452,330455705100106,37,36,81,58,82,96,79,115,390,194,584,33.21917808219178
13453,330455705100107,11,8,36,49,35,33,33,47,172,80,252,31.746031746031747
13454,330455705100108,22,29,85,67,58,80,58,84,341,142,483,29.399585921325052
13455,330455705100109,9,10,46,40,24,41,39,62,170,101,271,37.269372693726936
13456,330455705100110,12,17,36,39,39,47,38,82,190,120,310,38.70967741935484
13457,330455705100111,9,20,43,30,34,42,9,29,178,38,216,17.59259259259259
13458,330455705100112,6,6,28,26,18,30,34,29,114,63,177,35.59322033898305
13459,330455705100113,27,36,68,79,70,81,48,64,361,112,473,23.67864693446089
13460,330455705100114,23,27,78,66,57,75,65,102,326,167,493,33.87423935091278
13461,330455705100115,8,22,42,43,32,45,36,42,192,78,270,28.88888888888889
13462,330455705100116,8,12,30,23,27,45,37,55,145,92,237,38.81856540084388
13463,330455705100117,12,13,64,27,35,52,33,44,203,77,280,27.5
13464,330455705100118,10,19,56,40,30,50,31,41,205,72,277,25.9927797833935
13465,330455705100119,10,16,55,48,41,39,30,39,209,69,278,24.820143884892087
13466,330455705100120,19,40,79,47,61,91,69,118,337,187,524,35.68702290076336
13467,330455705100121,21,26,51,54,30,74,57,54,256,111,367,30.245231607629428
13468,330455705100122,8,15,19,18,23,26,32,55,109,87,196,44.38775510204081
13469,330455705100123,21,19,59,45,50,62,71,118,256,189,445,42.47191011235955
13470,330455705100124,12,17,17,30,27,21,11,11,124,22,146,15.068493150684931
13471,330455705100125,34,34,40,60,72,66,54,84,306,138,444,31.08108108108108
13472,330455705100126,60,48,79,105,109,104,85,76,505,161,666,24.174174174174173
13473,330455705100127,31,35,59,41,61,64,72,78,291,150,441,34.01360544217687
13474,330455705100128,18,27,55,31,36,56,49,73,223,122,345,35.36231884057971
13475,330455705100129,16,21,42,37,44,44,36,60,204,96,300,32.0
13476,330455705100130,13,24,40,49,35,55,35,57,216,92,308,29.87012987012987
13477,330455705100131,35,44,64,87,77,89,68,122,396,190,586,32.42320819112628
13478,330455705100132,13,12,29,35,35,52,56,71,176,127,303,41.914191419141915
13479,330455705100133,14,18,50,33,45,41,30,39,201,69,270,25.555555555555557
13480,330455705100134,17,22,68,52,47,74,56,82,280,138,418,33.014354066985646
13481,330455705100135,19,29,50,47,47,46,61,84,238,145,383,37.85900783289817
13482,330455705100136,25,31,74,68,71,74,67,137,343,204,547,37.29433272394881
13483,330455705100137,22,29,52,55,62,64,67,135,284,202,486,41.56378600823045
13484,330455705100138,9,14,53,30,16,47,58,61,169,119,288,41.31944444444444
13485,330455705100139,8,23,59,38,46,51,41,63,225,104,329,31.61094224924012
13486,330455705100140,7,24,45,41,38,31,36,46,186,82,268,30.597014925373134
13487,330455705100141,14,26,68,53,40,42,39,58,243,97,340,28.529411764705884
13488,330455705100142,30,44,54,49,60,69,63,96,306,159,465,34.193548387096776
13489,330455705100143,21,25,50,37,53,67,56,87,253,143,396,36.111111111111114
13490,330455705100144,18,36,76,57,77,74,57,66,338,123,461,26.68112798264642
13491,330455705100145,85,119,165,148,107,83,48,19,707,67,774,8.656330749354005
13492,330455705100146,22,22,51,63,62,70,55,60,290,115,405,28.395061728395063
13493,330455705100147,13,23,56,60,51,73,67,54,276,121,397,30.478589420654913
13494,330455705100148,29,37,112,96,100,91,83,93,465,176,641,27.45709828393136
13495,330455705100149,24,47,54,48,67,77,56,96,317,152,469,32.40938166311301
13496,330455705100150,28,15,49,41,28,51,44,82,212,126,338,37.27810650887574
13497,330455705100151,18,29,41,57,43,56,56,67,244,123,367,33.514986376021795
13498,330455705100152,23,37,79,93,64,82,97,134,378,231,609,37.93103448275862
13499,330455705100153,13,19,29,38,34,40,39,68,173,107,280,38.214285714285715
13500,330455705100154,8,5,10,17,7,12,15,28,59,43,102,42.15686274509804
13501,330455705100155,30,26,62,54,67,74,70,145,313,215,528,40.71969696969697
13502,330455705100156,18,21,52,40,44,54,55,68,229,123,352,34.94318181818182
13503,330455705100157,24,30,66,63,46,82,51,99,311,150,461,32.53796095444685
13504,330455705100158,8,20,60,41,38,41,43,83,208,126,334,37.724550898203596
13505,330455705100159,39,24,69,75,71,88,71,125,366,196,562,34.87544483985765
13506,330455705100160,14,17,30,24,25,31,28,55,141,83,224,37.05357142857143
13507,330455705100161,5,3,11,5,8,10,7,15,42,22,64,34.375
13508,330455705100162,11,21,35,22,33,42,34,68,164,102,266,38.34586466165413
13509,330455705100163,12,18,32,39,28,50,33,65,179,98,277,35.37906137184115
13510,330455705100164,26,25,73,43,46,69,72,89,282,161,443,36.3431151241535
13511,330455705100165,7,23,34,25,33,34,36,45,156,81,237,34.177215189873415
13512,330455705100166,11,17,75,46,46,55,50,52,250,102,352,28.977272727272727
13513,330455705100167,14,21,78,68,45,39,37,29,265,66,331,19.939577039274923
13514,330455705100168,18,22,33,44,48,57,33,72,222,105,327,32.11009174311926
13515,330455705100169,16,18,42,43,29,31,40,50,179,90,269,33.45724907063197
13516,330455705100170,12,15,53,27,34,40,32,53,181,85,266,31.954887218045112
13517,330455705100171,8,5,36,33,23,48,30,35,153,65,218,29.81651376146789
13518,330455705100172,9,10,29,40,28,34,35,35,150,70,220,31.818181818181817
13519,330455705100173,17,29,73,53,60,55,62,83,287,145,432,33.56481481481482
13520,330455705100174,20,20,44,59,46,40,45,66,229,111,340,32.64705882352941
13521,330455705100175,17,29,68,36,45,64,42,79,259,121,380,31.842105263157894
13522,330455705100176,14,16,35,48,38,47,51,54,198,105,303,34.65346534653465
13523,330455705100177,15,23,48,50,46,48,33,56,230,89,319,27.899686520376175
13524,330455705100178,11,17,50,51,51,44,40,60,224,100,324,30.864197530864196
13525,330455705100179,7,9,19,25,12,27,21,30,99,51,150,34.0
13526,330455705100180,12,16,45,37,28,37,25,38,175,63,238,26.470588235294116
13527,330455705100181,24,31,49,41,42,39,35,67,226,102,328,31.097560975609756
13528,330455705100182,22,33,52,60,45,70,72,115,282,187,469,39.872068230277186
13529,330455705100183,22,27,88,55,74,85,78,130,351,208,559,37.2093023255814
13530,330455705100184,7,9,18,24,33,28,33,75,119,108,227,47.57709251101321
13531,330455705100185,6,7,12,30,23,22,31,45,100,76,176,43.18181818181818
13532,330455705100186,19,21,43,41,40,66,62,93,230,155,385,40.25974025974026
13533,330455705100187,23,28,61,60,62,68,72,111,302,183,485,37.7319587628866
13534,330455705100188,23,32,48,52,56,62,81,103,273,184,457,40.26258205689278
13535,330455705100189,11,14,39,25,30,45,44,67,164,111,275,40.36363636363637
13536,330455705100190,20,36,99,65,67,111,81,153,398,234,632,37.0253164556962
13537,330455705100191,9,8,41,27,23,27,30,34,135,64,199,32.1608040201005
13538,330455705100192,32,39,94,74,62,68,72,119,369,191,560,34.107142857142854
13539,330455705100193,13,11,46,50,34,48,53,71,202,124,326,38.03680981595092
13540,330455705100194,22,14,62,38,43,61,47,95,240,142,382,37.17277486910995
13541,330455705100195,14,34,122,131,78,131,81,81,510,162,672,24.107142857142858
13542,330455705100196,6,13,39,23,32,40,25,72,153,97,250,38.8
13543,330455705100197,19,50,77,37,70,83,77,177,336,254,590,43.05084745762712
13544,330455705100198,8,16,15,12,29,24,22,39,104,61,165,36.96969696969697
13545,330455705100199,14,15,27,29,23,30,31,67,138,98,236,41.52542372881356
13546,330455705100200,14,12,26,33,24,39,40,47,148,87,235,37.02127659574468
13547,330455705100201,9,11,30,34,23,40,41,69,147,110,257,42.80155642023346
13548,330455705100202,14,24,41,33,39,51,40,76,202,116,318,36.477987421383645
13549,330455705100203,10,10,19,18,20,40,34,58,117,92,209,44.01913875598086
13550,330455705100204,2,3,13,13,10,19,11,22,60,33,93,35.483870967741936
13551,330455705100205,12,19,26,35,34,37,28,82,163,110,273,40.29304029304029
13552,330455705100206,14,27,58,54,61,73,53,120,287,173,460,37.608695652173914
13553,330455705100207,15,34,69,38,43,61,34,82,260,116,376,30.851063829787233
13554,330455705100208,7,10,29,45,25,22,23,29,138,52,190,27.36842105263158
13555,330455705100209,15,27,64,71,61,50,69,101,288,170,458,37.11790393013101
13556,330455705100210,16,14,48,33,28,43,48,68,182,116,298,38.92617449664429
13557,330455705100211,5,17,21,20,19,35,28,54,117,82,199,41.20603015075377
13558,330455705100212,25,29,82,69,56,61,65,101,322,166,488,34.01639344262295
13559,330455705100213,19,36,51,34,54,67,66,89,261,155,416,37.25961538461539
13560,330455705100214,20,35,61,59,46,61,49,95,282,144,426,33.80281690140845
13561,330455705100215,37,28,71,55,72,68,51,113,331,164,495,33.13131313131313
13562,330455705100216,20,18,22,29,36,45,43,88,170,131,301,43.521594684385384
13563,330455705100217,12,23,26,47,34,58,49,76,200,125,325,38.46153846153846
13564,330455705100218,11,21,51,54,47,43,46,64,227,110,337,32.640949554896146
13565,330455705100219,14,23,49,53,43,36,52,57,218,109,327,33.333333333333336
13566,330455705100220,31,48,70,71,74,88,65,107,382,172,554,31.04693140794224
13567,330455705100221,17,19,33,31,36,31,42,69,167,111,278,39.92805755395683
13568,330455705100222,27,28,37,46,37,38,36,82,213,118,331,35.64954682779456
13569,330455705100223,17,8,50,43,33,32,32,27,183,59,242,24.380165289256198
13570,330455705100224,3,16,41,27,35,26,27,38,148,65,213,30.516431924882628
13571,330455705100225,18,36,63,66,70,78,62,89,331,151,482,31.327800829875518
13572,330455705100226,10,22,82,37,36,43,43,55,230,98,328,29.878048780487806
13573,330455705100227,16,21,38,42,44,43,26,56,204,82,286,28.67132867132867
13574,330455705100228,9,16,33,57,36,47,57,58,198,115,313,36.74121405750799
13575,330455705100229,12,24,51,45,52,58,70,85,242,155,397,39.042821158690174
13576,330455705100230,10,17,48,31,42,43,36,45,191,81,272,29.779411764705884
13577,330455705100231,21,16,28,46,40,39,32,64,190,96,286,33.56643356643357
13578,330455705100232,19,17,40,31,34,34,38,56,175,94,269,34.94423791821561
13579,330455705100233,17,22,51,55,50,51,48,83,246,131,377,34.748010610079575
13580,330455705100234,8,8,42,43,25,36,34,59,162,93,255,36.470588235294116
13581,330455705100235,11,25,63,50,43,46,56,88,238,144,382,37.696335078534034
13582,330455705100236,37,36,67,71,62,87,70,111,360,181,541,33.45656192236599
13583,330455705100237,28,29,71,87,62,85,65,109,362,174,536,32.46268656716418
13584,330455705100238,22,17,38,53,46,59,57,78,235,135,370,36.486486486486484
13585,330455705100239,27,28,35,57,59,52,62,80,258,142,400,35.5
13586,330455705100240,20,25,47,80,56,55,66,88,283,154,437,35.24027459954233
13587,330455705100241,30,32,34,42,57,57,48,73,252,121,373,32.43967828418231
13588,330455705100242,24,23,45,43,37,69,35,77,241,112,353,31.728045325779036
13589,330455705100243,25,13,59,56,33,55,38,60,241,98,339,28.908554572271388
13590,330455705100244,158,161,242,252,123,118,70,41,1054,111,1165,9.527896995708154
13591,330455705100245,23,25,62,61,45,71,51,74,287,125,412,30.339805825242717
13592,330455705100246,6,21,42,47,38,68,35,85,222,120,342,35.08771929824562
13593,330455705100247,19,14,43,48,40,45,40,67,209,107,316,33.860759493670884
13594,330455705100248,29,31,47,50,50,47,51,75,254,126,380,33.1578947368421
13595,330455705100249,16,26,76,76,62,85,51,98,341,149,490,30.408163265306122
13596,330455705100250,4,10,54,22,20,37,31,51,147,82,229,35.80786026200873
13597,330455705100251,14,20,47,45,48,64,42,70,238,112,350,32.0
13598,330455705100252,41,29,61,63,46,52,54,72,292,126,418,30.14354066985646
13599,330455705100253,16,18,38,42,49,53,34,79,216,113,329,34.346504559270514
13600,330455705100254,22,30,46,52,46,47,45,50,243,95,338,28.106508875739646
13601,330455705100255,16,24,37,58,40,61,31,43,236,74,310,23.870967741935484
13602,330455705100256,12,27,56,72,43,62,49,60,272,109,381,28.608923884514436
13603,330455705100257,17,30,53,60,52,85,53,106,297,159,456,34.86842105263158
13604,330455705100258,24,27,45,52,63,61,61,80,272,141,413,34.14043583535109
13605,330455705100259,11,10,45,34,33,44,33,68,177,101,278,36.330935251798564
13606,330455705100260,15,32,48,27,48,43,51,83,213,134,347,38.61671469740634
13607,330455705100261,12,10,35,42,30,38,35,46,167,81,248,32.66129032258065
13608,330455705100262,35,31,42,69,70,81,51,85,328,136,464,29.310344827586206
13609,330455705100263,16,26,50,60,46,70,51,79,268,130,398,32.663316582914575
13610,330455705100264,28,25,90,66,57,80,57,81,346,138,484,28.512396694214875
13611,330455705100265,18,27,55,57,57,57,54,95,271,149,420,35.476190476190474
13612,330455705100266,21,30,52,49,47,64,55,81,263,136,399,34.08521303258146
13613,330455705100267,18,20,46,60,48,54,40,68,246,108,354,30.508474576271187
13614,330455705100268,19,21,37,43,58,53,43,100,231,143,374,38.23529411764706
13615,330455705100269,9,17,33,34,30,44,30,57,167,87,254,34.25196850393701
13616,330455705100270,5,9,33,51,40,40,40,80,178,120,298,40.26845637583892
13617,330455705100271,27,35,74,56,57,81,47,112,330,159,489,32.515337423312886
13618,330455705100272,14,30,77,70,59,68,76,96,318,172,490,35.10204081632653
13619,330455705100273,15,24,77,73,61,61,55,102,311,157,468,33.547008547008545
13620,330455705100274,22,23,39,31,33,57,45,62,205,107,312,34.294871794871796
13621,330455705100275,21,33,53,53,47,54,47,71,261,118,379,31.13456464379947
13622,330455705100276,8,16,43,30,34,51,43,65,182,108,290,37.241379310344826
13623,330455705100277,9,27,42,37,45,57,39,73,217,112,329,34.04255319148936
13624,330455705100278,12,28,81,86,55,73,64,93,335,157,492,31.910569105691057
13625,330455705100279,18,17,39,32,39,47,45,72,192,117,309,37.86407766990291
13626,330455705100280,29,36,43,37,64,54,47,94,263,141,404,34.9009900990099
13627,330455705100281,33,52,83,70,78,91,57,121,407,178,585,30.427350427350426
13628,330455705100282,23,45,51,51,62,75,48,93,307,141,448,31.473214285714285
13629,330455705100283,12,35,53,40,63,71,60,104,274,164,438,37.44292237442922
13630,330455705100284,12,16,65,47,46,41,36,49,227,85,312,27.243589743589745
13631,330455705100285,8,15,50,37,32,44,42,50,186,92,278,33.093525179856115
13632,330455705100286,15,21,53,56,57,61,57,72,263,129,392,32.90816326530612
13633,330455705100287,9,18,40,41,30,38,30,54,176,84,260,32.30769230769231
13634,330455705100288,6,6,30,27,23,24,15,26,116,41,157,26.11464968152866
13635,330455705100289,9,12,47,29,49,44,33,69,190,102,292,34.93150684931507
13636,330455705100290,2,5,22,30,10,16,16,10,85,26,111,23.423423423423422
13637,330455705100291,20,19,55,42,48,68,57,84,252,141,393,35.87786259541985
13638,330455705100292,30,45,69,77,93,96,67,88,410,155,565,27.43362831858407
13639,330455705100293,15,20,54,52,37,53,38,60,231,98,329,29.78723404255319
13640,330455705100294,36,44,84,102,94,91,57,95,451,152,603,25.207296849087893
13641,330455705100295,16,7,45,40,24,31,27,42,163,69,232,29.74137931034483
13642,330455705100296,14,15,48,43,41,64,41,62,225,103,328,31.402439024390244
13643,330455705100297,12,22,57,43,43,53,40,58,230,98,328,29.878048780487806
13644,330455705100298,13,12,35,37,25,37,21,43,159,64,223,28.699551569506728
13645,330455705100299,14,31,74,43,42,51,41,87,255,128,383,33.420365535248045
13646,330455705100300,22,25,107,82,51,69,60,60,356,120,476,25.210084033613445
13647,330455705100301,15,26,56,45,37,56,44,84,235,128,363,35.26170798898072
13648,330455705100302,8,15,41,21,30,40,41,65,155,106,261,40.61302681992337
13649,330455705100303,8,22,58,37,31,41,36,54,197,90,287,31.358885017421603
13650,330455705100304,9,10,33,42,26,17,22,32,137,54,191,28.272251308900522
13651,330455705100305,11,23,60,61,54,48,43,57,257,100,357,28.011204481792717
13652,330455705100306,28,25,57,58,48,64,48,106,280,154,434,35.483870967741936
13653,330455705100307,231,199,356,241,123,78,30,17,1228,47,1275,3.6862745098039214
13654,330455705100308,232,299,447,286,161,103,41,21,1528,62,1590,3.89937106918239
13655,330455705100309,278,304,401,302,187,111,41,28,1583,69,1652,4.176755447941889
13656,330455705100310,75,91,126,105,106,79,52,40,582,92,674,13.649851632047477
13657,330455705100311,31,44,85,103,90,85,51,68,438,119,557,21.364452423698385
13658,330455705100312,8,14,53,45,22,34,24,18,176,42,218,19.26605504587156
13659,330455705100313,6,13,39,30,31,30,17,18,149,35,184,19.02173913043478
13660,330455705100314,43,51,94,119,73,91,89,84,471,173,644,26.86335403726708
13661,330455705100315,24,21,56,53,55,58,37,64,267,101,368,27.445652173913043
13662,330455705100316,11,22,42,46,39,45,40,54,205,94,299,31.438127090301002
13663,330455705100317,14,16,52,33,43,41,37,60,199,97,296,32.770270270270274
13664,330455705100318,13,18,43,41,28,49,24,47,192,71,263,26.99619771863118
13665,330455705100319,12,24,46,42,34,56,38,44,214,82,296,27.7027027027027
13666,330455705100320,7,10,56,45,19,27,29,16,164,45,209,21.5311004784689
13667,330455705100321,16,40,59,48,42,75,50,83,280,133,413,32.20338983050848
13668,330455705100322,13,28,52,51,42,73,58,73,259,131,390,33.58974358974359
13669,330455705100323,19,28,42,54,50,51,36,56,244,92,336,27.38095238095238
13670,330455705100324,23,29,28,47,41,58,44,41,226,85,311,27.331189710610932
13671,330455705100325,16,25,47,40,44,46,43,73,218,116,334,34.73053892215569
13672,330455705100326,13,27,47,37,37,57,33,71,218,104,322,32.298136645962735
13673,330455705100327,9,28,51,27,47,62,39,103,224,142,366,38.797814207650276
13674,330455705100328,25,28,58,47,61,51,45,92,270,137,407,33.66093366093366
13675,330455705100329,22,30,42,50,48,63,55,90,255,145,400,36.25
13676,330455705100330,10,37,62,40,44,55,54,84,248,138,386,35.751295336787564
13677,330455705100331,12,21,40,48,27,44,49,65,192,114,306,37.254901960784316
13678,330455705100332,12,15,15,18,26,32,27,44,118,71,189,37.56613756613756
13679,330455705100333,21,28,62,77,66,70,64,90,324,154,478,32.21757322175732
13680,330455705100334,21,19,40,57,39,44,39,52,220,91,311,29.260450160771704
13681,330455705100335,5,10,29,53,38,37,35,34,172,69,241,28.630705394190873
13682,330455705100336,9,16,62,43,42,50,32,55,222,87,309,28.155339805825243
13683,330455705100337,15,21,21,40,41,40,30,67,178,97,275,35.27272727272727
13684,330455705100338,12,18,53,38,38,33,33,47,192,80,272,29.41176470588235
13685,330455705100339,20,20,58,58,55,73,48,95,284,143,427,33.48946135831382
13686,330455705100340,24,38,65,47,66,77,59,106,317,165,482,34.232365145228215
13687,330455705100341,13,12,54,37,33,49,43,65,198,108,306,35.294117647058826
13688,330455705100342,12,18,28,33,34,48,33,40,173,73,246,29.67479674796748
13689,330455705100343,18,25,41,47,46,55,37,63,232,100,332,30.120481927710845
13690,330455705100344,11,12,30,28,26,43,28,43,150,71,221,32.126696832579185
13691,330455705100345,14,16,34,29,38,38,26,43,169,69,238,28.991596638655462
13692,330455705100346,28,30,75,49,82,70,42,88,334,130,464,28.017241379310345
13693,330455705100347,19,18,39,34,23,52,42,67,185,109,294,37.074829931972786
13694,330455705100348,28,22,55,65,59,73,71,100,302,171,473,36.15221987315011
13695,330455705100349,16,10,49,56,43,49,50,56,223,106,329,32.21884498480243
13696,330455705100350,20,19,44,60,49,59,50,105,251,155,406,38.17733990147783
13697,330455705100351,27,30,86,71,47,69,51,85,330,136,466,29.184549356223176
13698,330455705100352,23,33,47,61,59,58,57,99,281,156,437,35.69794050343249
13699,330455705100353,9,21,29,35,39,38,30,58,171,88,259,33.97683397683398
13700,330455705100354,12,13,21,31,35,41,30,82,153,112,265,42.264150943396224
13701,330455705100355,25,29,39,49,69,56,55,88,267,143,410,34.8780487804878
13702,330455705100356,24,40,81,109,64,88,59,92,406,151,557,27.10951526032316
13703,330455705100357,16,17,45,65,42,55,56,75,240,131,371,35.309973045822105
13704,330455705100358,13,21,55,42,36,59,37,72,226,109,335,32.53731343283582
13705,330455705100359,19,26,60,70,44,68,39,43,287,82,369,22.22222222222222
13706,330455705100360,11,11,30,34,22,37,32,55,145,87,232,37.5
13707,330455705100361,24,40,86,55,63,81,69,114,349,183,532,34.3984962406015
13708,330455705100362,10,11,22,22,35,48,37,73,148,110,258,42.63565891472868
13709,330455705100363,24,22,39,45,48,50,40,62,228,102,330,30.90909090909091
13710,330455705100364,20,26,43,39,36,48,57,85,212,142,354,40.112994350282484
13711,330455705100365,21,28,46,65,60,47,54,74,267,128,395,32.40506329113924
13712,330455705100366,9,13,31,28,26,31,20,53,138,73,211,34.59715639810427
13713,330455705100367,14,17,46,40,38,51,46,82,206,128,334,38.32335329341317
13714,330455705100368,36,28,36,70,51,51,73,90,272,163,435,37.47126436781609
13715,330455705100369,10,4,9,16,10,18,16,34,67,50,117,42.73504273504273
13716,330455705100370,16,19,41,38,37,47,42,56,198,98,296,33.108108108108105
13717,330455705100371,24,15,47,55,29,50,44,70,220,114,334,34.131736526946106
13718,330455705100372,13,13,30,28,23,27,35,48,134,83,217,38.24884792626728
13719,330455705100373,28,41,52,61,61,69,78,109,312,187,499,37.4749498997996
13720,330455705100374,17,31,40,43,47,55,39,80,233,119,352,33.80681818181818
13721,330455705100375,12,19,39,32,38,42,38,44,182,82,264,31.060606060606062
13722,330455705100376,19,24,55,42,51,61,52,79,252,131,383,34.20365535248042
13723,330455705100377,24,20,47,58,41,48,33,63,238,96,334,28.74251497005988
13724,330455705100378,24,22,61,72,59,78,51,78,316,129,445,28.98876404494382
13725,330455705100379,30,30,58,74,71,69,61,94,332,155,487,31.82751540041068
13726,330455705100380,16,34,81,58,44,73,69,72,306,141,447,31.543624161073826
13727,330455705100381,25,39,64,72,73,62,60,99,335,159,494,32.18623481781376
13728,330455705100382,4,19,24,28,27,33,27,27,135,54,189,28.571428571428573
13729,330455705100383,17,23,58,44,46,64,50,57,252,107,359,29.805013927576603
13730,330455705100384,21,23,52,60,34,56,52,37,246,89,335,26.567164179104477
13731,330455705100385,24,30,67,81,57,52,56,69,311,125,436,28.6697247706422
13732,330455705100386,17,31,52,48,48,56,38,54,252,92,344,26.74418604651163
13733,330455705100387,141,175,161,212,175,111,53,56,975,109,1084,10.055350553505535
13734,330455705100388,22,35,58,55,59,54,26,34,283,60,343,17.49271137026239
13735,330455705100389,32,28,72,121,69,67,49,52,389,101,490,20.612244897959183
13736,330455705100390,33,21,78,106,69,60,56,46,367,102,469,21.748400852878465
13737,330455705100391,53,41,65,95,117,79,49,48,450,97,547,17.73308957952468
13738,330455705100392,19,24,48,45,39,46,50,51,221,101,322,31.366459627329192
13739,330455705100393,39,29,58,79,69,85,59,70,359,129,488,26.434426229508198
13740,330455705100394,11,9,47,43,24,32,40,46,166,86,252,34.12698412698413
13741,330455705100395,18,36,36,42,56,38,40,49,226,89,315,28.253968253968253
13742,330455705100396,34,28,37,60,49,59,33,44,267,77,344,22.38372093023256
13743,330455705100397,10,17,59,55,18,51,25,34,210,59,269,21.933085501858734
13744,330455705100398,42,43,76,115,90,93,67,66,459,133,592,22.466216216216218
13745,330455705100399,31,23,43,68,56,48,40,50,269,90,359,25.069637883008358
13746,330455705100400,24,24,83,82,64,75,40,50,352,90,442,20.361990950226243
13747,330455705100401,11,20,68,49,79,70,69,82,297,151,448,33.705357142857146
13748,330455705100402,18,24,58,40,39,51,27,52,230,79,309,25.566343042071196
13749,330455705100403,27,40,58,72,56,58,44,54,311,98,409,23.96088019559902
13750,330455705100404,26,35,80,70,52,71,45,41,334,86,420,20.476190476190474
13751,330455705100405,9,12,23,16,23,26,15,28,109,43,152,28.289473684210527
13752,330455705100406,35,42,74,59,64,67,56,49,341,105,446,23.542600896860986
13753,330455705100407,42,43,66,81,66,65,82,61,363,143,506,28.26086956521739
13754,330455705100408,229,264,381,268,185,101,63,27,1428,90,1518,5.928853754940712
13755,330455705100409,17,17,22,47,43,42,45,60,188,105,293,35.83617747440273
13756,330455705100410,17,19,55,49,32,56,62,62,228,124,352,35.22727272727273
13757,330455705100411,12,24,38,43,34,53,45,52,204,97,301,32.22591362126246
13758,330455705100412,18,10,30,35,41,36,35,48,170,83,253,32.80632411067194
13759,330455705100413,133,144,177,140,102,55,28,17,751,45,796,5.653266331658291
13760,330455705100414,48,56,94,73,29,20,18,8,320,26,346,7.514450867052023
13761,330455705100415,291,338,363,481,272,136,73,65,1881,138,2019,6.8350668647845465
13762,330455705100416,19,27,69,65,52,67,48,77,299,125,424,29.4811320754717
13763,330455705100417,21,21,68,62,41,73,30,75,286,105,391,26.854219948849106
13764,330455705100418,297,271,432,229,197,79,32,23,1505,55,1560,3.5256410256410255
13765,330455705100419,120,126,172,153,125,120,107,73,816,180,996,18.072289156626507
13766,330455705100420,40,27,56,59,41,25,5,6,248,11,259,4.2471042471042475
13767,330455705100421,102,114,126,105,91,72,46,93,610,139,749,18.55807743658211
13768,330455705110001,20,17,18,23,26,33,30,37,137,67,204,32.84313725490196
13769,330455705110002,0,8,10,3,10,14,9,15,45,24,69,34.78260869565217
13770,330455705110003,9,17,41,31,38,57,47,58,193,105,298,35.23489932885906
13771,330455705110004,9,18,41,50,99,70,57,45,287,102,389,26.22107969151671
13772,330455705110005,16,18,60,52,53,41,48,77,240,125,365,34.24657534246575
13773,330455705110006,36,36,79,59,88,87,63,122,385,185,570,32.45614035087719
13774,330455705110007,22,36,29,42,55,49,43,67,233,110,343,32.06997084548105
13775,330455705110008,30,35,70,80,74,83,76,126,372,202,574,35.19163763066202
13776,330455705110009,22,44,47,61,58,73,59,82,305,141,446,31.614349775784753
13777,330455705110010,37,34,88,88,77,87,95,109,411,204,615,33.170731707317074
13778,330455705110011,12,24,38,32,37,37,32,73,180,105,285,36.8421052631579
13779,330455705110012,36,27,77,92,70,69,58,89,371,147,518,28.37837837837838
13780,330455705110013,17,17,44,46,51,55,43,79,230,122,352,34.65909090909091
13781,330455705110014,31,37,75,78,89,89,83,99,399,182,581,31.325301204819276
13782,330455705110015,16,31,50,36,58,50,57,85,241,142,383,37.0757180156658
13783,330455705110016,12,16,32,42,36,32,33,59,170,92,262,35.11450381679389
13784,330455705110017,10,22,63,71,38,62,45,85,266,130,396,32.82828282828283
13785,330455705110018,10,6,15,25,15,11,3,17,82,20,102,19.607843137254903
13786,330455705110019,9,6,33,34,29,21,29,35,132,64,196,32.6530612244898
13787,330455705110020,25,25,46,40,54,57,62,60,247,122,369,33.06233062330623
13788,330455705110021,10,19,50,47,37,47,31,51,210,82,292,28.08219178082192
13789,330455705110022,20,24,73,55,41,56,51,69,269,120,389,30.848329048843187
13790,330455705110023,26,36,78,76,67,59,51,66,342,117,459,25.49019607843137
13791,330455705110024,18,37,68,52,65,71,65,86,311,151,462,32.683982683982684
13792,330455705110025,16,18,29,42,45,47,27,34,197,61,258,23.643410852713178
13793,330455705110026,77,87,71,56,46,29,15,12,366,27,393,6.870229007633588
13794,330455705110027,444,493,448,370,265,165,75,45,2185,120,2305,5.206073752711497
13795,330455705110028,60,105,61,63,72,36,13,11,397,24,421,5.7007125890736345
13796,330455705110029,24,31,41,54,52,50,52,59,252,111,363,30.578512396694215
13797,330455705110030,41,49,50,94,87,82,67,39,403,106,509,20.825147347740668
13798,330455705110031,74,50,77,98,97,113,70,68,509,138,647,21.32921174652241
13799,330455705110032,49,54,98,116,122,121,84,70,560,154,714,21.568627450980394
13800,330455705110033,60,63,125,138,118,150,115,92,654,207,861,24.041811846689896
13801,330455705110034,36,67,55,43,70,83,68,42,354,110,464,23.70689655172414
13802,330455705110035,4,16,49,38,53,16,11,1,176,12,188,6.382978723404255
13803,330455705110036,53,48,73,85,72,72,45,39,403,84,487,17.248459958932237
13804,330455705110037,34,48,37,55,52,54,30,30,280,60,340,17.647058823529413
13805,330455705110038,51,30,45,60,56,52,48,21,294,69,363,19.00826446280992
13806,330455705110039,23,41,89,54,63,70,54,127,340,181,521,34.74088291746641
13807,330455705110040,21,33,31,38,46,45,39,72,214,111,325,34.15384615384615
13808,330455705110041,21,25,43,69,60,49,45,56,267,101,368,27.445652173913043
13809,330455705110042,27,27,67,82,55,80,81,106,338,187,525,35.61904761904762
13810,330455705110043,22,16,45,65,46,55,45,82,249,127,376,33.776595744680854
13811,330455705110044,21,28,54,44,59,61,30,76,267,106,373,28.41823056300268
13812,330455705110045,35,41,69,77,60,75,43,62,357,105,462,22.727272727272727
13813,330455705110046,11,22,45,56,47,42,57,64,223,121,344,35.174418604651166
13814,330455705110047,33,29,58,69,52,64,45,72,305,117,422,27.725118483412324
13815,330455705110048,13,23,58,52,52,59,45,46,257,91,348,26.149425287356323
13816,330455705110049,27,23,51,85,66,73,62,54,325,116,441,26.303854875283445
13817,330455705110050,26,33,77,101,68,66,60,51,371,111,482,23.029045643153527
13818,330455705110051,39,29,82,98,91,87,63,80,426,143,569,25.131810193321616
13819,330455705110052,16,17,47,80,58,63,38,38,281,76,357,21.288515406162464
13820,330455705110053,24,45,52,41,52,77,51,46,291,97,388,25.0
13821,330455705110054,40,38,52,60,69,63,68,58,322,126,448,28.125
13822,330455705110055,40,57,63,89,91,101,66,52,441,118,559,21.10912343470483
13823,330455705110056,35,38,70,77,74,106,80,137,400,217,617,35.17017828200972
13824,330455705110057,30,28,42,80,65,82,52,55,327,107,434,24.65437788018433
13825,330455705110058,40,31,53,99,78,80,48,82,381,130,511,25.44031311154599
13826,330455705110059,34,42,76,85,76,77,48,49,390,97,487,19.917864476386036
13827,330455705110060,17,35,51,59,58,64,43,40,284,83,367,22.615803814713896
13828,330455705110061,16,38,58,53,77,68,48,103,310,151,461,32.75488069414317
13829,330455705110062,9,14,49,33,34,34,33,85,173,118,291,40.549828178694156
13830,330455705110063,14,14,26,50,21,35,31,61,160,92,252,36.507936507936506
13831,330455705110064,41,41,57,57,76,58,60,71,330,131,461,28.41648590021692
13832,330455705110065,38,22,52,63,44,52,48,90,271,138,409,33.74083129584352
13833,330455705110066,25,30,47,45,42,65,41,56,254,97,351,27.635327635327634
13834,330455705110067,29,39,47,37,46,58,37,51,256,88,344,25.58139534883721
13835,330455705110068,25,35,50,48,60,58,58,88,276,146,422,34.59715639810427
13836,330455705110069,28,27,44,62,55,47,61,102,263,163,426,38.262910798122064
13837,330455705110070,33,32,58,68,63,69,67,91,323,158,481,32.84823284823285
13838,330455705110071,6,24,39,30,31,28,16,27,158,43,201,21.393034825870647
13839,330455705110072,9,14,33,25,24,29,21,47,134,68,202,33.663366336633665
13840,330455705110073,21,51,63,47,53,83,33,95,318,128,446,28.699551569506728
13841,330455705110074,29,60,64,76,97,88,77,106,414,183,597,30.65326633165829
13842,330455705110075,37,35,52,57,56,71,53,48,308,101,409,24.69437652811736
13843,330455705110076,23,24,48,54,51,58,33,55,258,88,346,25.433526011560694
13844,330455705110077,18,26,55,65,57,65,57,46,286,103,389,26.47814910025707
13845,330455705110078,25,28,53,67,45,67,60,44,285,104,389,26.73521850899743
13846,330455705110079,46,51,69,79,95,119,83,106,459,189,648,29.166666666666668
13847,330455705110080,28,53,39,44,60,56,44,46,280,90,370,24.324324324324323
13848,330455705110081,18,15,38,30,38,49,38,79,188,117,305,38.36065573770492
13849,330455705110082,14,14,37,33,25,29,51,60,152,111,263,42.20532319391635
13850,330455705110083,21,32,56,33,40,46,35,104,228,139,367,37.87465940054496
13851,330455705110084,44,33,30,40,71,76,45,72,294,117,411,28.467153284671532
13852,330455705110085,20,29,24,27,46,28,29,48,174,77,251,30.677290836653388
13853,330455705110086,32,36,48,51,53,66,36,71,286,107,393,27.2264631043257
13854,330455705110087,21,38,58,55,69,70,60,92,311,152,463,32.82937365010799
13855,330455705110088,18,29,60,61,53,40,54,85,261,139,400,34.75
13856,330455705110089,8,15,57,58,36,48,31,83,222,114,336,33.92857142857143
13857,330455705110090,46,39,75,85,72,98,61,90,415,151,566,26.67844522968198
13858,330455705110091,48,48,76,71,76,104,58,91,423,149,572,26.04895104895105
13859,330455705110092,29,27,51,73,49,68,40,45,297,85,382,22.25130890052356
13860,330455705110093,66,43,72,98,120,94,72,104,493,176,669,26.307922272047833
13861,330455705110094,43,58,75,74,88,105,87,92,443,179,622,28.778135048231512
13862,330455705110095,32,19,62,71,63,89,72,43,336,115,451,25.49889135254989
13863,330455705110096,53,55,92,112,116,119,89,62,547,151,698,21.63323782234957
13864,330455705110097,20,34,40,55,48,67,27,29,264,56,320,17.5
13865,330455705110098,72,77,113,112,126,108,106,60,608,166,774,21.44702842377261
13866,330455705110099,64,73,103,104,100,125,99,69,569,168,737,22.795115332428765
13867,330455705110100,67,58,88,149,100,129,104,79,591,183,774,23.643410852713178
13868,330455705110101,79,53,84,158,138,116,81,76,628,157,785,20.0
13869,330455705110102,40,52,94,113,101,128,82,63,528,145,673,21.545319465081725
13870,330455705110103,53,62,81,84,83,124,72,64,487,136,623,21.829855537720707
13871,330455705110104,49,66,78,90,95,105,62,64,483,126,609,20.689655172413794
13872,330455705110105,8,4,19,49,22,25,16,13,127,29,156,18.58974358974359
13873,330455705110106,27,33,48,77,40,51,43,40,276,83,359,23.119777158774372
13874,330455705110107,45,41,59,54,49,81,55,58,329,113,442,25.56561085972851
13875,330455705110108,43,38,59,84,62,58,56,57,344,113,457,24.72647702407002
13876,330455705110109,65,82,105,85,102,162,83,100,601,183,784,23.341836734693878
13877,330455705110110,56,55,84,94,70,85,88,56,444,144,588,24.489795918367346
13878,330455705110111,48,28,81,107,82,65,72,61,411,133,544,24.448529411764707
13879,330455705110112,106,99,167,221,177,147,78,56,917,134,1051,12.74976213130352
13880,330455705110114,28,47,48,69,65,79,77,49,336,126,462,27.272727272727273
13881,330455705110115,26,42,36,40,48,46,20,16,238,36,274,13.138686131386862
13882,330455705110116,35,46,69,98,96,82,61,38,426,99,525,18.857142857142858
13883,330455705110117,73,68,76,107,109,91,81,70,524,151,675,22.37037037037037
13884,330455705110118,31,23,46,66,42,58,42,24,266,66,332,19.879518072289155
13885,330455705110119,72,48,76,116,78,71,55,46,461,101,562,17.97153024911032
13886,330455705110120,45,52,40,58,60,59,49,41,314,90,404,22.277227722772277
13887,330455705110121,34,40,37,54,66,64,51,59,295,110,405,27.160493827160494
13888,330455705110122,45,31,34,73,65,59,57,90,307,147,454,32.37885462555066
13889,330455705110123,21,33,44,47,52,48,49,65,245,114,359,31.754874651810585
13890,330455705110124,27,31,67,68,60,42,52,71,295,123,418,29.425837320574164
13891,330455705110125,33,40,72,84,76,82,69,123,387,192,579,33.16062176165803
13892,330455705110126,15,30,33,29,34,40,40,58,181,98,279,35.12544802867384
13893,330455705110127,24,24,35,39,37,39,45,48,198,93,291,31.95876288659794
13894,330455705110128,36,42,41,53,65,59,68,89,296,157,453,34.65783664459161
13895,330455705110129,17,21,34,24,34,33,30,35,163,65,228,28.50877192982456
13896,330455705110130,27,40,45,59,46,48,59,53,265,112,377,29.70822281167109
13897,330455705110131,14,16,28,29,30,32,25,41,149,66,215,30.697674418604652
13898,330455705110132,21,27,31,29,34,49,42,58,191,100,291,34.36426116838488
13899,330455705110133,12,33,61,44,41,44,52,79,235,131,366,35.79234972677595
13900,330455705110134,9,5,18,17,19,19,20,47,87,67,154,43.506493506493506
13901,330455705110135,28,32,62,81,57,73,52,80,333,132,465,28.387096774193548
13902,330455705110136,36,21,42,55,45,51,50,59,250,109,359,30.362116991643454
13903,330455705110137,15,13,22,26,18,25,30,30,119,60,179,33.5195530726257
13904,330455705110138,73,52,61,84,102,80,74,87,452,161,613,26.26427406199021
13905,330455705110139,32,35,53,77,61,64,59,98,322,157,479,32.77661795407098
13906,330455705110140,19,23,37,42,50,51,59,77,222,136,358,37.98882681564246
13907,330455705110141,14,29,55,61,52,50,54,72,261,126,387,32.55813953488372
13908,330455705110142,25,71,120,94,98,124,92,165,532,257,789,32.57287705956907
13909,330455705110143,1,8,8,9,4,14,8,9,44,17,61,27.868852459016395
13910,330455705110144,5,1,4,14,15,8,14,13,47,27,74,36.486486486486484
13911,330455705110145,59,85,101,93,95,78,45,52,511,97,608,15.953947368421053
13912,330455705110146,37,52,42,58,85,75,97,186,349,283,632,44.778481012658226
13913,330455705110147,59,91,77,76,85,75,35,48,463,83,546,15.2014652014652
13914,330455705110148,48,105,93,83,103,103,46,60,535,106,641,16.536661466458657
13915,330455705110149,31,46,58,58,50,86,65,91,329,156,485,32.16494845360825
13916,330455705110150,29,33,25,54,66,58,64,60,265,124,389,31.876606683804628
13917,330455705110151,27,33,63,45,47,80,57,64,295,121,416,29.08653846153846
13918,330455705110152,24,38,72,68,53,81,96,95,336,191,527,36.24288425047438
13919,330455705110153,35,30,51,60,43,43,33,44,262,77,339,22.71386430678466
13920,330455705110154,34,39,55,70,63,78,89,146,339,235,574,40.940766550522646
13921,330455705110155,56,54,70,71,82,85,35,49,418,84,502,16.733067729083665
13922,330455705110156,32,48,79,75,79,96,81,157,409,238,647,36.78516228748068
13923,330455705110157,23,43,70,68,86,88,90,127,378,217,595,36.470588235294116
13924,330455705110158,26,39,30,59,84,78,56,69,316,125,441,28.34467120181406
13925,330455705110159,5,9,20,54,50,47,44,55,185,99,284,34.859154929577464
13926,330455705110160,64,72,90,137,107,109,104,110,579,214,793,26.986128625472887
13927,330455705110161,15,42,71,46,54,69,62,89,297,151,448,33.705357142857146
13928,330455705110162,40,33,49,104,89,81,51,69,396,120,516,23.25581395348837
13929,330455705110163,27,33,53,76,57,49,41,52,295,93,388,23.969072164948454
13930,330455705110164,31,52,41,68,64,95,86,150,351,236,587,40.20442930153322
13931,330455705110165,44,47,64,82,97,62,109,132,396,241,637,37.83359497645212
13932,330455705110166,33,37,68,93,83,79,80,86,393,166,559,29.695885509838998
13933,330455705110167,32,29,53,57,61,58,47,84,290,131,421,31.116389548693586
13934,330455705110168,27,50,54,72,78,60,55,87,341,142,483,29.399585921325052
13935,330455705110169,33,50,51,60,60,59,53,74,313,127,440,28.863636363636363
13936,330455705110170,33,37,54,49,51,74,55,62,298,117,415,28.19277108433735
13937,330455705110171,9,34,22,34,35,26,30,49,160,79,239,33.05439330543933
13938,330455705110172,10,31,68,49,44,56,43,69,258,112,370,30.27027027027027
13939,330455705110173,26,32,52,43,62,73,64,77,288,141,429,32.86713286713287
13940,330455705110174,53,36,58,89,65,64,63,60,365,123,488,25.204918032786885
13941,330455705110175,38,41,64,62,54,62,67,77,321,144,465,30.967741935483872
13942,330455705110176,32,36,50,61,55,63,48,74,297,122,419,29.116945107398568
13943,330455705110177,31,26,54,61,59,55,64,87,286,151,437,34.55377574370709
13944,330455705110178,10,42,41,50,48,50,36,66,241,102,343,29.737609329446062
13945,330455705110179,16,33,85,134,79,82,65,43,429,108,537,20.11173184357542
13946,330455705110180,41,43,58,107,72,79,56,86,400,142,542,26.199261992619927
13947,330455705110181,19,20,46,62,41,58,34,71,246,105,351,29.914529914529915
13948,330455705110182,23,31,114,100,62,82,63,73,412,136,548,24.817518248175183
13949,330455705110183,35,19,76,80,47,59,46,62,316,108,424,25.471698113207548
13950,330455705110184,45,30,48,106,74,89,63,76,392,139,531,26.17702448210923
13951,330455705110185,55,48,79,89,93,102,86,91,466,177,643,27.527216174183515
13952,330455705110186,34,39,99,124,98,84,72,87,478,159,637,24.960753532182103
13953,330455705110187,31,22,79,82,66,71,72,90,351,162,513,31.57894736842105
13954,330455705110188,16,21,67,51,47,54,49,39,256,88,344,25.58139534883721
13955,330455705110189,30,31,51,46,47,43,54,42,248,96,344,27.906976744186046
13956,330455705110190,16,27,42,56,48,69,57,42,258,99,357,27.73109243697479
13957,330455705110191,31,50,42,90,79,75,52,76,367,128,495,25.858585858585858
13958,330455705110192,57,65,101,128,106,110,81,129,567,210,777,27.027027027027028
13959,330455705110193,26,23,34,32,32,41,25,32,188,57,245,23.26530612244898
13960,330455705110194,45,52,96,89,88,95,110,118,465,228,693,32.900432900432904
13961,330455705110195,43,45,72,62,66,85,62,83,373,145,518,27.99227799227799
13962,330455705110196,28,40,40,54,37,55,46,74,254,120,374,32.0855614973262
13963,330455705110197,26,31,56,62,60,59,79,73,294,152,446,34.08071748878924
13964,330455705110198,6,9,7,13,15,23,16,21,73,37,110,33.63636363636363
13965,330455705110199,15,25,51,46,51,65,48,59,253,107,360,29.72222222222222
13966,330455705110200,26,31,45,59,58,44,47,68,263,115,378,30.423280423280424
13967,330455705110201,30,31,52,64,74,77,59,71,328,130,458,28.38427947598253
13968,330455705110202,36,42,52,75,73,71,52,70,349,122,471,25.902335456475583
13969,330455705110203,37,46,76,71,78,72,76,87,380,163,543,30.01841620626151
13970,330455705110204,22,22,40,48,48,53,53,68,233,121,354,34.18079096045198
13971,330455705110205,25,46,85,71,62,109,67,133,398,200,598,33.44481605351171
13972,330455705110206,39,54,59,46,62,71,52,95,331,147,478,30.753138075313807
13973,330455705110207,28,39,29,46,59,62,39,66,263,105,368,28.532608695652176
13974,330455705110208,25,37,53,52,49,71,70,89,287,159,446,35.65022421524664
13975,330455705110209,22,19,44,54,43,51,56,61,233,117,350,33.42857142857143
13976,330455705110210,38,48,72,78,108,67,59,67,411,126,537,23.463687150837988
13977,330455705110211,11,28,48,47,48,61,43,81,243,124,367,33.787465940054496
13978,330455705110212,21,27,40,53,39,51,28,69,231,97,328,29.573170731707318
13979,330455705110213,53,50,66,103,82,85,85,79,439,164,603,27.197346600331674
13980,330455705110214,23,31,61,61,53,75,60,74,304,134,438,30.59360730593607
13981,330455705110215,66,65,79,130,121,112,80,80,573,160,733,21.828103683492497
13982,330455705110216,50,62,66,65,68,97,49,68,408,117,525,22.285714285714285
13983,330455705110217,7,5,17,35,18,19,16,17,101,33,134,24.62686567164179
13984,330455705110218,16,15,27,39,28,34,19,47,159,66,225,29.333333333333332
13985,330455705110219,25,47,82,77,94,93,71,98,418,169,587,28.79045996592845
13986,330455705110220,38,29,43,54,44,48,34,53,256,87,343,25.364431486880466
13987,330455705110221,35,51,74,122,59,147,112,93,488,205,693,29.58152958152958
13988,330455705110222,30,54,72,82,77,94,84,80,409,164,573,28.62129144851658
13989,330455705110223,28,37,40,44,57,42,62,35,248,97,345,28.115942028985508
13990,330455705110224,53,71,86,147,124,90,94,52,571,146,717,20.362622036262202
13991,330455705110225,55,58,79,90,81,108,70,71,471,141,612,23.03921568627451
13992,330455705110226,54,50,66,84,84,71,56,56,409,112,521,21.497120921305182
13993,330455705110227,83,99,116,173,173,158,78,42,802,120,922,13.015184381778742
13994,330455705110228,32,23,64,58,45,56,47,24,278,71,349,20.34383954154728
13995,330455705110229,49,49,60,56,82,84,62,76,380,138,518,26.64092664092664
13996,330455705110230,50,58,92,96,75,100,75,55,471,130,601,21.630615640599
13997,330455705110231,61,45,76,84,76,75,75,39,417,114,531,21.468926553672315
13998,330455705110232,25,39,38,39,51,47,35,35,239,70,309,22.653721682847895
13999,330455705110233,51,32,73,93,57,90,72,81,396,153,549,27.868852459016395
14000,330455705110234,44,60,65,72,78,89,67,93,408,160,568,28.169014084507044
14001,330455705110235,40,38,32,54,53,56,41,46,273,87,360,24.166666666666668
14002,330455705110236,132,136,149,213,192,136,134,111,958,245,1203,20.365752285951785
14003,330455705110237,32,31,79,77,68,68,50,51,355,101,456,22.149122807017545
14004,330455705110238,70,102,62,106,126,102,65,53,568,118,686,17.20116618075802
14005,330455705110239,47,38,55,74,73,53,46,43,340,89,429,20.745920745920746
14006,330455705110240,56,50,54,98,59,80,40,35,397,75,472,15.889830508474576
14007,330455705110241,57,57,76,131,83,109,74,50,513,124,637,19.46624803767661
14008,330455705110242,52,30,66,80,71,70,31,37,369,68,437,15.560640732265446
14009,330455705110243,91,63,157,210,128,131,108,104,780,212,992,21.370967741935484
14010,330455705110244,58,60,79,110,101,83,56,60,491,116,607,19.110378912685338
14011,330455705110245,31,35,43,79,73,77,48,52,338,100,438,22.831050228310502
14012,330455705110246,29,52,61,63,76,64,61,76,345,137,482,28.42323651452282
14013,330455705110247,36,33,49,64,43,56,45,50,281,95,376,25.26595744680851
14014,330455705110248,23,62,60,69,84,62,46,67,360,113,473,23.890063424947147
14015,330455705110249,26,36,43,65,57,54,31,44,281,75,356,21.06741573033708
14016,330455705110250,48,35,52,61,66,82,67,79,344,146,490,29.79591836734694
14017,330455705110251,53,76,109,88,102,110,81,69,538,150,688,21.802325581395348
14018,330455705110252,18,25,21,30,29,31,39,38,154,77,231,33.333333333333336
14019,330455705110253,76,89,107,78,134,113,108,109,597,217,814,26.65847665847666
14020,330455705110254,44,64,77,71,91,80,64,77,427,141,568,24.823943661971832
14021,330455705110255,22,24,18,40,43,31,21,34,178,55,233,23.605150214592275
14022,330455705110256,18,30,66,69,55,51,34,45,289,79,368,21.467391304347824
14023,330455705110257,16,12,26,23,21,32,18,11,130,29,159,18.238993710691823
14024,330455705110258,22,33,30,38,43,43,29,33,209,62,271,22.878228782287824
14025,330455705110259,45,46,67,95,90,85,70,63,428,133,561,23.707664884135472
14026,330455705110260,23,38,60,50,48,64,48,45,283,93,376,24.73404255319149
14027,330455705110261,26,10,57,76,48,68,39,52,285,91,376,24.20212765957447
14028,330455705110262,41,30,72,88,85,65,53,71,381,124,505,24.554455445544555
14029,330455705110263,29,21,51,55,47,53,62,60,256,122,378,32.27513227513227
14030,330455705110264,20,32,63,59,76,65,64,63,315,127,442,28.733031674208146
14031,330455705110265,36,46,75,80,68,79,78,98,384,176,560,31.428571428571427
14032,330455705110266,38,46,104,92,92,97,77,83,469,160,629,25.437201907790143
14033,330455705110267,45,63,87,74,74,108,80,55,451,135,586,23.037542662116042
14034,330455705110268,30,79,138,106,103,99,88,95,555,183,738,24.796747967479675
14035,330455705110269,46,54,152,119,81,102,78,75,554,153,707,21.64073550212164
14036,330455705110270,40,34,45,60,59,57,53,50,295,103,398,25.87939698492462
14037,330455705110271,53,59,84,78,77,114,60,60,465,120,585,20.512820512820515
14038,330455705110272,41,53,107,92,69,114,135,89,476,224,700,32.0
14039,330455705110273,29,35,60,97,44,87,42,45,352,87,439,19.81776765375854
14040,330455705110274,21,35,53,44,41,53,47,43,247,90,337,26.706231454005934
14041,330455705110275,29,42,88,99,72,66,57,52,396,109,505,21.584158415841586
14042,330455705110276,58,77,138,119,101,129,78,63,622,141,763,18.479685452162517
14043,330455705110277,34,46,65,50,75,81,49,32,351,81,432,18.75
14044,330455705110278,21,31,76,80,66,60,34,45,334,79,413,19.128329297820823
14045,330455705110279,23,34,59,61,45,59,43,52,281,95,376,25.26595744680851
14046,330455705110280,31,37,57,54,47,68,39,26,294,65,359,18.105849582172702
14047,330455705110281,66,85,110,95,104,123,89,89,583,178,761,23.390275952693823
14048,330455705110282,48,77,87,83,90,119,89,58,504,147,651,22.580645161290324
14049,330455705110283,51,76,145,117,110,94,69,57,593,126,719,17.52433936022253
14050,330455705110284,62,85,115,87,62,59,29,28,470,57,527,10.815939278937382
14051,330455705110285,50,70,122,126,108,117,96,94,593,190,783,24.26564495530013
14052,330455705110286,90,97,114,116,92,101,75,48,610,123,733,16.780354706684857
14053,330455705110287,31,70,98,70,76,78,31,29,423,60,483,12.422360248447205
14054,330455705110288,90,137,99,134,90,77,50,17,627,67,694,9.654178674351584
14055,330455705110289,7,10,18,27,26,33,17,23,121,40,161,24.84472049689441
14056,330455705110290,116,93,105,135,82,47,29,25,578,54,632,8.544303797468354
14057,330455705110291,102,141,133,138,118,80,42,11,712,53,765,6.928104575163399
14058,330455705110292,181,176,213,177,152,119,74,50,1018,124,1142,10.85814360770578
14059,330455705110293,135,145,130,160,106,77,56,29,753,85,838,10.143198090692124
14060,330455705110294,44,58,63,61,41,22,19,7,289,26,315,8.253968253968255
14061,330455705110295,148,176,184,172,127,90,63,25,897,88,985,8.934010152284264
14062,330455705110296,80,121,109,112,80,67,36,24,569,60,629,9.538950715421304
14063,330455705110297,78,92,82,83,71,55,20,24,461,44,505,8.712871287128714
14064,330455705110298,64,103,88,92,61,34,13,3,442,16,458,3.493449781659389
14065,330455705110299,232,262,279,236,171,109,46,34,1289,80,1369,5.843681519357195
14066,330455705110300,54,54,76,61,46,26,15,7,317,22,339,6.489675516224189
14067,330455705110301,46,77,79,68,64,52,13,17,386,30,416,7.211538461538462
14068,330455705110302,45,64,80,131,104,100,77,67,524,144,668,21.55688622754491
14069,330455705110303,32,54,58,50,67,61,93,60,322,153,475,32.21052631578947
14070,330455705110304,29,90,122,104,104,139,88,81,588,169,757,22.324966974900924
14071,330455705110305,54,93,129,133,142,125,94,77,676,171,847,20.188902007083826
14072,330455705110306,26,32,30,25,31,42,37,35,186,72,258,27.906976744186046
14073,330455705110307,121,152,178,187,196,205,215,199,1039,414,1453,28.492773571920164
14074,330455705110308,64,78,80,132,125,107,151,125,586,276,862,32.01856148491879
14075,330455705110309,130,172,215,196,195,178,82,51,1086,133,1219,10.910582444626744
14076,330455705110310,70,70,109,109,142,113,82,44,613,126,739,17.050067658998646
14077,330455705110311,41,50,59,55,42,45,20,10,292,30,322,9.316770186335404
14078,330455705110312,57,107,96,65,112,136,83,56,573,139,712,19.52247191011236
14079,330455705110313,66,81,113,108,119,128,96,86,615,182,797,22.835633626097867
14080,330455705110314,33,41,31,36,33,15,10,8,189,18,207,8.695652173913043
14081,330455705110316,3,7,14,8,8,11,13,10,51,23,74,31.08108108108108
14082,330455705110317,31,36,48,61,66,66,63,61,308,124,432,28.703703703703702
14083,330455705110318,33,37,73,52,43,68,47,69,306,116,422,27.488151658767773
14084,330455705110319,54,83,76,76,114,86,65,41,489,106,595,17.81512605042017
14085,330455705110320,60,89,109,113,140,113,64,35,624,99,723,13.692946058091286
14086,330455705110321,25,30,50,40,55,55,30,52,255,82,337,24.33234421364985
14087,330455705110322,30,45,71,76,61,87,78,71,370,149,519,28.709055876685934
14088,330455705110323,24,55,56,42,72,73,50,48,322,98,420,23.333333333333332
14089,330455705110324,133,181,212,165,161,136,56,52,988,108,1096,9.854014598540147
14090,330455705110325,40,46,43,53,51,38,11,19,271,30,301,9.966777408637874
14091,330455705110326,106,145,161,136,95,67,37,21,710,58,768,7.552083333333333
14092,330455705110327,106,111,91,115,93,67,29,12,583,41,624,6.57051282051282
14093,330455705110328,146,164,194,149,126,93,45,24,872,69,941,7.332624867162593
14094,330455705110329,44,83,87,81,74,46,18,3,415,21,436,4.81651376146789
14095,330455705110330,28,17,46,88,53,48,31,26,280,57,337,16.91394658753709
14096,330455705110331,50,47,98,127,101,96,64,28,519,92,611,15.057283142389526
14097,330455705110332,37,53,70,65,75,91,69,69,391,138,529,26.08695652173913
14098,330455705110334,19,15,28,33,24,33,39,24,152,63,215,29.302325581395348
14099,330455705110335,88,64,112,51,66,88,28,46,469,74,543,13.627992633517495
14100,330455705110336,20,18,44,51,49,49,27,31,231,58,289,20.069204152249135
14101,330455705110337,14,13,21,29,31,37,36,46,145,82,227,36.12334801762115
14102,330455705110338,8,4,6,16,21,20,20,29,75,49,124,39.516129032258064
14103,330455705110339,21,21,34,36,35,35,50,28,182,78,260,30.0
14104,330455705110340,62,49,48,68,78,62,70,43,367,113,480,23.541666666666668
14105,330455705110341,50,62,67,78,110,79,61,62,446,123,569,21.61687170474517
14106,330455705110342,25,23,30,29,37,40,13,18,184,31,215,14.418604651162791
14107,330455705110343,94,161,148,142,136,129,84,76,810,160,970,16.49484536082474
14108,330455705110344,39,46,53,48,48,58,34,33,292,67,359,18.662952646239553
14109,330455705110345,3,9,13,17,25,12,19,24,79,43,122,35.24590163934426
14110,330455705110346,26,53,65,46,63,70,29,45,323,74,397,18.639798488664987
14111,330455705110347,26,33,49,40,36,64,32,39,248,71,319,22.25705329153605
14112,330455705120001,133,173,192,181,155,126,79,58,960,137,1097,12.488605287146765
14113,330455705120002,12,32,50,37,42,34,34,43,207,77,284,27.112676056338028
14114,330455705120003,92,118,121,132,134,107,87,100,704,187,891,20.987654320987655
14115,330455705120004,60,98,105,122,83,46,55,42,514,97,611,15.875613747954173
14116,330455705120005,63,81,120,139,83,93,65,62,579,127,706,17.988668555240793
14117,330455705120006,117,134,135,126,112,91,52,45,715,97,812,11.945812807881774
14118,330455705120007,91,90,135,144,119,58,37,27,637,64,701,9.12981455064194
14119,330455705120008,101,102,136,70,61,32,28,25,502,53,555,9.54954954954955
14120,330455705120009,94,117,132,101,118,88,46,46,650,92,742,12.398921832884097
14121,330455705120010,175,212,196,187,141,99,63,47,1010,110,1120,9.821428571428571
14122,330455705120011,212,238,296,265,155,142,64,42,1308,106,1414,7.496463932107496
14123,330455705120012,64,55,68,77,46,34,28,22,344,50,394,12.690355329949238
14124,330455705120013,88,111,602,530,384,241,80,73,1956,153,2109,7.2546230440967285
14125,330455705120014,63,74,93,85,91,65,59,60,471,119,590,20.16949152542373
14126,330455705120015,93,103,151,159,132,100,68,103,738,171,909,18.81188118811881
14127,330455705120016,32,47,56,47,35,51,35,30,268,65,333,19.51951951951952
14128,330455705120017,0,5,7,4,5,7,1,9,28,10,38,26.31578947368421
14129,330455705120018,66,130,76,155,140,75,62,63,642,125,767,16.297262059973924
14130,330455705120019,59,73,86,54,67,40,26,17,379,43,422,10.189573459715639
14131,330455705120020,49,63,93,66,77,77,43,37,425,80,505,15.841584158415841
14132,330455705120021,31,54,79,65,57,67,56,43,353,99,452,21.902654867256636
14133,330455705120022,97,121,138,145,119,114,57,69,734,126,860,14.651162790697674
14134,330455705120023,106,123,160,164,148,90,50,49,791,99,890,11.123595505617978
14135,330455705120025,13,16,24,30,23,24,15,20,130,35,165,21.21212121212121
14136,330455705120026,160,135,139,86,104,72,21,10,696,31,727,4.264099037138927
14137,330455705120027,132,123,90,89,51,33,13,7,518,20,538,3.717472118959108
14138,330455705120028,117,124,190,148,98,77,39,20,754,59,813,7.2570725707257075
14139,330455705120029,100,139,101,94,96,76,31,35,606,66,672,9.821428571428571
14140,330455705120030,51,77,68,64,57,45,21,18,362,39,401,9.72568578553616
14141,330455705120031,269,260,270,206,159,121,40,38,1285,78,1363,5.7226705796038155
14142,330455705120032,161,156,146,95,84,62,26,33,704,59,763,7.732634338138925
14143,330455705120033,225,227,218,119,162,126,55,41,1077,96,1173,8.184143222506394
14144,330455705120034,180,188,145,128,82,61,37,28,784,65,849,7.656065959952886
14145,330455705120035,33,20,18,14,21,7,5,4,113,9,122,7.377049180327869
14146,330455705120036,87,109,130,71,84,58,39,22,539,61,600,10.166666666666666
14147,330455705120037,131,161,168,100,89,112,46,47,761,93,854,10.889929742388759
14148,330455705120038,237,248,206,185,143,105,66,43,1124,109,1233,8.840227088402271
14149,330455705120039,127,113,126,69,75,50,33,25,560,58,618,9.385113268608414
14150,330455705120040,73,62,56,42,30,27,20,8,290,28,318,8.80503144654088
14151,330455705120041,68,93,74,59,45,38,11,9,377,20,397,5.037783375314861
14152,330455705120042,23,45,38,30,18,22,13,4,176,17,193,8.808290155440414
14153,330455705120043,40,36,50,37,43,24,17,15,230,32,262,12.213740458015268
14154,330455705120044,151,187,179,128,122,116,66,52,883,118,1001,11.788211788211788
14155,330455705120045,160,163,245,186,109,75,41,27,938,68,1006,6.759443339960239
14156,330455705120046,93,92,115,99,81,44,25,26,524,51,575,8.869565217391305
14157,330455705120047,193,234,255,179,136,119,39,72,1116,111,1227,9.04645476772616
14158,330455705120048,67,99,109,90,67,71,59,30,503,89,592,15.033783783783784
14159,330455705120049,69,68,80,73,53,52,27,27,395,54,449,12.026726057906458
14160,330455705120050,94,83,123,89,91,74,46,38,554,84,638,13.16614420062696
14161,330455705120051,97,109,158,120,100,88,52,52,672,104,776,13.402061855670103
14162,330455705120052,77,104,124,102,88,59,27,26,554,53,607,8.731466227347612
14163,330455705120053,120,120,141,155,112,106,54,41,754,95,849,11.189634864546525
14164,330455705120054,30,51,47,36,34,20,10,20,218,30,248,12.096774193548388
14165,330455705120055,119,162,162,166,157,101,63,48,867,111,978,11.349693251533742
14166,330455705120056,58,90,115,98,103,107,62,58,571,120,691,17.36613603473227
14167,330455705120057,103,164,168,156,165,126,74,72,882,146,1028,14.202334630350194
14168,330455705120058,72,85,132,117,97,83,51,58,586,109,695,15.683453237410072
14169,330455705120059,54,75,111,96,104,110,75,130,550,205,755,27.1523178807947
14170,330455705120060,53,70,75,76,99,72,41,68,445,109,554,19.67509025270758
14171,330455705120061,71,99,106,132,140,97,62,79,645,141,786,17.938931297709924
14172,330455705120062,33,32,54,46,41,35,17,18,241,35,276,12.681159420289855
14173,330455705120063,31,28,34,41,42,43,33,16,219,49,268,18.28358208955224
14174,330455705120064,52,69,90,78,84,59,28,41,432,69,501,13.77245508982036
14175,330455705120065,41,46,75,67,68,78,41,43,375,84,459,18.30065359477124
14176,330455705120066,37,64,71,65,67,72,53,88,376,141,517,27.272727272727273
14177,330455705120067,16,24,32,31,29,33,14,16,165,30,195,15.384615384615385
14178,330455705120068,30,35,88,61,75,94,53,49,383,102,485,21.030927835051546
14179,330455705120069,79,109,115,112,126,116,75,71,657,146,803,18.181818181818183
14180,330455705120070,101,135,108,108,125,78,58,74,655,132,787,16.772554002541295
14181,330455705120071,16,21,32,39,47,27,35,20,182,55,237,23.206751054852322
14182,330455705120072,104,138,191,167,128,139,83,60,867,143,1010,14.158415841584159
14183,330455705120073,42,65,93,58,75,78,31,43,411,74,485,15.257731958762887
14184,330455705120074,56,55,78,54,60,37,30,26,340,56,396,14.141414141414142
14185,330455705120075,30,39,69,65,71,62,41,26,336,67,403,16.62531017369727
14186,330455705120076,30,40,59,60,49,63,36,52,301,88,389,22.62210796915167
14187,330455705120077,28,43,61,65,84,59,59,84,340,143,483,29.606625258799173
14188,330455705120078,28,46,69,51,69,47,50,63,310,113,423,26.713947990543737
14189,330455705120079,41,56,66,113,59,40,21,20,375,41,416,9.85576923076923
14190,330455705120080,32,54,85,77,87,78,83,81,413,164,577,28.422876949740036
14191,330455705120081,17,43,62,57,50,57,33,43,286,76,362,20.994475138121548
14192,330455705120082,55,84,101,110,102,121,85,84,573,169,742,22.776280323450134
14193,330455705120083,44,72,117,109,94,92,75,67,528,142,670,21.19402985074627
14194,330455705120084,47,64,82,63,60,59,34,32,375,66,441,14.965986394557824
14195,330455705120085,52,78,98,88,64,62,40,24,442,64,506,12.648221343873518
14196,330455705120086,32,48,62,52,47,76,32,50,317,82,399,20.551378446115287
14197,330455705120087,45,72,76,92,92,87,70,93,464,163,627,25.996810207336523
14198,330455705120088,43,78,103,97,118,96,56,82,535,138,673,20.505200594353642
14199,330455705120089,40,46,86,55,56,46,40,25,329,65,394,16.497461928934012
14201,330455705120091,45,61,68,75,86,72,52,56,407,108,515,20.97087378640777
14202,330455705120092,31,46,75,52,63,60,47,81,327,128,455,28.13186813186813
14203,330455705120093,62,72,77,74,54,42,20,26,381,46,427,10.772833723653395
14204,330455705120094,96,130,109,99,86,72,40,36,592,76,668,11.377245508982035
14205,330455705120095,161,143,147,131,90,60,34,18,732,52,784,6.63265306122449
14206,330455705120096,100,130,164,170,126,122,74,84,812,158,970,16.288659793814432
14207,330455705120097,156,205,173,169,130,91,51,41,924,92,1016,9.05511811023622
14208,330455705120098,88,73,90,71,61,46,21,24,429,45,474,9.49367088607595
14209,330455705120099,97,98,121,90,74,68,45,27,548,72,620,11.612903225806452
14210,330455705120100,109,139,126,134,97,87,55,59,692,114,806,14.1439205955335
14211,330455705120101,59,69,86,65,48,57,43,24,384,67,451,14.855875831485587
14212,330455705120102,72,94,97,86,105,95,55,59,549,114,663,17.194570135746606
14213,330455705120103,7,12,14,8,7,15,8,6,63,14,77,18.181818181818183
14214,330455705120104,33,31,31,30,30,28,25,11,183,36,219,16.438356164383563
14215,330455705120105,55,66,86,56,40,56,20,24,359,44,403,10.918114143920596
14216,330455705120106,139,78,126,77,35,31,8,7,486,15,501,2.9940119760479043
14217,330455705120107,48,79,76,70,57,62,60,35,392,95,487,19.50718685831622
14218,330455705120108,62,78,121,100,91,112,48,59,564,107,671,15.946348733233979
14219,330455705120109,5,6,10,6,4,2,6,4,33,10,43,23.25581395348837
14220,330455705120110,100,96,125,108,61,48,43,21,538,64,602,10.631229235880399
14221,330455705120111,17,18,26,27,24,24,13,26,136,39,175,22.285714285714285
14222,330455705120112,291,263,386,264,202,176,106,107,1582,213,1795,11.866295264623956
14223,330455705120113,19,36,54,39,58,39,35,24,245,59,304,19.407894736842106
14224,330455705120114,46,71,45,50,36,37,15,7,285,22,307,7.166123778501628
14225,330455705120115,100,115,162,106,125,149,85,60,757,145,902,16.075388026607538
14226,330455705120116,2,3,0,6,3,0,2,3,14,5,19,26.31578947368421
14227,330455705120117,60,67,99,63,64,31,30,29,384,59,443,13.318284424379232
14228,330455705120118,112,92,157,120,77,53,37,24,611,61,672,9.077380952380953
14229,330455705120119,27,26,33,28,20,21,7,7,155,14,169,8.284023668639053
14230,330455705120120,18,20,53,30,32,37,22,27,190,49,239,20.502092050209207
14232,330455705120122,1,1,5,0,6,4,0,1,17,1,18,5.555555555555555
14233,330455705120123,21,26,33,32,27,39,22,19,178,41,219,18.72146118721461
14234,330455705120124,10,8,7,14,16,13,10,9,68,19,87,21.839080459770116
14235,330455705120125,22,44,49,46,55,43,42,50,259,92,351,26.210826210826212
14238,330455705120129,22,27,25,29,15,21,11,14,139,25,164,15.24390243902439
14239,330455705120130,22,52,69,54,78,87,40,62,362,102,464,21.982758620689655
14240,330455705120131,64,61,132,154,79,74,46,31,564,77,641,12.012480499219969
14241,330455705120132,94,72,59,66,31,18,7,5,340,12,352,3.409090909090909
14242,330455705120133,95,109,73,83,52,41,11,2,453,13,466,2.7896995708154506
14243,330455705120134,164,176,120,156,85,41,13,3,742,16,758,2.1108179419525066
14244,330455705120135,26,26,29,23,18,15,8,7,137,15,152,9.868421052631579
14245,330455705120136,35,39,58,49,35,32,14,12,248,26,274,9.489051094890511
14246,330455705120137,97,80,120,78,72,29,13,4,476,17,493,3.4482758620689653
14247,330455705120138,55,61,52,59,48,62,20,15,337,35,372,9.408602150537634
14248,330455705120139,192,172,182,135,56,40,21,16,777,37,814,4.545454545454546
14249,330455705120140,88,81,77,69,46,37,16,14,398,30,428,7.009345794392523
14250,330455705120141,32,59,36,37,37,17,7,6,218,13,231,5.627705627705628
14251,330455705120142,28,42,33,27,28,20,9,14,178,23,201,11.442786069651742
14252,330455705120143,62,61,71,48,49,41,24,20,332,44,376,11.702127659574469
14253,330455705120144,46,56,57,65,31,19,13,0,274,13,287,4.529616724738676
14254,330455705120145,29,24,38,34,27,11,7,7,163,14,177,7.909604519774011
14255,330455705120146,215,248,241,232,175,154,92,78,1265,170,1435,11.846689895470384
14256,330455705120147,12,14,21,19,14,10,10,8,90,18,108,16.666666666666668
14257,330455705120148,15,17,21,18,18,11,8,7,100,15,115,13.043478260869565
14258,330455705120149,14,13,19,20,11,4,8,5,81,13,94,13.829787234042554
14259,330455705120150,95,62,121,89,72,58,32,25,497,57,554,10.288808664259928
14260,330455705120151,99,67,98,57,57,42,15,7,420,22,442,4.97737556561086
14261,330455705120152,91,100,92,73,53,37,19,7,446,26,472,5.508474576271187
14262,330455705130001,15,15,43,33,27,60,44,84,193,128,321,39.875389408099686
14263,330455705130002,19,28,48,40,53,56,51,97,244,148,392,37.755102040816325
14264,330455705130003,7,16,34,41,28,35,39,49,161,88,249,35.34136546184739
14265,330455705130004,45,69,131,99,97,129,71,89,570,160,730,21.91780821917808
14266,330455705130005,37,55,107,117,94,93,84,101,503,185,688,26.88953488372093
14267,330455705130006,75,60,97,143,101,107,79,110,583,189,772,24.481865284974095
14268,330455705130007,34,64,83,95,89,85,78,160,450,238,688,34.593023255813954
14269,330455705130008,13,20,42,37,36,43,47,70,191,117,308,37.98701298701299
14270,330455705130009,38,40,83,85,78,85,87,168,409,255,664,38.403614457831324
14271,330455705130010,57,80,116,114,128,148,82,135,643,217,860,25.232558139534884
14272,330455705130011,30,40,120,112,100,99,79,94,501,173,674,25.66765578635015
14273,330455705130012,47,37,72,66,77,63,57,41,362,98,460,21.304347826086957
14274,330455705130013,36,61,89,84,78,71,58,89,419,147,566,25.97173144876325
14275,330455705130014,36,49,101,92,66,120,75,82,464,157,621,25.281803542673106
14276,330455705130015,35,60,82,71,69,65,48,44,382,92,474,19.40928270042194
14277,330455705130016,34,42,48,53,66,49,50,76,292,126,418,30.14354066985646
14278,330455705130017,46,50,117,98,82,127,69,98,520,167,687,24.308588064046578
14279,330455705130018,46,77,96,100,138,112,81,116,569,197,766,25.718015665796344
14280,330455705130019,49,53,85,81,101,90,72,70,459,142,601,23.62728785357737
14281,330455705130020,80,87,104,119,131,114,99,126,635,225,860,26.162790697674417
14282,330455705130021,24,28,64,49,65,47,70,67,277,137,414,33.091787439613526
14283,330455705130022,11,14,38,27,23,39,32,39,152,71,223,31.838565022421523
14284,330455705130023,20,39,67,84,51,64,63,139,325,202,527,38.33017077798861
14285,330455705130024,26,43,77,68,74,79,62,123,367,185,552,33.51449275362319
14286,330455705130026,16,26,75,56,55,59,66,125,287,191,478,39.9581589958159
14287,330455705130027,12,23,74,56,43,46,63,98,254,161,415,38.795180722891565
14288,330455705130028,20,34,61,47,63,63,49,110,288,159,447,35.57046979865772
14289,330455705130029,40,65,129,77,96,106,92,150,513,242,755,32.05298013245033
14290,330455705130030,30,42,120,93,87,84,118,146,456,264,720,36.666666666666664
14291,330455705130031,34,45,96,110,97,103,86,151,485,237,722,32.825484764542935
14292,330455705130032,50,51,104,118,97,139,103,146,559,249,808,30.816831683168317
14293,330455705130033,29,43,91,56,51,104,74,113,374,187,561,33.333333333333336
14294,330455705130034,17,30,91,56,44,74,93,129,312,222,534,41.57303370786517
14295,330455705130035,25,26,58,58,55,45,42,72,267,114,381,29.921259842519685
14296,330455705130036,30,32,74,72,67,81,71,91,356,162,518,31.274131274131275
14297,330455705130037,33,30,80,67,72,63,60,109,345,169,514,32.87937743190661
14298,330455705130038,28,40,50,53,64,42,35,42,277,77,354,21.75141242937853
14299,330455705130039,33,54,70,99,82,85,59,79,423,138,561,24.59893048128342
14300,330455705130040,50,65,115,94,109,91,59,61,524,120,644,18.633540372670808
14301,330455705130041,76,72,73,50,59,42,11,13,372,24,396,6.0606060606060606
14302,330455705130042,67,58,68,36,40,20,14,5,289,19,308,6.1688311688311686
14303,330455705130043,102,128,106,59,54,28,17,13,477,30,507,5.9171597633136095
14304,330455705130044,71,53,78,54,40,28,19,10,324,29,353,8.215297450424929
14305,330455705130045,124,129,89,64,50,37,11,10,493,21,514,4.085603112840467
14306,330455705130046,102,101,90,72,41,39,11,10,445,21,466,4.506437768240343
14307,330455705130047,48,73,37,37,30,18,16,7,243,23,266,8.646616541353383
14308,330455705130048,45,72,52,48,53,31,20,18,301,38,339,11.2094395280236
14309,330455705130049,47,79,119,73,87,140,95,138,545,233,778,29.948586118251928
14310,330455705130050,56,57,84,91,105,73,64,62,466,126,592,21.283783783783782
14311,330455705130051,19,30,40,44,41,35,19,29,209,48,257,18.67704280155642
14312,330455705130052,47,82,75,91,107,85,64,66,487,130,617,21.06969205834684
14313,330455705130053,65,109,115,86,131,146,75,79,652,154,806,19.106699751861044
14314,330455705130055,40,60,66,77,81,92,74,111,416,185,601,30.782029950083196
14315,330455705130056,24,54,76,69,68,71,84,86,362,170,532,31.954887218045112
14316,330455705130057,48,74,103,110,109,127,83,122,571,205,776,26.417525773195877
14317,330455705130058,36,60,85,102,86,94,75,146,463,221,684,32.30994152046784
14318,330455705130059,25,43,67,66,61,78,64,81,340,145,485,29.896907216494846
14319,330455705130060,32,69,104,76,93,95,69,93,469,162,631,25.673534072900157
14320,330455705130061,22,34,55,70,54,59,50,61,294,111,405,27.40740740740741
14321,330455705130062,41,56,79,71,85,89,70,92,421,162,583,27.78730703259005
14322,330455705130063,24,41,62,51,50,64,54,81,292,135,427,31.615925058548008
14323,330455705130064,45,79,115,82,124,126,99,146,571,245,816,30.024509803921568
14324,330455705130065,43,88,98,92,102,123,83,134,546,217,763,28.440366972477065
14325,330455705130066,60,75,120,95,104,109,99,135,563,234,797,29.360100376411545
14326,330455705130067,20,29,54,37,48,58,45,73,246,118,364,32.417582417582416
14327,330455705130068,42,80,136,108,130,129,99,211,625,310,935,33.155080213903744
14328,330455705130069,53,66,130,120,113,136,121,175,618,296,914,32.38512035010941
14329,330455705130070,25,31,80,55,52,59,91,128,302,219,521,42.034548944337814
14330,330455705130071,24,49,52,68,70,68,53,104,331,157,488,32.17213114754098
14331,330455705130072,32,46,92,100,66,92,57,118,428,175,603,29.021558872305143
14332,330455705130073,19,25,61,51,41,46,53,72,243,125,368,33.96739130434783
14333,330455705130074,18,19,49,52,36,28,15,19,202,34,236,14.40677966101695
14334,330455705130075,24,40,69,50,62,109,78,82,354,160,514,31.1284046692607
14335,330455705130076,23,70,88,71,73,115,53,64,440,117,557,21.005385996409334
14336,330455705130077,24,59,81,62,91,77,61,125,394,186,580,32.06896551724138
14337,330455705130078,40,53,86,82,67,92,101,98,420,199,619,32.14862681744749
14338,330455705130079,23,50,88,68,68,113,88,138,410,226,636,35.534591194968556
14339,330455705130080,40,52,89,87,90,92,72,93,450,165,615,26.829268292682926
14340,330455705130081,26,50,85,44,71,65,51,90,341,141,482,29.25311203319502
14341,330455705130082,37,79,161,124,123,154,92,144,678,236,914,25.820568927789935
14342,330455705130083,41,68,98,111,107,102,60,118,527,178,705,25.24822695035461
14343,330455705130084,34,54,122,118,105,108,66,105,541,171,712,24.01685393258427
14344,330455705130085,29,66,64,78,84,81,41,83,402,124,526,23.574144486692017
14346,330455705130087,49,68,99,101,129,103,67,106,549,173,722,23.9612188365651
14347,330455705130088,39,62,95,73,100,98,68,84,467,152,619,24.55573505654281
14348,330455705130089,35,38,82,78,57,65,47,73,355,120,475,25.263157894736842
14349,330455705130090,37,40,75,75,68,72,85,79,367,164,531,30.88512241054614
14350,330455705130091,24,70,109,114,134,97,74,135,548,209,757,27.60898282694848
14351,330455705130092,18,31,51,56,54,59,42,102,269,144,413,34.86682808716707
14352,330455705130093,51,73,107,127,129,103,78,100,590,178,768,23.177083333333332
14353,330455705130094,70,87,128,152,157,130,102,139,724,241,965,24.974093264248705
14354,330455705130095,29,55,60,67,79,92,62,86,382,148,530,27.92452830188679
14355,330455705130096,24,46,72,66,65,97,80,129,370,209,579,36.09671848013817
14356,330455705130097,25,27,86,69,60,86,72,123,353,195,548,35.583941605839414
14357,330455705130098,35,36,80,60,67,82,75,101,360,176,536,32.83582089552239
14358,330455705130099,44,62,115,108,113,119,84,142,561,226,787,28.716645489199493
14359,330455705130100,27,38,70,65,80,63,46,88,343,134,477,28.09224318658281
14360,330455705130101,18,46,72,65,73,72,48,107,346,155,501,30.93812375249501
14361,330455705130102,34,27,45,63,72,49,34,65,290,99,389,25.44987146529563
14362,330455705130103,19,36,63,47,71,62,42,72,298,114,412,27.66990291262136
14363,330455705130104,25,39,60,70,63,58,52,81,315,133,448,29.6875
14364,330455705130105,24,43,74,57,48,87,63,101,333,164,497,32.99798792756539
14365,330455705130106,30,31,64,49,71,74,68,117,319,185,504,36.70634920634921
14366,330455705130107,29,43,59,59,80,74,54,111,344,165,509,32.416502946954814
14367,330455705130108,20,32,80,59,57,96,58,101,344,159,503,31.610337972167
14368,330455705130109,37,44,55,65,80,75,43,61,356,104,460,22.608695652173914
14369,330455705130110,32,53,90,56,87,93,63,102,411,165,576,28.645833333333332
14370,330455705130111,67,93,123,111,147,119,81,103,660,184,844,21.80094786729858
14371,330455705130112,14,18,52,35,46,27,34,36,192,70,262,26.717557251908396
14372,330455705130113,29,32,82,70,54,58,46,91,325,137,462,29.653679653679653
14373,330455705130114,40,51,68,72,77,70,40,110,378,150,528,28.40909090909091
14374,330455705130115,24,40,87,51,56,72,43,49,330,92,422,21.80094786729858
14375,330455705130116,19,29,69,47,47,48,54,71,259,125,384,32.552083333333336
14376,330455705130117,43,62,95,89,112,93,95,158,494,253,747,33.86880856760375
14377,330455705130118,32,49,53,74,66,56,41,53,330,94,424,22.169811320754718
14378,330455705130119,76,96,163,139,140,161,87,107,775,194,969,20.020639834881322
14379,330455705130120,4,11,7,9,16,13,8,102,60,110,170,64.70588235294117
14380,330455705130121,65,68,110,95,105,122,83,93,565,176,741,23.751686909581647
14381,330455705130122,47,71,137,133,110,111,89,116,609,205,814,25.184275184275183
14382,330455705130123,24,52,101,107,95,97,79,81,476,160,636,25.157232704402517
14383,330455705130124,28,51,73,57,72,87,38,94,368,132,500,26.4
14384,330455705130125,28,34,55,74,62,60,56,92,313,148,461,32.10412147505423
14385,330455705130126,31,39,69,53,60,60,54,92,312,146,458,31.87772925764192
14386,330455705130127,59,54,99,83,106,91,56,121,492,177,669,26.457399103139014
14387,330455705130128,32,66,100,69,97,108,82,102,472,184,656,28.048780487804876
14388,330455705130129,62,88,122,108,101,118,83,98,599,181,780,23.205128205128204
14389,330455705130130,29,52,73,91,79,85,78,87,409,165,574,28.745644599303137
14390,330455705130131,18,33,50,33,64,55,32,39,253,71,324,21.91358024691358
14391,330455705130132,49,54,75,76,78,86,70,105,418,175,593,29.51096121416526
14392,330455705130133,36,43,115,76,84,82,66,110,436,176,612,28.758169934640524
14393,330455705130134,20,45,101,67,74,91,59,94,398,153,551,27.76769509981851
14394,330455705130135,31,39,77,56,58,94,56,97,355,153,508,30.118110236220474
14395,330455705130136,47,63,101,96,107,105,97,139,519,236,755,31.258278145695364
14396,330455705130137,56,71,124,119,106,117,77,130,593,207,800,25.875
14397,330455705130138,39,76,136,108,114,132,97,130,605,227,832,27.283653846153847
14398,330455705130139,44,61,92,96,92,104,91,128,489,219,708,30.93220338983051
14399,330455705130140,40,46,81,96,65,89,104,140,417,244,661,36.91376701966717
14400,330455705130141,55,77,118,95,87,117,103,108,549,211,760,27.763157894736842
14401,330455705130142,54,87,119,122,106,150,83,155,638,238,876,27.168949771689498
14402,330455705130143,28,29,50,58,70,72,67,84,307,151,458,32.96943231441048
14403,330455705130144,35,40,88,65,72,74,57,71,374,128,502,25.49800796812749
14404,330455705130145,39,63,92,102,87,85,56,61,468,117,585,20.0
14405,330455705130146,36,49,84,91,63,96,100,116,419,216,635,34.01574803149607
14406,330455705130147,43,67,128,108,125,140,78,124,611,202,813,24.846248462484624
14407,330455705130148,25,60,94,63,73,80,66,117,395,183,578,31.66089965397924
14408,330455705130149,38,59,121,104,78,108,65,45,508,110,618,17.79935275080906
14409,330455705130150,61,73,107,121,78,98,41,49,538,90,628,14.331210191082803
14410,330455705130151,42,52,79,75,58,64,40,39,370,79,449,17.59465478841871
14411,330455705130152,49,91,126,116,92,103,58,111,577,169,746,22.654155495978554
14412,330455705130153,212,253,263,184,201,148,96,55,1261,151,1412,10.694050991501417
14413,330455705130154,32,45,31,21,18,17,6,6,164,12,176,6.818181818181818
14414,330455705130155,61,67,36,53,30,13,9,5,260,14,274,5.109489051094891
14415,330455705130156,217,233,225,173,155,95,48,31,1098,79,1177,6.711979609175871
14416,330455705130157,36,43,26,26,13,16,7,2,160,9,169,5.325443786982248
14417,330455705130158,13,7,14,9,4,3,3,1,50,4,54,7.407407407407407
14418,330455705130159,58,92,123,123,129,113,73,75,638,148,786,18.829516539440203
14419,330455705130160,75,77,129,118,84,110,55,37,593,92,685,13.430656934306569
14420,330455705130161,44,65,180,132,93,120,98,85,634,183,817,22.399020807833537
14421,330455705130162,41,52,107,81,87,110,102,130,478,232,710,32.67605633802817
14422,330455705130163,26,34,82,56,62,76,66,106,336,172,508,33.85826771653543
14423,330455705130164,39,75,99,85,86,129,113,145,513,258,771,33.463035019455255
14424,330455705130165,25,40,87,83,64,85,88,90,384,178,562,31.672597864768683
14425,330455705130166,22,26,39,48,53,53,52,76,241,128,369,34.68834688346883
14426,330455705130167,19,38,53,57,65,45,42,72,277,114,391,29.156010230179028
14427,330455705130168,41,44,83,75,73,85,40,38,401,78,479,16.2839248434238
14428,330455705130169,25,48,69,55,80,75,45,41,352,86,438,19.634703196347033
14429,330455705130170,26,57,96,72,68,101,86,137,420,223,643,34.68118195956454
14430,330455705130171,44,83,99,119,106,109,52,71,560,123,683,18.00878477306003
14431,330455705130172,31,48,69,74,80,73,53,90,375,143,518,27.606177606177607
14432,330455705130173,67,81,119,111,139,108,88,96,625,184,809,22.744128553770086
14433,330455705130174,26,47,76,61,70,83,77,122,363,199,562,35.40925266903915
14434,330455705130175,63,86,137,124,123,142,97,136,675,233,908,25.66079295154185
14435,330455705130176,7,22,12,24,17,19,14,21,101,35,136,25.735294117647058
14436,330455705130177,48,95,112,75,108,140,70,85,578,155,733,21.145975443383357
14437,330455705130178,45,62,56,66,74,85,49,77,388,126,514,24.513618677042803
14438,330455705130179,198,234,221,181,132,119,46,27,1085,73,1158,6.303972366148532
14439,330455705130180,104,105,83,72,62,40,33,14,466,47,513,9.161793372319687
14440,330455705130181,26,25,42,26,31,22,15,6,172,21,193,10.880829015544041
14441,330455705130182,79,133,80,65,71,36,13,19,464,32,496,6.451612903225806
14442,330455705130183,34,41,66,75,71,58,71,119,345,190,535,35.51401869158879
14443,330455705130184,26,60,78,65,85,83,72,74,397,146,543,26.887661141804788
14444,330455705130185,3,6,13,10,5,3,3,0,40,3,43,6.976744186046512
14445,330455705130186,20,36,58,56,56,77,52,84,303,136,439,30.979498861047837
14446,330455705130187,37,75,68,84,89,91,95,71,444,166,610,27.21311475409836
14447,330455705130188,37,58,66,57,83,56,61,78,357,139,496,28.024193548387096
14448,330455705130189,33,64,96,90,93,100,91,90,476,181,657,27.549467275494674
14449,330455705130190,25,54,86,70,70,61,68,56,366,124,490,25.306122448979593
14450,330455705130191,33,52,80,83,82,91,55,64,421,119,540,22.037037037037038
14451,330455705130192,45,56,74,83,82,80,67,71,420,138,558,24.731182795698924
14452,330455705130193,43,71,143,104,129,129,99,115,619,214,833,25.690276110444177
14453,330455705130195,53,73,112,110,101,100,50,89,549,139,688,20.203488372093023
14454,330455705130196,28,32,55,60,47,68,51,48,290,99,389,25.44987146529563
14455,330455705130197,44,51,76,90,88,80,59,87,429,146,575,25.391304347826086
14456,330455705130198,25,60,51,54,64,73,37,59,327,96,423,22.69503546099291
14457,330455705130199,42,72,81,56,85,61,53,63,397,116,513,22.612085769980506
14458,330455705130200,66,90,117,99,121,108,68,86,601,154,755,20.397350993377483
14459,330455705130201,156,200,211,220,159,165,89,70,1111,159,1270,12.51968503937008
14460,330455705130202,142,159,163,188,118,98,31,26,868,57,925,6.162162162162162
14461,330455705130203,148,184,190,174,102,96,26,19,894,45,939,4.792332268370607
14462,330455705130204,159,167,171,140,103,75,43,29,815,72,887,8.117249154453214
14463,330455705130205,196,190,169,186,91,72,21,19,904,40,944,4.237288135593221
14464,330455705130206,115,102,133,88,73,50,27,22,561,49,610,8.032786885245901
14465,330455705130207,71,80,44,50,41,12,6,3,298,9,307,2.9315960912052117
14466,330455705130208,136,182,184,162,121,111,59,40,896,99,995,9.949748743718592
14467,330455705130209,95,77,81,80,62,35,28,18,430,46,476,9.663865546218487
14468,330455705130210,139,161,169,100,82,66,43,40,717,83,800,10.375
14469,330455705130211,20,35,29,18,23,19,5,5,144,10,154,6.4935064935064934
14470,330455705130212,36,47,33,71,59,43,36,32,289,68,357,19.047619047619047
14471,330455705130213,48,65,115,96,89,85,37,48,498,85,583,14.579759862778731
14472,330455705130215,45,57,109,84,79,86,59,74,460,133,593,22.4283305227656
14473,330455705130216,45,48,82,100,68,85,58,68,428,126,554,22.743682310469314
14474,330455705130217,25,42,38,45,45,42,35,24,237,59,296,19.93243243243243
14476,330455705130219,21,33,56,29,40,53,33,39,232,72,304,23.68421052631579
14477,330455705130220,34,39,84,72,78,62,65,53,369,118,487,24.229979466119097
14478,330455705130221,45,76,106,117,109,127,104,82,580,186,766,24.281984334203656
14479,330455705130222,43,58,65,78,90,66,73,66,400,139,539,25.788497217068645
14480,330455705130223,36,40,61,47,59,70,57,52,313,109,422,25.829383886255926
14481,330455705130224,35,59,106,100,94,101,102,150,495,252,747,33.734939759036145
14482,330455705130225,49,58,75,80,104,93,68,102,459,170,629,27.027027027027028
14483,330455705130226,33,42,72,69,71,85,54,69,372,123,495,24.848484848484848
14484,330455705130227,49,87,125,110,127,138,81,76,636,157,793,19.798234552332914
14485,330455705130228,71,107,123,112,149,122,68,87,684,155,839,18.474374255065555
14486,330455705130229,139,129,100,171,175,133,46,57,847,103,950,10.842105263157896
14487,330455705130230,30,38,37,49,52,37,20,17,243,37,280,13.214285714285714
14488,330455705130231,34,52,91,92,82,77,51,59,428,110,538,20.44609665427509
14489,330455705130232,73,95,131,146,109,92,83,59,646,142,788,18.02030456852792
14490,330455705130233,29,49,64,77,82,68,56,52,369,108,477,22.641509433962263
14491,330455705130234,24,33,58,72,59,69,41,57,315,98,413,23.728813559322035
14492,330455705130235,48,85,147,130,108,146,88,93,664,181,845,21.420118343195266
14493,330455705130236,37,38,65,52,54,74,40,73,320,113,433,26.09699769053118
14494,330455705130237,20,55,58,52,76,63,50,73,324,123,447,27.516778523489933
14495,330455705130238,47,51,97,80,79,96,76,91,450,167,617,27.06645056726094
14496,330455705130239,31,46,66,77,58,75,68,76,353,144,497,28.973843058350102
14497,330455705130240,37,44,109,138,84,111,83,178,523,261,784,33.29081632653061
14498,330455705130241,39,65,64,84,67,71,71,103,390,174,564,30.851063829787233
14499,330455705130242,32,35,93,73,70,92,70,102,395,172,567,30.335097001763668
14500,330455705130243,17,32,43,44,47,35,32,40,218,72,290,24.82758620689655
14501,330455705130244,38,63,92,71,97,98,71,106,459,177,636,27.830188679245282
14502,330455705130245,11,21,30,41,40,45,42,63,188,105,293,35.83617747440273
14503,330455705130246,40,61,75,63,81,102,70,70,422,140,562,24.91103202846975
14504,330455705130247,34,53,62,84,85,72,45,60,390,105,495,21.21212121212121
14505,330455705130248,49,47,97,111,72,92,104,97,468,201,669,30.044843049327355
14506,330455705130249,75,102,139,162,167,148,100,110,793,210,1003,20.937188434695912
14507,330455705130250,24,44,63,57,61,70,29,52,319,81,400,20.25
14508,330455705130251,54,53,74,81,107,87,79,96,456,175,631,27.733755942947703
14509,330455705130252,61,84,117,143,129,154,98,128,688,226,914,24.72647702407002
14510,330455705130253,57,99,109,118,130,124,113,131,637,244,881,27.695800227014757
14511,330455705130254,26,49,54,38,61,73,47,85,301,132,433,30.484988452655887
14512,330455705130255,53,69,119,101,82,128,87,114,552,201,753,26.693227091633467
14513,330455705130256,23,43,71,64,66,69,59,90,336,149,485,30.721649484536083
14514,330455705130257,24,49,97,69,56,103,76,111,398,187,585,31.965811965811966
14515,330455705130258,44,64,85,91,107,92,69,118,483,187,670,27.91044776119403
14516,330455705130259,92,106,91,84,60,51,22,19,484,41,525,7.809523809523809
14517,330455705130260,63,88,57,60,53,26,16,10,347,26,373,6.970509383378016
14518,330455705130261,46,75,51,39,54,45,20,28,310,48,358,13.40782122905028
14519,330455705130262,238,227,279,176,129,89,54,29,1138,83,1221,6.797706797706797
14520,330455705130263,22,39,44,43,51,46,32,43,245,75,320,23.4375
14521,330455705130264,26,63,91,79,89,74,55,78,422,133,555,23.963963963963963
14522,330455705130265,40,50,78,90,90,66,69,100,414,169,583,28.987993138936535
14523,330455705130266,39,60,86,79,92,80,62,86,436,148,584,25.34246575342466
14524,330455705130267,56,97,97,120,111,109,112,130,590,242,832,29.08653846153846
14525,330455705130268,84,106,113,155,155,96,61,66,709,127,836,15.191387559808613
14526,330455705130269,28,54,123,82,71,132,95,80,490,175,665,26.31578947368421
14527,330455705130270,23,31,92,71,72,80,48,58,369,106,475,22.31578947368421
14528,330455705130271,13,21,22,27,34,30,28,31,147,59,206,28.640776699029125
14529,330455705130272,29,52,89,66,69,60,49,48,365,97,462,20.995670995670995
14530,330455705130273,73,63,140,142,103,115,90,114,636,204,840,24.285714285714285
14531,330455705130274,30,63,102,72,84,72,59,84,423,143,566,25.26501766784452
14532,330455705130275,46,54,108,110,89,101,57,42,508,99,607,16.30971993410214
14533,330455705130276,99,112,132,88,97,85,38,35,613,73,686,10.641399416909621
14534,330455705130277,40,44,72,59,72,64,41,53,351,94,445,21.123595505617978
14535,330455705130278,35,53,52,62,75,73,54,50,350,104,454,22.90748898678414
14536,330455705130279,148,165,160,164,151,136,98,64,924,162,1086,14.917127071823204
14537,330455705130280,105,141,132,123,129,140,92,130,770,222,992,22.379032258064516
14538,330455705130281,60,84,80,88,80,116,51,41,508,92,600,15.333333333333334
14539,330455705130282,126,159,149,154,114,94,48,27,796,75,871,8.610792192881744
14540,330455705130283,49,63,79,76,77,49,36,37,393,73,466,15.665236051502147
14541,330455705130284,87,92,103,141,92,106,62,65,621,127,748,16.97860962566845
14542,330455705130285,45,64,82,60,81,86,49,80,418,129,547,23.583180987202926
14543,330455705130286,24,40,47,41,57,49,29,44,258,73,331,22.05438066465257
14544,330455705130287,68,74,95,80,90,68,53,110,475,163,638,25.54858934169279
14545,330455705130289,47,57,71,59,75,68,64,83,377,147,524,28.053435114503817
14546,330455705130290,23,16,34,22,20,21,13,10,136,23,159,14.465408805031446
14547,330455705130291,79,107,88,95,81,85,40,36,535,76,611,12.438625204582651
14548,330455705130292,66,100,131,136,88,136,78,78,657,156,813,19.18819188191882
14549,330455705130293,52,66,118,149,97,88,57,52,570,109,679,16.05301914580265
14550,330455705130294,44,50,84,82,80,78,75,83,418,158,576,27.430555555555557
14551,330455705130295,30,38,50,57,65,66,73,105,306,178,484,36.77685950413223
14552,330455705130296,34,54,79,76,84,85,63,97,412,160,572,27.972027972027973
14553,330455705130297,8,14,41,33,32,31,38,86,159,124,283,43.81625441696113
14554,330455705130298,21,44,77,72,66,68,54,98,348,152,500,30.4
14555,330455705130299,31,64,70,68,78,78,50,58,389,108,497,21.730382293762574
14556,330455705130300,15,21,48,57,60,46,42,80,247,122,369,33.06233062330623
14557,330455705130301,34,33,44,59,48,60,62,61,278,123,401,30.673316708229425
14558,330455705130302,94,89,59,151,121,58,47,19,572,66,638,10.344827586206897
14559,330455705130303,31,44,83,69,60,72,68,95,359,163,522,31.226053639846743
14560,330455705130304,17,19,41,33,31,28,20,18,169,38,207,18.357487922705314
14561,330455705130305,22,27,49,82,41,76,33,53,297,86,383,22.45430809399478
14562,330455705130306,32,31,62,64,61,56,51,89,306,140,446,31.390134529147982
14563,330455705130307,19,39,36,45,59,55,40,60,253,100,353,28.328611898016998
14564,330455705130308,27,80,87,54,117,89,60,57,454,117,571,20.490367775831874
14565,330455705130309,25,39,46,33,16,20,13,4,179,17,196,8.673469387755102
14566,330455705130310,37,35,50,26,26,9,7,3,183,10,193,5.181347150259067
14567,330455705130311,36,49,40,32,43,20,17,3,220,20,240,8.333333333333334
14568,330455705130312,4,12,3,11,9,2,4,0,41,4,45,8.88888888888889
14569,330455705130313,60,85,95,69,78,77,48,39,464,87,551,15.789473684210526
14570,330455705130314,44,36,58,43,37,33,19,15,251,34,285,11.929824561403509
14571,330455705130315,30,30,39,31,23,30,5,7,183,12,195,6.153846153846154
14572,330455705130316,17,23,37,34,19,16,6,4,146,10,156,6.410256410256411
14573,330455705130317,148,154,261,118,135,92,60,25,908,85,993,8.559919436052366
14574,330455705130318,115,196,157,126,107,51,25,10,752,35,787,4.447268106734435
14575,330455705130319,41,54,37,39,34,12,14,7,217,21,238,8.823529411764707
14576,330455705130320,66,83,97,60,71,71,29,26,448,55,503,10.934393638170974
14577,330455705130321,36,50,55,36,34,37,18,25,248,43,291,14.776632302405499
14578,330455705130322,33,49,57,58,58,28,32,10,283,42,325,12.923076923076923
14579,330455705130323,189,254,169,256,117,70,17,3,1055,20,1075,1.8604651162790697
14580,330455705130324,149,193,153,148,112,49,30,27,804,57,861,6.620209059233449
14581,330455705140001,31,32,79,62,63,70,27,58,337,85,422,20.14218009478673
14582,330455705140002,39,60,127,81,91,105,76,107,503,183,686,26.676384839650147
14583,330455705140003,32,59,118,73,92,80,71,109,454,180,634,28.391167192429023
14584,330455705140004,29,73,106,84,96,98,45,68,486,113,599,18.864774624373958
14585,330455705140005,43,76,123,101,86,100,63,86,529,149,678,21.976401179941004
14586,330455705140006,36,36,63,65,62,73,47,67,335,114,449,25.389755011135858
14587,330455705140007,26,53,70,70,72,82,55,73,373,128,501,25.548902195608783
14588,330455705140008,31,54,96,52,92,79,29,65,404,94,498,18.87550200803213
14589,330455705140009,32,24,51,44,44,58,24,41,253,65,318,20.440251572327043
14590,330455705140010,35,69,114,87,98,140,67,65,543,132,675,19.555555555555557
14591,330455705140011,40,44,103,113,84,65,60,72,449,132,581,22.719449225473323
14592,330455705140012,28,26,74,81,47,67,58,56,323,114,437,26.08695652173913
14593,330455705140013,27,28,40,66,58,55,49,71,274,120,394,30.456852791878173
14594,330455705140014,36,62,85,78,96,90,60,71,447,131,578,22.664359861591695
14595,330455705140015,48,34,100,94,65,105,78,98,446,176,622,28.29581993569132
14596,330455705140016,51,35,78,87,82,88,64,67,421,131,552,23.731884057971016
14597,330455705140017,27,38,79,58,82,61,42,56,345,98,443,22.121896162528216
14598,330455705140018,73,68,129,110,128,139,103,98,647,201,848,23.702830188679247
14599,330455705140019,43,59,124,88,101,131,82,99,546,181,727,24.896836313617605
14600,330455705140020,40,51,110,91,67,94,70,68,453,138,591,23.3502538071066
14601,330455705140021,52,65,153,95,111,118,79,79,594,158,752,21.01063829787234
14602,330455705140022,40,52,75,72,59,59,36,56,357,92,449,20.489977728285076
14603,330455705140023,18,34,67,40,60,46,25,51,265,76,341,22.287390029325515
14604,330455705140024,37,59,110,92,90,82,53,55,470,108,578,18.685121107266436
14605,330455705140025,22,33,89,46,46,54,46,66,290,112,402,27.860696517412936
14606,330455705140026,56,84,116,111,102,111,48,54,580,102,682,14.956011730205278
14607,330455705140027,26,37,68,66,55,73,37,51,325,88,413,21.307506053268764
14608,330455705140028,63,104,149,124,131,150,79,66,721,145,866,16.74364896073903
14609,330455705140029,44,77,109,86,95,104,88,113,515,201,716,28.07262569832402
14610,330455705140030,53,102,126,103,145,132,48,42,661,90,751,11.984021304926765
14611,330455705140031,60,71,88,97,96,88,54,87,500,141,641,21.996879875195006
14612,330455705140032,53,78,133,114,104,128,87,91,610,178,788,22.588832487309645
14613,330455705140033,50,51,79,84,94,86,57,64,444,121,565,21.41592920353982
14614,330455705140034,27,35,99,98,73,75,51,98,407,149,556,26.798561151079138
14615,330455705140035,23,40,71,67,59,91,53,54,351,107,458,23.362445414847162
14616,330455705140036,43,52,84,52,66,93,60,61,390,121,511,23.679060665362034
14617,330455705140037,26,36,100,60,49,78,41,55,349,96,445,21.573033707865168
14618,330455705140038,26,63,157,101,97,105,62,61,549,123,672,18.303571428571427
14619,330455705140039,22,67,152,69,84,84,68,77,478,145,623,23.274478330658106
14620,330455705140040,33,54,114,85,82,85,52,64,453,116,569,20.38664323374341
14621,330455705140041,45,59,78,42,53,30,15,11,307,26,333,7.807807807807808
14622,330455705140042,46,69,90,83,81,99,59,56,468,115,583,19.725557461406517
14623,330455705140043,27,39,78,78,62,84,70,82,368,152,520,29.23076923076923
14624,330455705140044,32,51,85,115,89,101,79,82,473,161,634,25.394321766561514
14625,330455705140045,37,56,91,52,71,101,71,79,408,150,558,26.881720430107528
14626,330455705140046,39,73,84,95,96,103,90,96,490,186,676,27.514792899408285
14627,330455705140047,23,28,86,45,61,73,62,115,316,177,493,35.9026369168357
14628,330455705140048,39,48,120,67,86,106,86,124,466,210,676,31.06508875739645
14629,330455705140049,49,53,96,88,91,96,77,98,473,175,648,27.006172839506174
14630,330455705140050,43,58,97,96,98,115,77,125,507,202,709,28.49083215796897
14631,330455705140051,42,56,115,108,92,97,85,84,510,169,679,24.889543446244478
14632,330455705140052,68,62,136,103,92,110,76,88,571,164,735,22.312925170068027
14633,330455705140053,32,52,72,60,45,50,42,45,311,87,398,21.85929648241206
14634,330455705140054,18,35,43,38,48,37,31,31,219,62,281,22.06405693950178
14635,330455705140055,48,68,130,115,121,114,75,89,596,164,760,21.57894736842105
14636,330455705140056,28,51,78,88,78,87,57,62,410,119,529,22.495274102079396
14637,330455705140057,31,61,126,101,69,111,52,65,499,117,616,18.993506493506494
14638,330455705140058,21,28,60,54,61,70,71,74,294,145,439,33.029612756264235
14639,330455705140059,39,57,110,72,84,123,88,155,485,243,728,33.379120879120876
14640,330455705140060,35,46,80,79,79,74,65,100,393,165,558,29.56989247311828
14641,330455705140061,45,37,109,84,86,105,101,131,466,232,698,33.2378223495702
14642,330455705140062,22,43,86,68,73,88,70,120,380,190,570,33.333333333333336
14643,330455705140063,26,41,84,71,54,69,52,87,345,139,484,28.71900826446281
14644,330455705140064,28,51,69,43,53,75,52,92,319,144,463,31.101511879049674
14645,330455705140065,98,114,158,143,113,132,90,98,758,188,946,19.873150105708245
14646,330455705140066,32,69,107,99,93,116,70,51,516,121,637,18.995290423861853
14647,330455705140067,65,69,120,96,75,59,28,20,484,48,532,9.022556390977444
14648,330455705140068,48,29,72,80,64,66,33,37,359,70,429,16.317016317016318
14649,330455705140069,47,79,130,99,85,112,62,59,552,121,673,17.97919762258544
14650,330455705140070,38,65,118,109,88,122,65,95,540,160,700,22.857142857142858
14651,330455705140071,38,50,102,68,100,75,63,98,433,161,594,27.104377104377104
14652,330455705140072,36,52,80,54,64,87,64,89,373,153,526,29.08745247148289
14653,330455705140073,20,44,92,58,73,102,63,69,389,132,521,25.335892514395393
14654,330455705140074,55,51,107,109,82,99,68,72,503,140,643,21.77293934681182
14655,330455705140075,45,50,101,110,83,104,89,91,493,180,673,26.74591381872214
14656,330455705140076,40,60,81,84,90,65,68,105,420,173,593,29.17369308600337
14657,330455705140077,46,56,104,106,117,114,101,103,543,204,747,27.309236947791163
14658,330455705140078,33,57,83,92,93,92,92,113,450,205,655,31.297709923664122
14659,330455705140079,38,80,81,107,81,99,77,100,486,177,663,26.69683257918552
14660,330455705140080,45,64,113,133,114,112,76,107,581,183,764,23.952879581151834
14661,330455705140081,33,59,54,48,63,38,21,28,295,49,344,14.244186046511627
14662,330455705140082,161,133,145,117,97,87,37,36,740,73,813,8.979089790897909
14663,330455705140083,90,103,124,160,131,103,106,93,711,199,910,21.86813186813187
14664,330455705140084,46,58,133,139,93,138,82,102,607,184,791,23.261694058154234
14665,330455705140085,46,57,113,93,79,105,62,74,493,136,629,21.62162162162162
14667,330455705140087,25,27,75,65,52,74,49,72,318,121,439,27.5626423690205
14668,330455705140088,58,100,159,118,141,157,84,71,733,155,888,17.454954954954953
14669,330455705140089,55,75,119,96,108,114,62,69,567,131,698,18.76790830945559
14670,330455705140090,55,70,96,92,82,84,79,90,479,169,648,26.080246913580247
14671,330455705140091,45,52,60,57,61,42,40,47,317,87,404,21.534653465346533
14672,330455705140092,63,83,132,133,104,132,70,89,647,159,806,19.727047146401986
14673,330455705140093,55,63,112,88,81,70,57,46,469,103,572,18.006993006993007
14674,330455705140094,38,48,75,88,68,64,62,87,381,149,530,28.11320754716981
14675,330455705140095,32,46,69,77,72,71,69,122,367,191,558,34.229390681003586
14676,330455705140096,51,71,111,108,101,137,82,77,579,159,738,21.54471544715447
14677,330455705140097,38,26,65,85,65,75,42,24,354,66,420,15.714285714285714
14678,330455705140098,43,61,88,73,75,63,46,71,403,117,520,22.5
14679,330455705140099,38,45,68,75,71,64,55,58,361,113,474,23.839662447257385
14680,330455705140100,32,34,87,78,71,86,54,61,388,115,503,22.86282306163022
14681,330455705140101,142,321,161,167,302,167,76,30,1260,106,1366,7.759882869692533
14682,330455705140102,51,68,100,96,108,121,73,82,544,155,699,22.17453505007153
14683,330455705140103,79,123,136,118,142,116,78,78,714,156,870,17.93103448275862
14684,330455705140104,44,44,39,13,30,14,6,6,184,12,196,6.122448979591836
14685,330455705140105,127,102,105,83,52,24,18,9,493,27,520,5.1923076923076925
14686,330455705140106,138,181,193,147,127,117,54,66,903,120,1023,11.730205278592376
14687,330455705140107,54,55,116,91,90,108,79,75,514,154,668,23.05389221556886
14688,330455705140108,31,54,63,52,56,63,27,43,319,70,389,17.994858611825194
14689,330455705140109,21,58,83,58,65,95,50,60,380,110,490,22.448979591836736
14690,330455705140110,41,77,118,106,109,90,76,112,541,188,729,25.78875171467764
14691,330455705140111,40,65,79,66,82,76,49,66,408,115,523,21.988527724665392
14692,330455705140112,41,47,63,85,78,83,52,55,397,107,504,21.23015873015873
14693,330455705140113,49,58,94,96,117,91,69,106,505,175,680,25.735294117647058
14694,330455705140114,42,65,77,102,85,82,88,83,453,171,624,27.403846153846153
14695,330455705140115,54,85,115,108,116,121,62,78,599,140,739,18.944519621109606
14696,330455705140116,46,72,111,97,94,112,99,96,532,195,727,26.822558459422282
14697,330455705140117,41,66,94,86,91,86,62,71,464,133,597,22.278056951423785
14698,330455705140118,30,47,73,69,46,84,43,59,349,102,451,22.61640798226164
14699,330455705140119,43,57,92,90,100,74,63,50,456,113,569,19.85940246045694
14700,330455705140120,132,175,134,132,96,76,38,28,745,66,811,8.13810110974106
14701,330455705140121,167,168,202,191,127,72,37,32,927,69,996,6.927710843373494
14702,330455705140122,112,155,178,124,129,135,53,53,833,106,939,11.288604898828542
14703,330455705140123,153,225,215,207,113,86,47,26,999,73,1072,6.809701492537314
14704,330455705140124,269,130,251,221,86,93,47,25,1050,72,1122,6.4171122994652405
14705,330455705140125,36,61,124,87,80,145,61,71,533,132,665,19.849624060150376
14706,330455705140126,32,76,127,122,103,136,98,118,596,216,812,26.600985221674875
14707,330455705140127,44,52,75,113,85,69,48,65,438,113,551,20.508166969147005
14708,330455705140128,45,38,98,106,82,84,60,42,453,102,555,18.37837837837838
14709,330455705140129,46,97,148,64,100,166,60,55,621,115,736,15.625
14710,330455705140130,54,70,98,115,95,112,99,99,544,198,742,26.684636118598384
14711,330455705140131,59,73,164,122,122,133,91,104,673,195,868,22.465437788018434
14712,330455705140132,72,105,129,133,126,129,87,101,694,188,882,21.31519274376417
14713,330455705140133,37,41,98,101,81,70,88,167,428,255,683,37.33528550512445
14714,330455705140134,35,36,87,60,57,89,71,99,364,170,534,31.835205992509362
14715,330455705140135,62,74,128,121,136,109,80,97,630,177,807,21.933085501858734
14716,330455705140136,58,87,119,137,106,120,85,101,627,186,813,22.878228782287824
14717,330455705140137,46,76,78,84,109,101,65,68,494,133,627,21.21212121212121
14718,330455705140138,67,73,122,135,133,99,87,96,629,183,812,22.536945812807883
14719,330455705140139,52,57,84,63,83,80,45,48,419,93,512,18.1640625
14720,330455705140140,30,50,81,65,66,69,78,60,361,138,499,27.655310621242485
14721,330455705140141,46,47,93,100,60,60,21,35,406,56,462,12.121212121212121
14722,330455705140142,198,236,212,182,146,107,55,45,1081,100,1181,8.467400508044031
14723,330455705140143,239,340,267,260,185,124,79,45,1415,124,1539,8.057179987004549
14724,330455705140144,228,253,254,209,119,84,66,28,1147,94,1241,7.574536663980661
14725,330455705140145,31,37,74,82,60,63,66,77,347,143,490,29.183673469387756
14726,330455705140146,46,54,109,109,99,113,91,135,530,226,756,29.894179894179896
14727,330455705140147,30,55,124,107,101,111,110,161,528,271,799,33.917396745932415
14728,330455705140148,42,45,89,98,76,72,84,95,422,179,601,29.78369384359401
14729,330455705140149,35,50,112,69,112,105,82,95,483,177,660,26.818181818181817
14730,330455705140150,21,49,66,52,67,92,71,68,347,139,486,28.60082304526749
14731,330455705140151,43,70,84,87,84,95,59,58,463,117,580,20.17241379310345
14732,330455705140152,95,109,108,78,51,21,24,6,462,30,492,6.097560975609756
14733,330455705140153,31,35,28,19,16,19,5,5,148,10,158,6.329113924050633
14734,330455705140154,39,56,58,45,21,7,24,5,226,29,255,11.372549019607844
14735,330455705140155,86,96,84,74,47,34,21,13,421,34,455,7.472527472527473
14737,330455705140157,7,13,16,17,9,8,1,0,70,1,71,1.408450704225352
14738,330455705140158,30,40,41,33,28,14,9,6,186,15,201,7.462686567164179
14739,330455705140159,2,12,3,5,8,6,1,0,36,1,37,2.7027027027027026
14740,330455705140160,39,57,27,26,16,12,7,1,177,8,185,4.324324324324325
14741,330455705140161,44,63,60,30,27,24,15,4,248,19,267,7.116104868913857
14742,330455705140162,38,39,54,33,20,15,3,8,199,11,210,5.238095238095238
14743,330455705140163,107,96,71,36,53,21,10,4,384,14,398,3.5175879396984926
14744,330455705140164,167,177,164,135,117,62,29,29,822,58,880,6.590909090909091
14745,330455705140165,43,88,138,79,135,133,61,110,616,171,787,21.72808132147395
14746,330455705140166,31,44,74,65,50,65,49,61,329,110,439,25.056947608200456
14747,330455705140167,28,49,76,55,71,72,44,39,351,83,434,19.12442396313364
14748,330455705140168,42,76,99,85,108,112,60,82,522,142,664,21.3855421686747
14749,330455705140169,35,62,89,72,87,93,47,62,438,109,547,19.926873857404022
14750,330455705140170,37,54,71,86,84,89,62,82,421,144,565,25.486725663716815
14751,330455705140171,26,41,57,44,55,44,36,46,267,82,349,23.49570200573066
14752,330455705140172,44,54,91,85,68,58,37,30,400,67,467,14.346895074946467
14753,330455705140173,56,62,78,109,87,92,81,68,484,149,633,23.53870458135861
14754,330455705140174,34,62,75,79,61,90,43,65,401,108,509,21.218074656188605
14755,330455705140175,51,56,116,106,87,112,82,72,528,154,682,22.580645161290324
14756,330455705140176,28,49,86,75,83,83,70,91,404,161,565,28.495575221238937
14757,330455705140177,33,32,105,92,73,110,65,95,445,160,605,26.446280991735538
14758,330455705140178,43,55,103,91,82,101,76,102,475,178,653,27.258805513016846
14759,330455705140179,28,40,86,78,64,88,53,104,384,157,541,29.02033271719039
14760,330455705140180,42,73,86,108,92,98,59,61,499,120,619,19.38610662358643
14761,330455705140181,63,87,127,112,118,123,67,78,630,145,775,18.70967741935484
14762,330455705140182,26,26,36,30,27,15,8,8,160,16,176,9.090909090909092
14763,330455705140183,116,156,147,126,148,81,63,53,774,116,890,13.03370786516854
14764,330455705140184,56,56,71,79,70,72,45,55,404,100,504,19.841269841269842
14765,330455705140185,82,89,98,123,104,91,69,66,587,135,722,18.698060941828256
14766,330455705140186,52,94,100,98,92,125,65,81,561,146,707,20.650636492220652
14767,330455705140187,24,46,53,68,59,72,54,56,322,110,432,25.462962962962962
14768,330455705140188,49,67,90,93,102,91,57,74,492,131,623,21.02728731942215
14769,330455705140189,50,68,123,94,92,139,84,101,566,185,751,24.63382157123835
14770,330455705140190,64,56,137,111,108,142,126,99,618,225,843,26.690391459074732
14771,330455705140191,41,62,113,87,99,109,79,87,511,166,677,24.519940915805023
14772,330455705140192,30,27,88,96,78,106,62,67,425,129,554,23.28519855595668
14773,330455705140193,41,37,99,83,72,91,69,67,423,136,559,24.329159212880143
14774,330455705140194,30,70,82,72,68,97,77,65,419,142,561,25.311942959001783
14775,330455705140195,45,70,85,110,76,95,41,64,481,105,586,17.918088737201366
14776,330455705140196,54,72,97,90,95,119,66,94,527,160,687,23.28966521106259
14777,330455705140197,29,52,79,77,94,94,64,96,425,160,585,27.35042735042735
14778,330455705140198,43,48,100,106,89,98,66,109,484,175,659,26.555386949924127
14779,330455705140199,49,87,132,111,127,121,69,126,627,195,822,23.722627737226276
14780,330455705140200,66,71,101,90,84,111,69,63,523,132,655,20.15267175572519
14781,330455705140201,27,40,65,86,66,87,63,88,371,151,522,28.9272030651341
14782,330455705140202,37,40,90,93,61,94,64,75,415,139,554,25.09025270758123
14783,330455705140203,30,31,75,64,71,80,55,92,351,147,498,29.518072289156628
14784,330455705140204,49,87,109,91,103,103,62,65,542,127,669,18.98355754857997
14785,330455705140205,141,153,188,153,110,82,48,39,827,87,914,9.518599562363239
14786,330455705140206,81,117,75,75,80,25,28,22,453,50,503,9.940357852882704
14787,330455705140207,45,68,52,36,38,28,21,11,267,32,299,10.702341137123746
14788,330455705140208,11,16,6,10,5,6,1,1,54,2,56,3.5714285714285716
14789,330455705140209,8,20,11,13,5,2,4,3,59,7,66,10.606060606060606
14790,330455705140210,60,62,42,45,31,17,10,10,257,20,277,7.2202166064981945
14791,330455705140211,40,63,53,49,36,31,18,7,272,25,297,8.417508417508417
14792,330455705140212,90,86,92,63,46,47,24,24,424,48,472,10.169491525423728
14793,330455705140213,72,76,58,61,37,39,17,8,343,25,368,6.793478260869565
14794,330455705140214,60,70,79,60,52,47,26,18,368,44,412,10.679611650485437
14795,330455705140215,12,14,17,8,15,13,14,13,79,27,106,25.471698113207548
14796,330455705140216,47,56,52,58,45,45,25,23,303,48,351,13.675213675213675
14797,330455705140217,93,127,93,110,85,69,44,34,577,78,655,11.908396946564885
14798,330455705140218,130,143,177,193,164,166,108,114,973,222,1195,18.577405857740587
14799,330455705140219,48,83,107,69,81,104,80,110,492,190,682,27.85923753665689
14800,330455705140220,39,73,69,93,77,88,54,57,439,111,550,20.181818181818183
14801,330455705140221,34,44,79,90,54,86,72,64,387,136,523,26.003824091778203
14802,330455705140222,35,65,72,80,89,84,58,71,425,129,554,23.28519855595668
14803,330455705140223,69,85,126,94,109,114,79,79,597,158,755,20.927152317880793
14804,330455705140224,54,75,125,99,108,110,70,101,571,171,742,23.045822102425877
14805,330455705140225,68,89,117,129,141,136,103,139,680,242,922,26.247288503253795
14806,330455705140226,24,51,70,64,67,75,54,71,351,125,476,26.26050420168067
14807,330455705140227,56,55,102,108,96,103,80,83,520,163,683,23.865300146412885
14808,330455705140228,43,57,86,86,62,100,58,105,434,163,597,27.30318257956449
14809,330455705140229,46,40,72,87,68,73,54,61,386,115,501,22.954091816367267
14810,330455705140230,58,65,107,93,80,98,63,74,501,137,638,21.473354231974923
14811,330455705140231,29,28,70,70,63,79,47,78,339,125,464,26.939655172413794
14812,330455705140232,47,53,70,73,78,83,69,82,404,151,555,27.207207207207208
14813,330455705140233,52,61,98,112,108,115,80,118,546,198,744,26.612903225806452
14814,330455705140234,31,57,95,79,84,96,80,103,442,183,625,29.28
14815,330455705140235,38,65,129,106,88,138,80,114,564,194,758,25.593667546174142
14816,330455705140236,56,66,115,107,103,116,94,126,563,220,783,28.097062579821202
14817,330455705140237,55,96,139,96,117,156,80,101,659,181,840,21.547619047619047
14818,330455705140238,52,58,105,139,101,106,78,92,561,170,731,23.25581395348837
14819,330455705140239,32,39,58,59,55,74,45,62,317,107,424,25.235849056603772
14820,330455705140240,43,55,110,104,89,90,76,98,491,174,665,26.165413533834588
14821,330455705140241,55,60,106,112,94,115,106,128,542,234,776,30.15463917525773
14822,330455705140242,48,63,66,106,81,102,61,106,466,167,633,26.382306477093206
14823,330455705140243,63,99,141,127,113,106,64,79,649,143,792,18.055555555555557
14824,330455705140244,78,98,154,153,107,122,81,84,712,165,877,18.814139110604334
14825,330455705140245,64,65,91,124,97,93,78,87,534,165,699,23.605150214592275
14826,330455705140246,55,55,72,86,91,70,61,87,429,148,577,25.64991334488735
14827,330455705140247,45,69,95,83,114,124,81,131,530,212,742,28.571428571428573
14828,330455705140248,67,79,96,112,101,101,74,118,556,192,748,25.668449197860962
14829,330455705140249,55,81,76,99,103,95,61,103,509,164,673,24.368499257057948
14830,330455705140250,39,61,96,81,80,87,82,81,444,163,607,26.85337726523888
14831,330455705140251,58,57,122,123,113,96,95,144,569,239,808,29.57920792079208
14832,330455705140252,61,64,99,114,112,108,66,116,558,182,740,24.594594594594593
14833,330455705140253,35,70,107,81,104,95,70,106,492,176,668,26.347305389221557
14834,330455705140254,59,85,168,128,119,167,111,123,726,234,960,24.375
14835,330455705140255,63,82,121,101,118,108,55,60,593,115,708,16.242937853107346
14836,330455705140256,170,207,190,176,122,95,40,27,960,67,1027,6.523855890944499
14837,330455705140257,147,162,207,159,113,80,32,14,868,46,914,5.032822757111598
14838,330455705140258,255,260,295,249,177,139,56,31,1375,87,1462,5.950752393980848
14839,330455705140259,59,80,98,89,89,81,61,58,496,119,615,19.349593495934958
14840,330455705140260,21,30,93,75,55,81,35,42,355,77,432,17.824074074074073
14841,330455705140261,57,63,99,105,88,113,82,86,525,168,693,24.242424242424242
14842,330455705140262,47,64,64,87,93,78,71,74,433,145,578,25.086505190311417
14843,330455705140263,29,62,71,74,87,87,71,152,410,223,633,35.229067930489734
14844,330455705140264,47,66,107,96,100,120,84,106,536,190,726,26.170798898071624
14845,330455705140265,44,63,115,95,98,107,76,123,522,199,721,27.600554785020805
14846,330455705140266,40,41,70,65,64,82,59,72,362,131,493,26.572008113590265
14847,330455705140267,74,74,131,102,116,153,79,104,650,183,833,21.968787515006003
14848,330455705140268,85,137,56,107,147,86,47,44,618,91,709,12.834978843441467
14849,330455705140269,106,123,87,119,172,97,45,42,704,87,791,10.99873577749684
14850,330455705140270,61,85,93,82,109,84,67,55,514,122,636,19.18238993710692
14851,330455705140271,110,127,89,91,82,61,33,21,560,54,614,8.794788273615636
14852,330455705140272,61,65,54,41,34,22,11,11,277,22,299,7.357859531772576
14853,330455705140273,72,64,123,141,93,114,68,60,607,128,735,17.41496598639456
14854,330455705140274,81,73,123,140,125,116,76,85,658,161,819,19.65811965811966
14855,330455705140275,71,91,106,124,136,93,66,94,621,160,781,20.486555697823302
14856,330455705140276,75,61,117,133,111,117,67,65,614,132,746,17.694369973190348
14857,330455705140277,53,54,68,82,82,83,43,89,422,132,554,23.826714801444044
14858,330455705140278,41,57,83,99,75,63,43,40,418,83,501,16.56686626746507
14859,330455705140279,39,44,53,79,76,72,56,58,363,114,477,23.89937106918239
14860,330455705140280,67,77,124,123,122,127,88,91,640,179,819,21.855921855921856
14861,330455705140281,49,55,102,112,75,105,70,100,498,170,668,25.449101796407184
14862,330455705140282,19,25,50,39,34,41,33,47,208,80,288,27.77777777777778
14863,330455705140283,25,25,77,47,47,57,42,64,278,106,384,27.604166666666668
14864,330455705140284,32,47,83,49,55,59,53,60,325,113,438,25.799086757990867
14865,330455705140285,22,34,81,56,49,58,48,63,300,111,411,27.00729927007299
14866,330455705140286,79,97,97,96,82,73,35,25,524,60,584,10.273972602739725
14867,330455705140287,35,36,72,69,56,83,43,60,351,103,454,22.687224669603523
14868,330455705140288,67,40,61,109,75,61,41,38,413,79,492,16.056910569105693
14869,330455705140289,48,79,79,71,77,88,68,59,442,127,569,22.319859402460455
14870,330455705140290,151,172,154,123,100,54,31,25,754,56,810,6.91358024691358
14871,330455705140291,33,51,63,79,59,72,68,89,357,157,514,30.544747081712064
14872,330455705140292,26,51,92,70,74,86,53,61,399,114,513,22.22222222222222
14873,330455705140293,35,51,58,60,58,66,47,43,328,90,418,21.5311004784689
14874,330455705140294,19,34,63,45,29,39,34,36,229,70,299,23.411371237458194
14875,330455705140295,43,68,82,73,63,60,48,64,389,112,501,22.355289421157686
14876,330455705140296,39,33,53,49,50,38,33,50,262,83,345,24.057971014492754
14877,330455705140297,139,126,162,131,84,49,32,21,691,53,744,7.123655913978495
14878,330455705140298,53,67,114,103,86,72,49,55,495,104,599,17.362270450751254
14879,330455705140299,70,60,102,77,60,81,48,39,450,87,537,16.201117318435752
14880,330455705140300,69,69,81,73,61,39,26,18,392,44,436,10.091743119266056
14881,330455705140301,91,107,86,84,69,46,17,14,483,31,514,6.031128404669261
14882,330455705140302,69,90,69,75,64,39,19,16,406,35,441,7.936507936507937
14883,330455705140303,23,23,25,30,13,13,6,6,127,12,139,8.633093525179856
14884,330455705140304,61,64,64,48,28,19,14,6,284,20,304,6.578947368421052
14885,330455705140305,67,209,65,150,140,27,54,29,658,83,741,11.201079622132253
14886,330455705140306,96,127,97,87,69,63,44,23,539,67,606,11.056105610561056
14887,330455705140307,65,80,83,73,58,40,21,22,399,43,442,9.728506787330316
14888,330455705140308,59,65,79,57,53,45,23,12,358,35,393,8.9058524173028
14889,330455705140309,15,12,18,10,6,8,7,4,69,11,80,13.75
14890,330455705140310,180,541,202,482,403,52,72,45,1860,117,1977,5.918057663125948
14891,330455705140311,6,15,7,8,12,9,2,2,57,4,61,6.557377049180328
14892,330455705140312,59,120,32,51,79,46,11,9,387,20,407,4.914004914004914
14893,330455705140313,116,136,141,141,85,41,64,20,660,84,744,11.290322580645162
14894,330455705150001,92,110,152,123,118,103,44,59,698,103,801,12.85892634207241
14895,330455705150002,56,47,57,43,39,31,22,9,273,31,304,10.197368421052632
14896,330455705150003,87,99,104,97,67,51,22,13,505,35,540,6.481481481481482
14897,330455705150004,239,255,200,177,156,97,55,36,1124,91,1215,7.489711934156379
14898,330455705150005,91,78,108,102,77,68,35,37,524,72,596,12.080536912751677
14899,330455705150006,40,58,54,46,52,26,26,25,276,51,327,15.596330275229358
14900,330455705150007,57,39,38,55,28,32,17,5,249,22,271,8.118081180811808
14901,330455705150008,217,318,263,212,220,151,54,47,1381,101,1482,6.815114709851552
14902,330455705150009,132,235,155,175,148,81,46,31,926,77,1003,7.676969092721834
14903,330455705150010,157,251,152,181,171,110,60,31,1022,91,1113,8.176100628930818
14904,330455705150011,180,238,214,187,161,115,46,37,1095,83,1178,7.045840407470289
14905,330455705150012,70,79,66,74,29,27,20,8,345,28,373,7.506702412868632
14906,330455705150013,113,79,82,94,59,28,18,7,455,25,480,5.208333333333333
14907,330455705150014,249,458,262,274,247,125,45,14,1615,59,1674,3.5244922341696534
14908,330455705150015,147,142,142,94,77,58,18,12,660,30,690,4.3478260869565215
14909,330455705150016,215,279,244,206,154,133,50,33,1231,83,1314,6.316590563165906
14910,330455705150017,68,98,67,45,59,44,14,12,381,26,407,6.388206388206388
14911,330455705150018,119,159,134,112,75,41,21,11,640,32,672,4.761904761904762
14912,330455705150019,122,108,125,133,86,63,42,24,637,66,703,9.388335704125177
14913,330455705150020,97,123,138,146,85,61,47,25,650,72,722,9.97229916897507
14914,330455705150021,101,105,127,122,87,73,36,26,615,62,677,9.15805022156573
14915,330455705150022,46,62,72,71,57,39,25,19,347,44,391,11.253196930946292
14916,330455705150023,103,123,138,150,91,43,26,18,648,44,692,6.358381502890174
14917,330455705150024,105,114,99,95,91,85,36,15,589,51,640,7.96875
14918,330455705150025,6,18,69,68,76,45,15,13,282,28,310,9.03225806451613
14919,330455705150026,214,226,204,193,127,80,37,11,1044,48,1092,4.395604395604396
14920,330455705150027,105,111,85,80,60,42,18,9,483,27,510,5.294117647058823
14921,330455705150028,113,106,131,98,76,42,25,8,566,33,599,5.509181969949917
14922,330455705150029,149,184,198,151,104,74,46,14,860,60,920,6.521739130434782
14923,330455705150030,42,61,42,38,41,32,10,12,256,22,278,7.913669064748201
14924,330455705150031,241,243,231,212,136,109,65,30,1172,95,1267,7.49802683504341
14925,330455705150032,118,138,99,93,61,52,24,9,561,33,594,5.555555555555555
14926,330455705150033,63,86,117,90,90,86,52,27,532,79,611,12.92962356792144
14927,330455705150034,879,494,757,722,265,138,39,5,3255,44,3299,1.333737496210973
14928,330455705150035,335,284,208,274,99,70,17,5,1270,22,1292,1.7027863777089782
14929,330455705150036,112,126,78,82,41,23,9,3,462,12,474,2.5316455696202533
14930,330455705150037,131,139,138,141,69,42,7,6,660,13,673,1.9316493313521546
14931,330455705150038,585,552,578,667,379,261,113,53,3022,166,3188,5.20702634880803
14932,330455705150039,266,209,244,202,79,59,30,9,1059,39,1098,3.551912568306011
14933,330455705150040,269,278,268,240,137,93,35,31,1285,66,1351,4.885270170244263
14934,330455705150041,31,39,44,40,59,43,42,60,256,102,358,28.491620111731844
14935,330455705150042,45,38,77,66,68,104,46,85,398,131,529,24.763705103969755
14936,330455705150043,35,39,100,85,59,99,57,85,417,142,559,25.402504472271914
14937,330455705150044,23,34,46,47,41,35,32,26,226,58,284,20.422535211267604
14938,330455705150045,27,42,36,46,45,36,29,47,232,76,308,24.675324675324674
14939,330455705150046,42,38,50,37,54,33,24,24,254,48,302,15.894039735099337
14940,330455705150047,79,105,107,100,116,111,57,70,618,127,745,17.046979865771814
14941,330455705150048,32,37,71,56,76,72,40,56,344,96,440,21.818181818181817
14942,330455705150049,27,52,72,60,61,85,63,101,357,164,521,31.47792706333973
14943,330455705150050,51,83,89,82,105,111,86,145,521,231,752,30.71808510638298
14944,330455705150051,39,59,69,69,86,87,59,93,409,152,561,27.094474153297682
14945,330455705150052,23,45,54,42,50,56,46,47,270,93,363,25.619834710743802
14946,330455705150053,52,65,93,99,69,110,56,47,488,103,591,17.42808798646362
14947,330455705150054,67,92,98,116,88,84,50,52,545,102,647,15.765069551777435
14948,330455705150055,56,71,109,90,82,72,44,56,480,100,580,17.24137931034483
14949,330455705150056,74,108,138,140,130,113,63,81,703,144,847,17.001180637544273
14950,330455705150057,57,64,105,80,64,52,34,21,422,55,477,11.530398322851154
14951,330455705150058,36,68,80,87,68,51,35,34,390,69,459,15.032679738562091
14952,330455705150059,47,78,133,78,101,84,54,52,521,106,627,16.905901116427433
14953,330455705150060,62,59,67,82,61,73,48,29,404,77,481,16.008316008316008
14954,330455705150061,35,52,50,50,37,60,41,42,284,83,367,22.615803814713896
14955,330455705150062,75,113,129,120,118,84,58,59,639,117,756,15.476190476190476
14956,330455705150063,23,27,25,43,38,25,19,23,181,42,223,18.83408071748879
14957,330455705150064,34,48,75,62,67,35,36,43,321,79,400,19.75
14958,330455705150065,37,49,49,66,44,36,42,43,281,85,366,23.224043715846996
14959,330455705150066,5,7,6,3,4,20,91,184,45,275,320,85.9375
14960,330455705150067,65,65,69,53,33,38,37,13,323,50,373,13.404825737265416
14961,330455705150068,183,193,219,136,117,105,37,13,953,50,1003,4.985044865403789
14962,330455705150069,53,86,77,73,96,54,39,34,439,73,512,14.2578125
14963,330455705150070,44,76,81,61,82,104,77,68,448,145,593,24.45193929173693
14964,330455705150071,46,66,106,97,106,98,81,109,519,190,709,26.798307475317348
14965,330455705150072,33,58,67,95,64,57,43,42,374,85,459,18.51851851851852
14966,330455705150073,68,101,116,115,121,101,82,85,622,167,789,21.166032953105198
14967,330455705150074,46,54,72,77,65,77,47,79,391,126,517,24.37137330754352
14968,330455705150075,48,78,103,78,94,105,82,87,506,169,675,25.037037037037038
14969,330455705150076,89,102,144,137,117,99,64,79,688,143,831,17.208182912154033
14970,330455705150077,48,59,98,63,82,104,59,70,454,129,583,22.126929674099486
14971,330455705150078,49,66,67,64,79,78,63,57,403,120,523,22.94455066921606
14972,330455705150079,53,69,107,109,65,106,95,84,509,179,688,26.017441860465116
14973,330455705150080,49,78,99,83,85,102,48,59,496,107,603,17.744610281923716
14974,330455705150081,74,74,119,121,128,112,74,89,628,163,791,20.606826801517066
14975,330455705150082,84,98,97,133,126,110,79,115,648,194,842,23.040380047505938
14976,330455705150083,69,52,123,98,93,126,56,84,561,140,701,19.971469329529246
14977,330455705150084,76,70,117,86,105,99,71,101,553,172,725,23.724137931034484
14978,330455705150085,42,72,76,92,81,88,49,62,451,111,562,19.750889679715304
14979,330455705150086,63,69,79,88,83,85,54,65,467,119,586,20.30716723549488
14980,330455705150087,37,69,63,59,65,69,30,39,362,69,431,16.009280742459396
14981,330455705150088,54,92,88,108,145,92,53,35,579,88,667,13.193403298350825
14982,330455705150089,77,104,117,121,138,122,73,71,679,144,823,17.496962332928312
14983,330455705150090,59,67,98,92,90,108,61,65,514,126,640,19.6875
14984,330455705150091,64,103,94,124,112,95,55,56,592,111,703,15.789473684210526
14985,330455705150092,34,67,55,68,64,79,49,82,367,131,498,26.305220883534137
14986,330455705150093,71,91,85,92,103,86,82,75,528,157,685,22.919708029197082
14987,330455705150094,63,85,104,96,87,94,58,71,529,129,658,19.6048632218845
14988,330455705150095,65,74,116,88,91,95,77,97,529,174,703,24.751066856330013
14989,330455705150096,76,106,119,128,116,135,84,70,680,154,834,18.465227817745802
14990,330455705150097,59,68,113,94,85,120,54,65,539,119,658,18.085106382978722
14991,330455705150098,24,38,38,40,40,55,42,44,235,86,321,26.79127725856698
14992,330455705150099,74,100,117,111,102,80,76,76,584,152,736,20.652173913043477
14993,330455705150100,33,66,51,56,61,32,22,16,299,38,337,11.275964391691394
14994,330455705150101,68,97,84,105,88,86,63,59,528,122,650,18.76923076923077
14995,330455705150102,66,119,166,113,96,77,67,37,637,104,741,14.035087719298245
14996,330455705150103,28,62,64,77,62,68,71,73,361,144,505,28.514851485148515
14997,330455705150104,26,60,48,59,63,64,37,49,320,86,406,21.182266009852217
14998,330455705150105,66,122,124,118,102,99,47,97,631,144,775,18.580645161290324
14999,330455705150106,51,50,55,73,57,40,41,52,326,93,419,22.195704057279237
15000,330455705150107,32,64,60,54,80,60,35,57,350,92,442,20.81447963800905
15001,330455705150108,95,102,115,128,123,87,70,51,650,121,771,15.693904020752269
15002,330455705150109,64,96,92,79,83,66,42,39,480,81,561,14.438502673796792
15003,330455705150110,99,114,126,114,112,114,55,57,679,112,791,14.15929203539823
15004,330455705150111,76,84,87,94,82,71,55,64,494,119,613,19.412724306688418
15005,330455705150112,85,132,120,141,110,103,62,52,691,114,805,14.161490683229813
15006,330455705150113,91,131,134,139,149,143,88,115,787,203,990,20.505050505050505
15007,330455705150114,40,45,71,64,64,54,55,46,338,101,439,23.006833712984054
15008,330455705150115,28,38,82,66,60,58,43,24,332,67,399,16.791979949874687
15009,330455705150116,33,46,57,50,52,52,34,37,290,71,361,19.667590027700832
15010,330455705150117,54,73,98,84,96,88,47,65,493,112,605,18.512396694214875
15011,330455705150118,79,97,142,178,130,83,61,46,709,107,816,13.112745098039216
15012,330455705150119,41,65,49,55,41,33,14,3,284,17,301,5.647840531561462
15013,330455705150120,61,62,92,181,100,41,42,26,537,68,605,11.239669421487603
15014,330455705150121,107,98,98,103,126,69,42,39,601,81,682,11.87683284457478
15015,330455705150122,76,99,97,109,69,53,43,34,503,77,580,13.275862068965518
15016,330455705150123,216,188,357,254,198,102,43,33,1315,76,1391,5.463695183321351
15017,330455705150124,49,63,54,57,51,30,16,5,304,21,325,6.461538461538462
15018,330455705150125,42,51,51,51,36,46,16,14,277,30,307,9.77198697068404
15019,330455705150126,46,68,134,143,61,62,27,47,514,74,588,12.585034013605442
15020,330455705150127,44,46,52,69,55,27,8,11,293,19,312,6.089743589743589
15021,330455705150128,20,25,17,64,41,29,22,9,196,31,227,13.656387665198238
15022,330455705150129,18,28,23,15,26,11,6,7,121,13,134,9.701492537313433
15023,330455705150130,51,83,63,66,102,75,46,40,440,86,526,16.34980988593156
15024,330455705150131,54,56,90,73,73,76,50,48,422,98,520,18.846153846153847
15025,330455705150132,58,65,91,125,84,86,43,62,509,105,614,17.10097719869707
15026,330455705150133,32,60,59,52,75,84,70,54,362,124,486,25.51440329218107
15027,330455705150134,34,69,72,73,78,70,51,61,396,112,508,22.04724409448819
15028,330455705150135,77,96,156,102,142,109,88,91,682,179,861,20.78977932636469
15029,330455705150136,67,92,108,102,107,107,83,69,583,152,735,20.68027210884354
15030,330455705150137,47,59,78,87,83,93,75,105,447,180,627,28.708133971291865
15031,330455705150138,48,59,102,100,76,91,119,68,476,187,663,28.205128205128204
15032,330455705150139,33,38,46,53,52,46,35,49,268,84,352,23.863636363636363
15033,330455705150140,95,125,162,166,150,106,53,64,804,117,921,12.703583061889251
15034,330455705150141,66,97,154,181,138,119,77,78,755,155,910,17.032967032967033
15035,330455705150142,38,66,82,99,76,109,70,74,470,144,614,23.452768729641694
15036,330455705150143,33,55,83,94,87,108,100,93,460,193,653,29.555895865237368
15037,330455705150144,18,25,39,27,35,31,28,50,175,78,253,30.8300395256917
15038,330455705150145,51,78,79,118,105,93,84,87,524,171,695,24.60431654676259
15039,330455705150146,61,71,64,106,75,81,52,55,458,107,565,18.938053097345133
15040,330455705150147,47,65,100,90,92,123,82,62,517,144,661,21.78517397881997
15041,330455705150148,60,58,115,94,97,116,77,97,540,174,714,24.369747899159663
15042,330455705150149,25,44,51,73,60,73,56,57,326,113,439,25.74031890660592
15043,330455705150150,64,80,87,103,87,74,71,60,495,131,626,20.926517571884983
15044,330455705150151,40,57,86,76,72,90,46,55,421,101,522,19.34865900383142
15045,330455705150152,63,103,115,97,116,106,91,87,600,178,778,22.87917737789203
15046,330455705150153,78,91,81,125,104,59,78,71,538,149,687,21.688500727802037
15047,330455705150154,89,115,124,144,140,88,133,80,700,213,913,23.329682365826944
15048,330455705150155,76,110,105,139,131,70,126,87,631,213,844,25.23696682464455
15049,330455705150156,56,88,97,105,95,93,90,53,534,143,677,21.122599704579024
15050,330455705150157,67,60,91,84,61,66,56,53,429,109,538,20.260223048327138
15051,330455705150158,41,59,63,41,49,32,10,14,285,24,309,7.766990291262136
15052,330455705150159,51,105,89,71,105,71,65,36,492,101,593,17.032040472175378
15053,330455705150160,69,74,105,86,92,93,68,89,519,157,676,23.224852071005916
15054,330455705150161,37,76,86,75,104,76,65,75,454,140,594,23.569023569023567
15055,330455705150162,56,75,98,110,101,74,84,59,514,143,657,21.765601217656013
15056,330455705150163,29,59,78,82,85,70,80,60,403,140,543,25.78268876611418
15057,330455705150164,66,88,110,136,127,118,81,86,645,167,812,20.56650246305419
15058,330455705150165,33,35,46,43,58,34,42,52,249,94,343,27.40524781341108
15059,330455705150166,78,84,136,156,107,112,72,91,673,163,836,19.497607655502392
15060,330455705150167,82,69,97,126,88,124,117,101,586,218,804,27.114427860696516
15061,330455705150168,135,129,190,215,149,165,134,101,983,235,1218,19.29392446633826
15062,330455705150169,40,63,49,75,64,61,35,39,352,74,426,17.370892018779344
15063,330455705150170,66,92,99,96,93,94,47,68,540,115,655,17.557251908396946
15064,330455705150171,86,82,101,129,103,103,83,92,604,175,779,22.464698331193837
15065,330455705150172,68,85,129,110,113,105,69,96,610,165,775,21.29032258064516
15066,330455705150173,92,111,159,124,163,142,99,98,791,197,988,19.939271255060728
15067,330455705150174,65,75,97,107,102,74,62,71,520,133,653,20.367534456355283
15068,330455705150175,42,45,62,51,60,55,33,30,315,63,378,16.666666666666668
15069,330455705150176,40,44,47,37,31,28,24,20,227,44,271,16.236162361623617
15070,330455705150177,128,111,136,110,106,102,75,57,693,132,825,16.0
15071,330455705150178,89,121,118,105,122,113,74,50,668,124,792,15.656565656565656
15072,330455705150179,84,119,104,139,120,73,99,58,639,157,796,19.723618090452263
15073,330455705150180,49,94,78,79,103,54,90,43,457,133,590,22.54237288135593
15074,330455705150181,52,81,77,75,93,81,72,74,459,146,605,24.132231404958677
15075,330455705150182,42,61,68,81,60,43,44,43,355,87,442,19.683257918552037
15076,330455705150183,97,120,135,141,126,103,129,65,722,194,916,21.179039301310045
15077,330455705150184,61,68,72,71,67,64,50,30,403,80,483,16.563146997929607
15078,330455705150185,40,71,51,65,66,47,42,34,340,76,416,18.26923076923077
15079,330455705150186,74,91,121,81,80,71,43,38,518,81,599,13.52253756260434
15080,330455705150187,69,76,55,76,39,49,34,25,364,59,423,13.947990543735225
15081,330455705150188,148,142,164,118,103,116,60,51,791,111,902,12.3059866962306
15082,330455705150189,130,116,157,93,133,87,35,40,716,75,791,9.481668773704172
15083,330455705150190,41,68,79,77,75,62,60,68,402,128,530,24.150943396226417
15084,330455705150191,63,84,95,106,102,98,59,73,548,132,680,19.41176470588235
15085,330455705150192,42,61,70,70,75,68,61,75,386,136,522,26.053639846743295
15086,330455705150193,66,85,100,90,122,102,78,74,565,152,717,21.199442119944212
15087,330455705150194,58,99,115,83,106,115,89,80,576,169,745,22.684563758389263
15088,330455705150195,53,73,94,82,92,83,75,57,477,132,609,21.67487684729064
15089,330455705150196,95,204,150,161,150,128,76,68,888,144,1032,13.953488372093023
15090,330455705150197,73,82,78,71,90,52,40,32,446,72,518,13.8996138996139
15091,330455705150198,72,117,107,117,90,97,72,62,600,134,734,18.256130790190735
15092,330455705150199,58,82,88,98,84,72,24,24,482,48,530,9.056603773584905
15093,330455705150200,64,57,55,69,62,47,30,25,354,55,409,13.447432762836186
15094,330455705150201,118,121,139,114,92,94,51,53,678,104,782,13.29923273657289
15095,330455705150202,108,122,108,119,73,50,32,20,580,52,632,8.227848101265822
15096,330455705150203,187,186,178,175,112,105,53,35,943,88,1031,8.535402521823473
15097,330455705150204,75,85,104,114,104,117,95,114,599,209,808,25.866336633663366
15098,330455705150205,77,69,96,114,95,105,94,99,556,193,749,25.767690253671564
15099,330455705150206,31,53,37,61,62,55,52,35,299,87,386,22.53886010362694
15100,330455705150207,52,63,57,66,58,52,43,43,348,86,434,19.81566820276498
15101,330455705150208,26,46,38,51,40,38,28,30,239,58,297,19.52861952861953
15102,330455705150209,70,85,70,69,51,47,24,14,392,38,430,8.837209302325581
15103,330455705150210,63,79,88,49,30,51,12,12,360,24,384,6.25
15104,330455705150211,79,96,66,68,55,34,19,20,398,39,437,8.924485125858123
15105,330455705150212,128,126,147,104,93,59,25,32,657,57,714,7.983193277310924
15106,330455705150213,44,47,50,53,27,26,13,13,247,26,273,9.523809523809524
15107,330455705150214,60,57,49,38,31,24,13,5,259,18,277,6.498194945848375
15108,330455705150215,61,79,58,58,54,25,16,14,335,30,365,8.219178082191782
15109,330455705150216,166,159,173,162,124,97,53,39,881,92,973,9.45529290853032
15110,330455705150217,34,65,86,102,114,93,42,21,494,63,557,11.310592459605028
15111,330455705150218,43,40,51,48,70,52,30,45,304,75,379,19.788918205804748
15112,330455705150219,37,35,63,62,58,70,39,63,325,102,427,23.88758782201405
15113,330455705150220,45,79,84,67,61,57,48,55,393,103,496,20.766129032258064
15114,330455705150221,32,79,92,72,84,87,76,63,446,139,585,23.76068376068376
15115,330455705150222,32,38,53,59,70,52,35,52,304,87,391,22.25063938618926
15116,330455705150223,42,54,71,54,64,65,40,42,350,82,432,18.98148148148148
15117,330455705150224,117,97,118,123,67,32,6,5,554,11,565,1.9469026548672566
15118,330455705150225,182,194,238,216,124,53,18,13,1007,31,1038,2.9865125240847785
15119,330455705150226,66,95,90,99,83,58,20,12,491,32,523,6.118546845124283
15120,330455705150227,28,36,39,44,54,56,22,54,257,76,333,22.822822822822822
15121,330455705150228,54,57,103,99,69,82,53,80,464,133,597,22.278056951423785
15122,330455705150229,27,45,38,40,58,52,18,42,260,60,320,18.75
15123,330455705150230,38,57,59,60,68,65,55,68,347,123,470,26.170212765957448
15124,330455705150231,48,65,63,84,78,60,56,40,398,96,494,19.4331983805668
15125,330455705150232,39,56,64,70,66,59,22,41,354,63,417,15.107913669064748
15126,330455705150233,29,53,30,36,21,17,11,8,186,19,205,9.268292682926829
15127,330455705150234,90,107,113,95,80,68,25,10,553,35,588,5.9523809523809526
15128,330455705150235,15,9,15,7,7,2,3,2,55,5,60,8.333333333333334
15129,330455705150236,25,36,40,15,33,23,11,5,172,16,188,8.51063829787234
15130,330455705150237,59,97,54,68,50,21,15,11,349,26,375,6.933333333333334
15131,330455705150238,93,75,88,65,51,27,7,2,399,9,408,2.2058823529411766
15132,330455705150239,103,184,105,192,112,64,32,10,760,42,802,5.236907730673317
15133,330455705150242,68,56,70,70,42,19,8,6,325,14,339,4.129793510324483
15134,330455705150243,55,73,75,83,46,35,24,23,367,47,414,11.352657004830919
15135,330455705160001,56,82,108,104,83,95,56,57,528,113,641,17.628705148205928
15136,330455705160002,68,74,91,99,105,72,50,47,509,97,606,16.006600660066006
15137,330455705160003,40,29,63,79,49,79,47,33,339,80,419,19.09307875894988
15138,330455705160004,37,37,58,48,51,72,39,61,303,100,403,24.81389578163772
15139,330455705160005,27,46,64,38,48,65,42,68,288,110,398,27.63819095477387
15140,330455705160006,31,33,72,56,63,55,47,50,310,97,407,23.832923832923832
15141,330455705160007,53,68,80,81,80,74,63,59,436,122,558,21.863799283154123
15142,330455705160008,37,46,72,68,62,85,51,49,370,100,470,21.27659574468085
15143,330455705160009,64,74,108,100,95,88,90,74,529,164,693,23.665223665223664
15144,330455705160010,53,93,79,84,102,77,58,76,488,134,622,21.543408360128616
15145,330455705160011,42,51,84,70,61,85,38,48,393,86,479,17.954070981210855
15146,330455705160012,45,55,93,58,84,73,72,83,408,155,563,27.53108348134991
15147,330455705160013,49,70,73,71,83,64,37,55,410,92,502,18.326693227091635
15148,330455705160014,74,99,138,99,121,106,81,72,637,153,790,19.367088607594937
15149,330455705160015,47,52,57,76,63,80,59,53,375,112,487,22.99794661190965
15150,330455705160016,74,82,121,110,107,127,56,65,621,121,742,16.307277628032345
15151,330455705160017,37,56,61,47,54,64,31,34,319,65,384,16.927083333333332
15152,330455705160018,35,44,80,59,70,77,43,50,365,93,458,20.305676855895197
15153,330455705160019,36,41,67,53,52,59,43,34,308,77,385,20.0
15154,330455705160020,39,49,73,48,70,58,41,66,337,107,444,24.0990990990991
15155,330455705160021,48,47,78,69,85,60,48,68,387,116,503,23.061630218687874
15156,330455705160022,33,32,57,52,52,57,37,37,283,74,357,20.72829131652661
15157,330455705160023,35,41,50,45,46,47,36,47,264,83,347,23.919308357348704
15158,330455705160024,35,48,41,58,48,49,40,42,279,82,361,22.714681440443215
15159,330455705160025,56,90,110,107,94,123,79,55,580,134,714,18.76750700280112
15160,330455705160026,47,81,84,57,104,98,33,24,471,57,528,10.795454545454545
15161,330455705160027,37,59,78,55,81,73,30,39,383,69,452,15.265486725663717
15162,330455705160028,95,184,176,185,193,105,74,72,938,146,1084,13.468634686346864
15163,330455705160029,54,89,140,116,90,105,64,70,594,134,728,18.406593406593405
15164,330455705160030,76,83,79,97,72,78,61,50,485,111,596,18.624161073825505
15165,330455705160031,41,55,82,59,74,77,46,42,388,88,476,18.48739495798319
15166,330455705160032,57,63,78,101,70,87,69,58,456,127,583,21.783876500857634
15167,330455705160033,99,89,147,109,140,76,90,46,660,136,796,17.08542713567839
15168,330455705160034,56,78,109,119,104,69,75,66,535,141,676,20.857988165680474
15169,330455705160035,19,29,59,33,33,61,30,65,234,95,329,28.875379939209726
15170,330455705160036,24,31,51,32,58,53,37,44,249,81,330,24.545454545454547
15171,330455705160037,20,31,48,28,41,35,34,25,203,59,262,22.519083969465647
15172,330455705160038,38,66,63,90,37,40,33,47,334,80,414,19.32367149758454
15173,330455705160039,45,64,85,65,81,85,46,53,425,99,524,18.893129770992367
15174,330455705160040,60,63,83,74,92,74,66,89,446,155,601,25.79034941763727
15175,330455705160041,43,40,45,56,48,53,24,33,285,57,342,16.666666666666668
15176,330455705160042,41,48,61,49,63,36,44,34,298,78,376,20.74468085106383
15177,330455705160043,59,77,110,100,80,72,31,54,498,85,583,14.579759862778731
15178,330455705160044,37,45,51,48,42,38,31,37,261,68,329,20.66869300911854
15179,330455705160045,66,71,84,77,79,51,51,39,428,90,518,17.374517374517374
15180,330455705160046,44,86,150,106,95,72,47,4,553,51,604,8.443708609271523
15181,330455705160047,42,49,70,58,64,71,64,50,354,114,468,24.358974358974358
15182,330455705160048,32,51,51,48,45,43,40,36,270,76,346,21.965317919075144
15183,330455705160049,52,60,79,76,87,74,54,49,428,103,531,19.397363465160076
15184,330455705160050,58,62,85,83,67,97,58,79,452,137,589,23.2597623089983
15185,330455705160051,49,67,67,70,81,57,35,56,391,91,482,18.87966804979253
15186,330455705160052,30,62,80,60,82,94,56,81,408,137,545,25.137614678899084
15187,330455705160053,40,61,71,79,71,78,31,69,400,100,500,20.0
15188,330455705160054,40,72,88,60,78,65,47,41,403,88,491,17.922606924643585
15189,330455705160055,37,68,56,55,62,62,35,28,340,63,403,15.632754342431761
15190,330455705160056,89,116,119,104,117,66,59,59,611,118,729,16.18655692729767
15191,330455705160057,49,64,89,64,55,51,39,37,372,76,448,16.964285714285715
15192,330455705160058,133,146,132,137,122,86,58,65,756,123,879,13.993174061433447
15193,330455705160059,25,47,53,51,75,42,33,47,293,80,373,21.447721179624665
15194,330455705160060,72,165,155,256,98,89,70,55,835,125,960,13.020833333333334
15195,330455705160061,75,78,93,104,92,77,71,82,519,153,672,22.767857142857142
15196,330455705160062,65,63,90,96,74,85,71,71,473,142,615,23.089430894308943
15197,330455705160063,47,65,89,91,57,87,82,57,436,139,575,24.17391304347826
15198,330455705160064,24,30,50,59,43,64,46,55,270,101,371,27.223719676549866
15199,330455705160065,43,79,92,80,97,101,88,75,492,163,655,24.885496183206108
15200,330455705160066,183,283,415,175,108,91,63,30,1255,93,1348,6.899109792284866
15201,330455705160067,100,137,106,76,74,50,26,25,543,51,594,8.585858585858587
15202,330455705160068,166,194,162,138,146,93,53,37,899,90,989,9.100101112234581
15203,330455705160069,116,93,148,79,70,70,48,29,576,77,653,11.791730474732006
15204,330455705160070,20,229,119,27,32,46,17,10,473,27,500,5.4
15205,330455705160071,89,83,113,106,93,63,36,30,547,66,613,10.766721044045678
15206,330455705160072,79,193,168,98,101,93,67,43,732,110,842,13.064133016627078
15207,330455705160073,91,134,138,127,97,85,57,55,672,112,784,14.285714285714286
15208,330455705160074,98,217,525,182,92,84,50,37,1198,87,1285,6.770428015564202
15209,330455705160075,70,86,111,116,86,78,34,36,547,70,617,11.345218800648299
15210,330455705160076,60,95,75,81,58,40,26,28,409,54,463,11.663066954643629
15211,330455705160077,70,73,105,64,49,35,15,10,396,25,421,5.938242280285036
15212,330455705160078,174,235,221,151,114,67,33,21,962,54,1016,5.31496062992126
15213,330455705160079,149,175,184,132,114,82,35,34,836,69,905,7.624309392265193
15214,330455705160080,203,234,194,192,123,91,49,34,1037,83,1120,7.410714285714286
15215,330455705160081,38,50,58,63,62,57,29,46,328,75,403,18.610421836228287
15216,330455705160082,43,53,74,63,67,77,45,62,377,107,484,22.107438016528924
15217,330455705160083,51,93,89,87,100,97,87,86,517,173,690,25.07246376811594
15218,330455705160084,59,80,102,88,88,121,89,94,538,183,721,25.381414701803052
15219,330455705160085,40,69,78,50,54,77,91,84,368,175,543,32.22836095764273
15220,330455705160086,92,150,198,81,79,49,41,29,649,70,719,9.735744089012517
15221,330455705160087,162,392,209,189,150,93,27,17,1195,44,1239,3.5512510088781277
15222,330455705160088,241,214,146,340,158,51,50,7,1150,57,1207,4.72245236122618
15223,330455705160089,79,116,223,63,37,40,14,3,558,17,575,2.9565217391304346
15224,330455705160090,53,89,95,44,58,39,24,14,378,38,416,9.134615384615385
15225,330455705160091,38,338,604,142,39,32,19,9,1193,28,1221,2.293202293202293
15226,330455705160092,42,94,121,63,53,42,25,25,415,50,465,10.75268817204301
15227,330455705160093,98,87,108,76,67,43,29,15,479,44,523,8.413001912045889
15228,330455705160094,145,288,307,179,165,105,43,37,1189,80,1269,6.304176516942475
15229,330455705160095,87,74,117,62,74,51,21,17,465,38,503,7.5546719681908545
15230,330455705160096,54,153,151,40,36,31,25,9,465,34,499,6.813627254509018
15231,330455705160097,45,50,52,40,35,32,27,15,254,42,296,14.18918918918919
15232,330455705160098,72,101,115,97,83,54,27,14,522,41,563,7.282415630550622
15233,330455705160099,29,28,47,36,45,32,20,21,217,41,258,15.891472868217054
15234,330455705160100,75,74,79,87,64,56,32,34,435,66,501,13.173652694610778
15235,330455705160101,97,91,122,82,89,78,34,32,559,66,625,10.56
15236,330455705160102,42,50,53,50,39,43,24,21,277,45,322,13.975155279503106
15237,330455705160103,217,202,213,176,129,77,39,23,1014,62,1076,5.762081784386617
15238,330455705160104,78,166,304,84,35,39,25,15,706,40,746,5.361930294906166
15239,330455705160105,102,198,273,140,91,101,30,27,905,57,962,5.925155925155925
15240,330455705160106,41,100,221,156,79,61,26,20,658,46,704,6.534090909090909
15241,330455705160107,133,180,241,109,94,42,35,15,799,50,849,5.889281507656066
15242,330455705160108,114,202,258,143,90,60,28,22,867,50,917,5.452562704471101
15243,330455705160109,64,85,87,83,59,38,30,27,416,57,473,12.050739957716702
15244,330455705160110,155,220,280,205,117,61,56,8,1038,64,1102,5.807622504537205
15245,330455705160111,58,78,148,99,112,140,80,41,635,121,756,16.005291005291006
15246,330455705160112,71,89,136,110,134,121,73,59,661,132,793,16.64564943253468
15247,330455705160113,195,211,205,168,103,77,53,32,959,85,1044,8.14176245210728
15248,330455705160114,119,114,134,91,44,41,28,10,543,38,581,6.540447504302926
15249,330455705160115,69,251,109,65,68,32,12,10,594,22,616,3.5714285714285716
15250,330455705160116,57,80,106,76,99,102,50,52,520,102,622,16.39871382636656
15251,330455705160117,38,63,78,73,63,83,54,58,398,112,510,21.96078431372549
15252,330455705160118,44,56,68,91,73,62,75,48,394,123,517,23.79110251450677
15253,330455705160119,56,83,87,90,77,83,64,72,476,136,612,22.22222222222222
15254,330455705160120,46,48,62,52,62,67,32,45,337,77,414,18.59903381642512
15255,330455705160121,22,35,54,48,43,51,30,35,253,65,318,20.440251572327043
15256,330455705160122,34,27,59,49,51,48,27,25,268,52,320,16.25
15257,330455705160123,37,55,73,49,49,49,60,57,312,117,429,27.272727272727273
15258,330455705160124,39,50,57,62,55,53,26,44,316,70,386,18.134715025906736
15259,330455705160125,83,85,119,97,78,105,51,61,567,112,679,16.49484536082474
15260,330455705160126,44,90,81,83,91,80,73,89,469,162,631,25.673534072900157
15261,330455705160127,103,144,125,133,148,106,107,99,759,206,965,21.34715025906736
15262,330455705160129,24,33,48,56,35,51,26,29,247,55,302,18.211920529801326
15263,330455705160130,39,38,70,48,47,38,30,27,280,57,337,16.91394658753709
15264,330455705160131,38,41,67,56,40,60,52,46,302,98,400,24.5
15265,330455705160132,77,91,118,104,120,110,77,94,620,171,791,21.61820480404551
15266,330455705160133,60,85,75,77,81,66,56,58,444,114,558,20.43010752688172
15267,330455705160134,45,32,74,81,51,67,42,42,350,84,434,19.35483870967742
15268,330455705160135,59,71,84,95,99,84,77,71,492,148,640,23.125
15269,330455705160136,56,61,91,86,78,79,66,57,451,123,574,21.428571428571427
15270,330455705160137,95,48,73,121,54,51,33,33,442,66,508,12.992125984251969
15271,330455705160138,35,61,47,57,54,53,32,43,307,75,382,19.63350785340314
15272,330455705160139,71,96,144,83,101,91,31,46,586,77,663,11.613876319758672
15273,330455705160140,32,65,64,67,56,66,39,39,350,78,428,18.22429906542056
15274,330455705160141,33,51,80,49,61,57,43,44,331,87,418,20.8133971291866
15275,330455705160142,198,223,306,316,160,95,94,38,1298,132,1430,9.23076923076923
15276,330455705160143,208,222,202,150,131,103,65,35,1016,100,1116,8.960573476702509
15277,330455705160144,86,146,141,151,114,109,79,65,747,144,891,16.161616161616163
15278,330455705160145,98,102,130,105,102,92,65,65,629,130,759,17.127799736495387
15279,330455705160146,84,88,126,116,117,95,76,76,626,152,778,19.53727506426735
15280,330455705160147,55,62,104,80,92,84,48,75,477,123,600,20.5
15281,330455705160148,55,75,83,83,77,67,55,44,440,99,539,18.367346938775512
15282,330455705160149,74,250,268,111,45,34,17,8,782,25,807,3.097893432465923
15283,330455705160150,76,78,114,106,95,97,53,62,566,115,681,16.886930983847282
15284,330455705160151,57,67,70,69,83,67,52,54,413,106,519,20.423892100192678
15285,330455705160152,35,68,92,63,80,89,70,76,427,146,573,25.479930191972077
15286,330455705160153,36,55,56,46,73,66,42,61,332,103,435,23.67816091954023
15287,330455705160154,49,94,118,101,104,107,63,64,573,127,700,18.142857142857142
15288,330455705160155,29,28,11,13,7,10,5,3,98,8,106,7.547169811320755
15289,330455705160156,113,135,131,125,71,59,36,28,634,64,698,9.169054441260744
15290,330455705160157,111,255,139,94,70,35,29,8,704,37,741,4.993252361673414
15291,330455705160158,54,116,114,67,39,21,5,12,411,17,428,3.97196261682243
15292,330455705160159,62,79,67,54,48,34,18,16,344,34,378,8.994708994708995
15293,330455705160160,116,382,216,102,56,67,43,12,939,55,994,5.533199195171026
15294,330455705160161,100,121,120,113,87,71,44,31,612,75,687,10.91703056768559
15295,330455705160162,130,146,140,108,77,76,31,24,677,55,732,7.5136612021857925
15296,330455705160163,104,215,176,116,88,90,54,46,789,100,889,11.24859392575928
15297,330455705160164,52,58,98,59,64,78,49,65,409,114,523,21.797323135755256
15298,330455705160165,60,91,105,88,91,108,87,95,543,182,725,25.103448275862068
15299,330455705160166,48,68,73,77,88,77,67,84,431,151,582,25.945017182130584
15300,330455705160167,42,66,72,77,73,64,45,30,394,75,469,15.991471215351812
15301,330455705160168,33,41,66,71,73,70,48,54,354,102,456,22.36842105263158
15302,330455705160169,52,70,49,37,35,16,16,9,259,25,284,8.80281690140845
15303,330455705160170,70,184,106,63,67,72,35,51,562,86,648,13.271604938271604
15304,330455705160171,33,49,72,78,62,86,60,47,380,107,487,21.971252566735114
15305,330455705160172,42,47,64,56,65,56,51,75,330,126,456,27.63157894736842
15306,330455705160173,56,83,86,89,117,89,67,62,520,129,649,19.87673343605547
15307,330455705160174,108,121,155,153,112,113,67,57,762,124,886,13.99548532731377
15308,330455705160175,135,123,91,84,69,45,24,14,547,38,585,6.495726495726496
15309,330455705160176,48,63,86,73,69,78,44,30,417,74,491,15.071283095723015
15310,330455705160177,36,51,60,42,52,48,15,27,289,42,331,12.688821752265861
15311,330455705160178,37,39,56,41,62,36,35,25,271,60,331,18.12688821752266
15312,330455705160179,69,88,96,83,95,56,47,40,487,87,574,15.156794425087108
15313,330455705160180,43,81,72,62,86,49,35,47,393,82,475,17.263157894736842
15314,330455705160181,74,79,108,113,90,104,60,74,568,134,702,19.08831908831909
15315,330455705160182,36,45,82,64,54,75,55,35,356,90,446,20.179372197309416
15316,330455705160183,41,96,106,85,106,110,76,78,544,154,698,22.063037249283667
15317,330455705160184,57,73,87,101,93,83,59,53,494,112,606,18.48184818481848
15318,330455705160185,29,49,80,114,81,45,19,29,398,48,446,10.762331838565023
15319,330455705160186,45,51,64,74,57,66,70,60,357,130,487,26.694045174537987
15320,330455705160187,88,106,158,131,128,150,87,117,761,204,965,21.139896373056995
15321,330455705160188,12,16,28,20,22,20,14,27,118,41,159,25.78616352201258
15322,330455705160189,77,96,133,122,105,134,89,100,667,189,856,22.07943925233645
15323,330455705160190,26,59,71,74,78,100,88,68,408,156,564,27.659574468085108
15324,330455705160191,64,79,112,126,113,146,85,74,640,159,799,19.899874843554443
15325,330455705160192,127,132,167,154,164,133,80,71,877,151,1028,14.688715953307392
15326,330455705160193,164,220,205,158,155,125,65,75,1027,140,1167,11.996572407883463
15327,330455705160194,41,34,57,36,31,35,30,30,234,60,294,20.408163265306122
15328,330455705160195,37,59,69,67,64,52,44,36,348,80,428,18.69158878504673
15329,330455705160196,52,51,82,74,65,82,48,52,406,100,506,19.76284584980237
15330,330455705160197,42,65,55,57,63,56,40,28,338,68,406,16.748768472906406
15331,330455705160198,58,40,77,55,58,69,42,42,357,84,441,19.047619047619047
15332,330455705160199,56,81,81,98,102,76,61,55,494,116,610,19.016393442622952
15333,330455705160200,67,107,99,97,115,89,78,81,574,159,733,21.69167803547067
15334,330455705160201,50,76,90,95,87,87,54,64,485,118,603,19.56882255389718
15335,330455705160202,49,79,82,63,89,87,46,60,449,106,555,19.0990990990991
15336,330455705160203,142,138,134,103,83,101,34,34,701,68,769,8.842652795838752
15337,330455705160204,91,123,172,136,124,99,105,72,745,177,922,19.197396963123644
15338,330455705160205,82,118,90,98,88,97,43,49,573,92,665,13.834586466165414
15339,330455705160206,37,52,63,55,43,59,36,34,309,70,379,18.46965699208443
15340,330455705160207,69,78,57,63,69,48,34,37,384,71,455,15.604395604395604
15341,330455705160208,82,115,107,89,139,104,45,55,636,100,736,13.58695652173913
15342,330455705160209,29,63,144,70,44,32,40,17,382,57,439,12.984054669703873
15343,330455705160210,31,51,76,66,74,66,51,67,364,118,482,24.481327800829874
15344,330455705160211,30,37,64,51,64,67,43,44,313,87,400,21.75
15345,330455705160212,32,50,42,61,59,40,39,54,284,93,377,24.6684350132626
15346,330455705160213,37,41,38,59,56,45,36,34,276,70,346,20.23121387283237
15347,330455705160214,53,50,69,74,71,61,72,53,378,125,503,24.85089463220676
15348,330455705160215,132,186,155,184,144,134,108,77,935,185,1120,16.517857142857142
15349,330455705160216,73,114,104,114,107,89,69,89,601,158,759,20.816864295125164
15350,330455705160217,83,125,102,110,133,100,71,87,653,158,811,19.482120838471022
15351,330455705160218,103,146,137,160,132,123,56,60,801,116,917,12.649945474372956
15352,330455705160219,22,35,73,53,122,40,19,12,345,31,376,8.24468085106383
15353,330455705160220,137,122,116,100,58,37,28,14,570,42,612,6.862745098039215
15354,330455705160221,232,274,251,223,211,129,76,30,1320,106,1426,7.433380084151473
15355,330455705160222,170,240,175,176,168,79,36,31,1008,67,1075,6.232558139534884
15356,330455705160223,60,76,70,49,61,45,59,32,361,91,452,20.13274336283186
15357,330455705160224,65,110,90,109,107,71,68,64,552,132,684,19.29824561403509
15358,330455705160225,53,89,78,68,77,83,46,52,448,98,546,17.94871794871795
15359,330455705160226,70,94,109,86,117,98,64,93,574,157,731,21.477428180574556
15360,330455705160227,52,76,78,72,85,71,56,58,434,114,548,20.802919708029197
15361,330455705160228,69,82,80,81,71,55,42,46,438,88,526,16.730038022813687
15362,330455705160229,78,96,94,73,99,84,41,51,524,92,616,14.935064935064934
15363,330455705160230,91,132,103,110,88,78,51,44,602,95,697,13.629842180774748
15364,330455705160231,67,119,114,82,115,80,58,49,577,107,684,15.64327485380117
15365,330455705160232,139,137,158,139,101,75,62,51,749,113,862,13.109048723897912
15366,330455705160233,97,134,119,131,107,93,84,76,681,160,841,19.024970273483948
15367,330455705160234,78,78,97,97,76,66,46,33,492,79,571,13.8353765323993
15368,330455705160235,70,107,88,87,94,83,60,62,529,122,651,18.740399385560675
15369,330455705160236,106,120,124,99,107,119,67,46,675,113,788,14.34010152284264
15370,330455705160237,131,178,158,148,155,115,77,63,885,140,1025,13.658536585365853
15371,330455705160238,153,182,155,151,138,95,48,44,874,92,966,9.523809523809524
15372,330455705160239,56,100,104,75,91,97,39,46,523,85,608,13.980263157894736
15373,330455705160240,299,286,244,320,180,101,106,26,1430,132,1562,8.450704225352112
15374,330455705160241,62,91,93,81,79,92,68,50,498,118,616,19.155844155844157
15375,330455705160242,71,85,104,91,102,94,75,72,547,147,694,21.181556195965417
15376,330455705160243,35,60,67,65,81,47,44,44,355,88,443,19.864559819413092
15377,330455705160244,28,45,48,54,63,55,51,44,293,95,388,24.484536082474225
15378,330455705160245,56,64,56,76,72,59,37,44,383,81,464,17.45689655172414
15379,330455705160246,68,88,90,82,97,87,50,61,512,111,623,17.81701444622793
15380,330455705160247,57,87,85,108,141,97,57,78,575,135,710,19.014084507042252
15381,330455705160248,34,50,45,52,87,52,37,38,320,75,395,18.9873417721519
15382,330455705160249,45,37,44,52,43,18,24,23,239,47,286,16.433566433566433
15383,330455705160250,52,97,78,83,66,50,31,48,426,79,505,15.643564356435643
15384,330455705160251,80,78,151,141,55,60,57,28,565,85,650,13.076923076923077
15385,330455705160252,112,113,123,116,125,103,41,44,692,85,777,10.939510939510939
15386,330455705160253,81,182,288,110,98,101,35,40,860,75,935,8.02139037433155
15387,330455705160254,87,102,160,100,83,78,50,49,610,99,709,13.963328631875882
15388,330455705160255,86,107,111,87,86,76,36,38,553,74,627,11.802232854864434
15389,330455705160256,57,91,59,89,74,33,19,21,403,40,443,9.029345372460497
15390,330455705160257,72,82,107,78,104,81,51,76,524,127,651,19.508448540706606
15391,330455705160258,50,73,98,101,85,107,104,94,514,198,712,27.808988764044944
15392,330455705160259,18,54,60,56,53,77,38,36,318,74,392,18.877551020408163
15393,330455705160260,46,113,105,90,145,107,47,84,606,131,737,17.774762550881952
15394,330455705160261,38,58,92,80,63,79,52,42,410,94,504,18.650793650793652
15395,330455705160262,72,82,117,126,82,129,95,69,608,164,772,21.243523316062177
15396,330455705160263,76,85,117,115,105,94,71,66,592,137,729,18.792866941015088
15397,330455705160264,47,63,88,95,100,76,33,74,469,107,576,18.57638888888889
15398,330455705160265,63,92,143,100,126,139,57,80,663,137,800,17.125
15399,330455705160266,33,56,52,39,62,42,32,20,284,52,336,15.476190476190476
15400,330455705160267,28,39,50,48,65,40,29,21,270,50,320,15.625
15401,330455705160268,60,101,133,113,110,113,74,49,630,123,753,16.334661354581673
15402,330455705160269,42,73,69,57,58,53,30,39,352,69,421,16.389548693586697
15403,330455705160270,42,126,153,158,162,62,40,71,703,111,814,13.636363636363637
15404,330455705160271,33,41,103,102,69,75,55,29,423,84,507,16.568047337278106
15405,330455705160272,73,80,94,113,83,100,71,60,543,131,674,19.43620178041543
15406,330455705160273,106,101,110,108,76,75,49,39,576,88,664,13.25301204819277
15407,330455705160274,65,104,104,90,89,92,41,57,544,98,642,15.264797507788161
15408,330455705160275,104,138,122,157,177,124,55,60,822,115,937,12.273212379935966
15409,330455705160276,90,88,93,101,49,42,27,28,463,55,518,10.617760617760618
15410,330455705160277,152,314,582,252,98,127,59,19,1525,78,1603,4.865876481597006
15411,330455705160278,191,216,167,139,102,49,27,8,864,35,899,3.8932146829810903
15412,330455705160279,118,105,149,167,55,54,15,6,648,21,669,3.1390134529147984
15413,330455705160280,179,198,181,131,141,74,55,25,904,80,984,8.130081300813009
15414,330455705160281,34,60,75,67,60,81,51,42,377,93,470,19.78723404255319
15415,330455705160282,50,72,83,77,68,83,43,73,433,116,549,21.129326047358834
15416,330455705160283,101,97,98,73,63,54,21,19,486,40,526,7.604562737642586
15417,330455705160284,149,168,171,120,102,55,40,17,765,57,822,6.934306569343065
15418,330455705160285,144,166,174,123,113,74,23,15,794,38,832,4.5673076923076925
15419,330455705160286,106,113,148,163,125,139,68,32,794,100,894,11.185682326621924
15420,330455705160287,52,42,39,32,25,13,6,6,203,12,215,5.5813953488372094
15421,330455705160288,62,36,75,40,53,35,29,30,301,59,360,16.38888888888889
15422,330455705160289,56,70,79,64,62,71,46,49,402,95,497,19.114688128772634
15423,330455705160290,77,92,83,77,73,67,16,18,469,34,503,6.759443339960239
15424,330455705160291,58,58,48,43,35,25,16,11,267,27,294,9.183673469387756
15425,330455705160292,79,74,66,67,62,51,20,24,399,44,443,9.932279909706546
15426,330455705160293,56,126,357,91,100,73,56,50,803,106,909,11.66116611661166
15427,330455705160294,84,85,102,115,124,64,56,61,574,117,691,16.931982633863964
15428,330455705160295,45,57,77,51,88,74,39,41,392,80,472,16.949152542372882
15429,330455705160296,54,49,36,50,18,15,9,7,222,16,238,6.722689075630252
15430,330455705160297,49,43,32,28,15,13,5,1,180,6,186,3.225806451612903
15431,330455705160298,4,3,10,7,6,1,5,0,31,5,36,13.88888888888889
15432,330455705160299,11,12,11,13,10,8,8,4,65,12,77,15.584415584415584
15433,330455705160300,56,119,201,84,28,20,15,2,508,17,525,3.238095238095238
15434,330455705160301,155,162,173,141,90,72,35,26,793,61,854,7.142857142857143
15435,330455705160303,45,82,48,66,73,55,27,39,369,66,435,15.172413793103448
15436,330455705170001,45,67,89,61,84,82,49,54,428,103,531,19.397363465160076
15437,330455705170002,70,88,131,126,122,98,39,32,635,71,706,10.056657223796034
15438,330455705170003,105,99,130,137,134,122,82,67,727,149,876,17.009132420091323
15439,330455705170004,32,47,58,41,37,60,46,42,275,88,363,24.242424242424242
15440,330455705170005,90,98,70,68,37,50,24,11,413,35,448,7.8125
15441,330455705170006,145,185,216,143,129,107,52,64,925,116,1041,11.143131604226705
15442,330455705170007,229,266,346,229,151,97,52,21,1318,73,1391,5.24802300503235
15443,330455705170008,69,99,150,107,103,110,66,57,638,123,761,16.16294349540079
15444,330455705170009,49,60,91,111,85,92,46,56,488,102,590,17.28813559322034
15445,330455705170010,80,122,170,169,146,122,108,95,809,203,1012,20.059288537549406
15446,330455705170012,25,65,93,67,62,51,37,40,363,77,440,17.5
15447,330455705170013,55,84,98,106,91,81,57,79,515,136,651,20.89093701996928
15448,330455705170014,50,91,121,98,113,123,115,83,596,198,794,24.937027707808564
15449,330455705170015,81,96,141,136,124,103,71,72,681,143,824,17.354368932038835
15450,330455705170016,46,81,60,94,75,72,50,51,428,101,529,19.092627599243855
15451,330455705170017,35,53,67,60,85,69,40,48,369,88,457,19.25601750547046
15452,330455705170018,53,60,70,82,83,77,28,56,425,84,509,16.50294695481336
15453,330455705170019,33,50,86,87,67,81,61,70,404,131,535,24.485981308411215
15454,330455705170020,80,124,122,153,154,120,95,65,753,160,913,17.524644030668128
15455,330455705170023,33,52,70,79,76,67,49,78,377,127,504,25.1984126984127
15456,330455705170024,76,100,134,134,150,148,99,98,742,197,939,20.979765708200212
15457,330455705170025,43,44,78,67,51,47,32,33,330,65,395,16.455696202531644
15458,330455705170026,60,112,115,133,117,133,82,80,670,162,832,19.471153846153847
15459,330455705170027,37,69,91,74,89,114,70,87,474,157,631,24.881141045958795
15460,330455705170028,38,66,64,72,97,55,32,56,392,88,480,18.333333333333332
15461,330455705170029,47,59,82,97,73,79,57,74,437,131,568,23.06338028169014
15462,330455705170030,55,70,112,70,99,112,67,114,518,181,699,25.894134477825464
15463,330455705170031,35,65,74,80,66,64,52,39,384,91,475,19.157894736842106
15464,330455705170032,91,90,139,107,132,87,49,47,646,96,742,12.93800539083558
15465,330455705170033,27,43,81,104,70,103,94,50,428,144,572,25.174825174825173
15466,330455705170034,13,25,35,23,27,28,23,25,151,48,199,24.12060301507538
15467,330455705170035,59,72,94,104,77,80,38,57,486,95,581,16.351118760757316
15468,330455705170036,51,65,105,71,73,83,49,47,448,96,544,17.647058823529413
15469,330455705170037,53,64,64,93,85,75,53,49,434,102,536,19.029850746268657
15470,330455705170038,0,0,0,0,0,0,4,46,0,50,50,100.0
15471,330455705170039,59,70,76,96,76,68,66,63,445,129,574,22.473867595818817
15472,330455705170040,40,75,112,74,107,106,50,85,514,135,649,20.801232665639446
15473,330455705170041,53,52,84,79,83,85,58,82,436,140,576,24.305555555555557
15474,330455705170042,43,65,108,100,93,91,59,28,500,87,587,14.821124361158432
15475,330455705170043,53,59,64,69,54,70,41,62,369,103,472,21.822033898305083
15476,330455705170044,47,73,66,67,70,65,40,32,388,72,460,15.652173913043478
15477,330455705170045,48,69,79,95,86,70,58,53,447,111,558,19.892473118279568
15478,330455705170046,38,55,96,83,77,99,70,77,448,147,595,24.705882352941178
15479,330455705170047,84,100,128,123,146,123,93,110,704,203,907,22.381477398015434
15480,330455705170049,145,91,87,77,43,37,23,14,480,37,517,7.156673114119923
15481,330455705170050,118,121,111,114,107,56,36,39,627,75,702,10.683760683760683
15482,330455705170051,41,62,71,83,68,86,52,75,411,127,538,23.605947955390334
15483,330455705170052,23,47,43,46,56,40,25,34,255,59,314,18.78980891719745
15484,330455705170053,62,67,94,79,83,78,58,70,463,128,591,21.658206429780034
15485,330455705170054,91,120,160,132,90,73,28,25,666,53,719,7.37134909596662
15486,330455705170055,48,55,78,71,55,52,36,38,359,74,433,17.090069284064665
15487,330455705170056,140,149,108,122,77,55,33,25,651,58,709,8.180535966149506
15488,330455705170057,88,132,114,84,71,50,27,6,539,33,572,5.769230769230769
15489,330455705170058,75,105,99,104,87,107,79,71,577,150,727,20.63273727647868
15490,330455705170059,78,104,115,110,83,106,58,74,596,132,728,18.13186813186813
15491,330455705170060,60,89,75,85,110,59,33,48,478,81,559,14.490161001788909
15492,330455705170061,126,114,179,187,133,113,83,43,852,126,978,12.883435582822086
15493,330455705170062,67,67,83,84,59,45,26,26,405,52,457,11.37855579868709
15494,330455705170063,64,86,101,94,89,99,52,64,533,116,649,17.873651771956858
15495,330455705170064,87,90,113,94,103,59,42,41,546,83,629,13.195548489666137
15496,330455705170065,34,52,80,67,71,75,58,40,379,98,477,20.545073375262053
15497,330455705170066,103,106,144,131,117,104,66,64,705,130,835,15.568862275449101
15498,330455705170067,278,295,238,239,180,89,69,33,1319,102,1421,7.178043631245601
15499,330455705170068,220,238,221,158,120,70,58,29,1027,87,1114,7.809694793536805
15500,330455705170069,55,82,166,85,103,119,63,66,610,129,739,17.456021650879567
15501,330455705170070,45,76,100,77,91,84,60,68,473,128,601,21.29783693843594
15502,330455705170071,70,62,111,100,83,73,40,40,499,80,579,13.81692573402418
15503,330455705170072,26,43,37,39,37,43,21,29,225,50,275,18.181818181818183
15504,330455705170073,130,147,219,164,123,39,40,9,822,49,871,5.625717566016074
15505,330455705170074,120,183,81,112,70,34,17,1,600,18,618,2.912621359223301
15506,330455705170075,32,43,54,43,31,54,37,33,257,70,327,21.406727828746178
15507,330455705170076,57,55,98,81,76,85,65,76,452,141,593,23.777403035413155
15508,330455705170077,36,48,66,60,44,53,37,39,307,76,383,19.843342036553526
15509,330455705170078,42,93,103,76,94,94,58,55,502,113,615,18.3739837398374
15510,330455705170079,17,36,40,36,38,39,27,49,206,76,282,26.95035460992908
15511,330455705170080,30,47,62,66,73,67,42,59,345,101,446,22.6457399103139
15512,330455705170081,75,91,112,126,106,82,65,65,592,130,722,18.005540166204987
15513,330455705170082,41,62,77,77,82,76,47,51,415,98,513,19.103313840155945
15514,330455705170083,61,84,87,65,86,94,51,59,477,110,587,18.739352640545146
15515,330455705170084,49,56,92,85,68,80,45,57,430,102,532,19.172932330827066
15516,330455705170085,32,47,64,48,48,58,44,39,297,83,380,21.842105263157894
15517,330455705170086,60,96,123,122,113,102,58,59,616,117,733,15.961800818553888
15518,330455705170087,69,87,88,102,110,93,46,42,549,88,637,13.814756671899529
15519,330455705170088,70,110,107,126,107,102,61,46,622,107,729,14.67764060356653
15520,330455705170089,77,79,158,153,95,130,86,62,692,148,840,17.61904761904762
15521,330455705170090,85,91,131,117,115,118,71,58,657,129,786,16.412213740458014
15522,330455705170091,58,87,77,119,86,91,72,64,518,136,654,20.795107033639145
15523,330455705170092,82,100,132,141,182,92,61,21,729,82,811,10.110974106041924
15524,330455705170093,55,82,104,84,109,99,76,82,533,158,691,22.865412445730826
15525,330455705170094,52,48,41,41,30,26,19,8,238,27,265,10.18867924528302
15526,330455705170095,37,47,58,43,35,36,16,14,256,30,286,10.48951048951049
15527,330455705170096,33,47,59,84,71,81,41,54,375,95,470,20.21276595744681
15528,330455705170097,174,220,197,177,138,135,86,86,1041,172,1213,14.179719703215168
15529,330455705170098,69,100,125,138,121,86,68,72,639,140,779,17.971758664955072
15530,330455705170099,94,234,150,188,203,123,71,44,992,115,1107,10.38843721770551
15531,330455705170100,85,95,118,133,109,92,49,52,632,101,733,13.778990450204638
15532,330455705170101,87,104,139,120,129,129,69,94,708,163,871,18.714121699196326
15533,330455705170102,40,67,64,74,83,76,46,43,404,89,493,18.052738336713997
15534,330455705170103,71,109,140,138,125,132,77,92,715,169,884,19.11764705882353
15535,330455705170104,54,70,90,60,67,54,34,27,395,61,456,13.37719298245614
15536,330455705170105,255,279,287,246,149,134,57,36,1350,93,1443,6.444906444906445
15537,330455705170106,130,101,115,131,104,77,39,31,658,70,728,9.615384615384615
15538,330455705170107,156,166,143,151,105,67,39,13,788,52,840,6.190476190476191
15539,330455705170108,84,84,78,59,82,60,34,26,447,60,507,11.834319526627219
15540,330455705170109,64,93,107,105,94,97,63,53,560,116,676,17.159763313609467
15541,330455705170110,37,54,65,63,71,55,29,50,345,79,424,18.632075471698112
15542,330455705170111,63,62,84,70,72,57,31,47,408,78,486,16.049382716049383
15543,330455705170112,47,58,87,79,64,74,43,40,409,83,492,16.869918699186993
15544,330455705170113,75,88,119,104,124,96,54,61,606,115,721,15.9500693481276
15545,330455705170114,188,176,223,153,125,118,47,35,983,82,1065,7.699530516431925
15546,330455705170115,88,121,87,66,63,40,9,9,465,18,483,3.7267080745341614
15547,330455705170116,118,184,133,125,112,70,40,44,742,84,826,10.169491525423728
15548,330455705170117,89,110,83,83,53,45,19,17,463,36,499,7.214428857715431
15549,330455705170118,75,106,97,70,71,48,18,18,467,36,503,7.157057654075547
15550,330455705170119,42,61,91,81,76,71,46,67,422,113,535,21.121495327102803
15551,330455705170120,31,53,50,47,54,50,30,29,285,59,344,17.151162790697676
15552,330455705170121,161,187,240,219,209,184,103,75,1200,178,1378,12.917271407837445
15553,330455705170122,78,86,128,155,114,85,73,41,646,114,760,15.0
15554,330455705170123,92,97,138,160,109,114,84,74,710,158,868,18.202764976958527
15555,330455705170124,43,93,90,93,99,117,61,81,535,142,677,20.974889217134418
15556,330455705170125,29,31,57,53,34,64,39,44,268,83,351,23.646723646723647
15557,330455705170126,71,72,81,104,92,84,62,86,504,148,652,22.699386503067483
15558,330455705170127,51,55,94,91,63,104,59,59,458,118,576,20.48611111111111
15559,330455705170128,109,133,176,153,147,138,60,66,856,126,982,12.830957230142566
15560,330455705170129,53,75,93,85,111,81,45,45,498,90,588,15.306122448979592
15561,330455705170130,39,70,153,111,139,117,63,95,629,158,787,20.076238881829735
15562,330455705170131,11,34,20,31,32,8,6,14,136,20,156,12.820512820512821
15563,330455705170132,113,157,138,112,116,108,69,98,744,167,911,18.331503841931944
15564,330455705170133,186,256,265,253,605,236,166,250,1801,416,2217,18.764095624718088
15565,330455705170134,113,121,119,141,93,74,43,34,661,77,738,10.433604336043361
15566,330455705170135,130,161,142,116,165,107,49,44,821,93,914,10.175054704595185
15567,330455705170136,77,79,101,94,100,92,50,74,543,124,667,18.590704647676162
15568,330455705170137,69,82,97,102,91,73,60,44,514,104,618,16.828478964401295
15569,330455705170138,57,91,114,105,125,135,86,107,627,193,820,23.536585365853657
15570,330455705170139,32,23,27,37,42,25,27,32,186,59,245,24.081632653061224
15571,330455705170140,52,80,134,103,120,121,88,110,610,198,808,24.504950495049506
15572,330455705170141,80,93,129,113,136,128,77,109,679,186,865,21.502890173410403
15573,330455705170142,38,58,83,72,81,94,53,63,426,116,542,21.40221402214022
15574,330455705170144,46,79,122,84,102,120,92,101,553,193,746,25.871313672922252
15575,330455705170145,57,50,103,117,72,69,45,57,468,102,570,17.894736842105264
15576,330455705170146,43,55,105,97,75,90,68,85,465,153,618,24.75728155339806
15577,330455705170147,52,69,79,103,79,77,64,49,459,113,572,19.755244755244757
15578,330455705170148,33,34,49,72,49,42,40,49,279,89,368,24.184782608695652
15579,330455705170149,48,73,89,90,78,79,58,44,457,102,559,18.246869409660107
15580,330455705170150,33,48,79,47,48,63,32,41,318,73,391,18.67007672634271
15581,330455705170151,87,101,128,133,118,119,65,76,686,141,827,17.04957678355502
15582,330455705170152,100,84,126,140,88,81,70,57,619,127,746,17.024128686327078
15583,330455705170153,86,102,111,117,87,94,57,60,597,117,714,16.386554621848738
15584,330455705170154,25,43,77,39,48,85,49,53,317,102,419,24.343675417661096
15585,330455705170155,45,69,74,87,88,88,63,69,451,132,583,22.641509433962263
15586,330455705170156,36,39,74,75,71,70,51,46,365,97,462,20.995670995670995
15587,330455705170157,61,77,70,56,60,50,30,25,374,55,429,12.820512820512821
15588,330455705170158,90,109,146,119,98,85,40,45,647,85,732,11.612021857923498
15589,330455705170159,264,299,242,203,142,102,41,27,1252,68,1320,5.151515151515151
15590,330455705170160,166,231,152,138,126,80,27,31,893,58,951,6.0988433228180865
15591,330455705170161,179,190,175,152,110,76,26,26,882,52,934,5.56745182012848
15592,330455705170162,152,179,171,195,137,108,66,41,942,107,1049,10.200190657769305
15593,330455705170163,237,291,274,221,235,131,59,55,1389,114,1503,7.584830339321357
15594,330455705170164,78,82,84,51,52,36,19,9,383,28,411,6.81265206812652
15595,330455705170165,77,98,108,122,92,90,59,82,587,141,728,19.36813186813187
15596,330455705170166,58,47,76,94,70,67,42,42,412,84,496,16.93548387096774
15597,330455705170167,39,61,77,77,100,71,54,55,425,109,534,20.411985018726593
15598,330455705170168,43,74,82,99,81,85,58,80,464,138,602,22.92358803986711
15599,330455705170169,21,36,61,73,54,57,52,54,302,106,408,25.980392156862745
15600,330455705170170,80,73,138,146,117,154,81,72,708,153,861,17.770034843205575
15601,330455705170171,93,129,115,153,131,79,55,36,700,91,791,11.504424778761061
15602,330455705170172,79,116,124,131,127,115,87,106,692,193,885,21.807909604519775
15603,330455705170173,128,175,298,253,378,226,142,98,1458,240,1698,14.134275618374557
15604,330455705170174,26,36,66,47,62,87,54,115,324,169,493,34.27991886409736
15605,330455705170175,48,86,129,99,127,151,113,184,640,297,937,31.69690501600854
15606,330455705170176,34,50,69,62,65,82,74,102,362,176,538,32.71375464684015
15607,330455705170177,60,57,86,91,78,101,78,84,473,162,635,25.511811023622048
15608,330455705170178,25,37,76,62,62,71,58,85,333,143,476,30.04201680672269
15609,330455705170179,16,32,39,28,52,62,38,71,229,109,338,32.248520710059175
15610,330455705170180,55,58,142,108,129,154,99,126,646,225,871,25.832376578645235
15611,330455705170181,32,68,101,85,98,113,96,109,497,205,702,29.202279202279204
15612,330455705170182,50,65,93,81,70,106,65,77,465,142,607,23.393739703459637
15613,330455705170183,28,44,54,68,54,59,50,59,307,109,416,26.201923076923077
15614,330455705170184,31,41,62,73,70,94,59,89,371,148,519,28.516377649325626
15615,330455705170185,65,91,140,99,123,132,68,100,650,168,818,20.537897310513447
15616,330455705170186,44,51,112,81,94,124,89,87,506,176,682,25.806451612903224
15617,330455705170187,42,66,92,85,72,110,58,72,467,130,597,21.775544388609717
15618,330455705170188,27,43,63,50,79,60,48,66,322,114,436,26.146788990825687
15619,330455705170189,64,72,118,137,96,125,77,88,612,165,777,21.235521235521237
15620,330455705170190,58,58,109,105,73,111,59,50,514,109,623,17.49598715890851
15621,330455705170191,53,81,105,100,117,117,96,117,573,213,786,27.099236641221374
15622,330455705170192,42,60,92,83,91,88,88,96,456,184,640,28.75
15623,330455705170193,49,78,103,103,110,105,80,114,548,194,742,26.1455525606469
15624,330455705170194,31,64,94,70,84,101,71,122,444,193,637,30.298273155416013
15625,330455705170195,23,25,58,56,58,54,45,58,274,103,377,27.320954907161802
15626,330455705170196,71,69,145,136,102,113,77,92,636,169,805,20.993788819875775
15627,330455705170197,41,63,126,77,94,143,72,111,544,183,727,25.17193947730399
15628,330455705170198,34,77,99,86,97,106,94,117,499,211,710,29.718309859154928
15629,330455705170199,71,128,116,136,152,164,80,74,767,154,921,16.720955483170467
15630,330455705170200,62,89,111,131,137,131,104,129,661,233,894,26.062639821029084
15631,330455705170201,51,78,80,69,80,45,44,32,403,76,479,15.866388308977035
15632,330455705170202,32,41,78,56,70,67,50,84,344,134,478,28.03347280334728
15633,330455705170203,16,23,29,27,34,38,28,41,167,69,236,29.23728813559322
15634,330455705170204,53,58,117,91,94,119,74,71,532,145,677,21.418020679468242
15635,330455705170205,43,55,92,85,111,64,50,41,450,91,541,16.820702402957487
15636,330455705170206,57,65,140,120,94,106,67,82,582,149,731,20.383036935704514
15637,330455705170207,44,54,89,98,92,87,61,75,464,136,600,22.666666666666668
15638,330455705170208,42,45,44,41,35,27,19,12,234,31,265,11.69811320754717
15639,330455705170209,31,61,88,65,70,113,92,130,428,222,650,34.15384615384615
15640,330455705170210,30,27,52,63,59,61,71,119,292,190,482,39.41908713692946
15641,330455705170211,47,67,84,93,99,106,72,95,496,167,663,25.188536953242835
15642,330455705170212,21,41,50,54,60,54,62,74,280,136,416,32.69230769230769
15643,330455705170213,44,78,96,69,104,92,69,79,483,148,631,23.454833597464344
15644,330455705170214,30,37,65,46,75,86,77,99,339,176,515,34.1747572815534
15645,330455705170215,31,64,79,99,86,114,103,130,473,233,706,33.0028328611898
15646,330455705170216,62,92,126,109,114,157,100,125,660,225,885,25.423728813559322
15647,330455705170217,73,103,127,138,129,137,112,131,707,243,950,25.57894736842105
15648,330455705170218,53,88,150,102,125,162,87,98,680,185,865,21.387283236994218
15649,330455705170219,32,67,84,82,73,96,52,83,434,135,569,23.725834797891036
15650,330455705170220,25,46,63,41,61,70,47,66,306,113,419,26.968973747016708
15651,330455705170221,46,90,157,90,120,153,91,119,656,210,866,24.249422632794456
15652,330455705170222,36,46,108,75,75,105,73,117,445,190,635,29.921259842519685
15653,330455705170223,25,38,67,47,51,65,51,86,293,137,430,31.86046511627907
15654,330455705170224,59,72,128,98,91,135,82,54,583,136,719,18.915159944367176
15655,330455705170225,35,35,91,76,58,72,64,44,367,108,475,22.736842105263158
15656,330455705170226,48,89,121,139,111,141,102,113,649,215,864,24.88425925925926
15657,330455705170227,101,111,142,162,165,154,102,90,835,192,1027,18.6952288218111
15658,330455705170228,59,76,133,99,105,109,80,72,581,152,733,20.73669849931787
15659,330455705170229,39,73,99,82,97,111,100,106,501,206,707,29.13719943422914
15660,330455705170230,79,82,134,129,154,123,81,74,701,155,856,18.10747663551402
15661,330455705170231,39,54,86,83,71,79,62,69,412,131,543,24.12523020257827
15662,330455705170232,39,68,105,81,111,125,82,127,529,209,738,28.319783197831978
15663,330455705170233,23,44,82,56,63,79,56,106,347,162,509,31.827111984282908
15664,330455705170234,43,65,102,69,115,108,95,129,502,224,726,30.853994490358126
15665,330455705170235,61,99,142,93,119,139,86,93,653,179,832,21.514423076923077
15666,330455705170236,12,26,56,55,41,86,57,84,276,141,417,33.81294964028777
15667,330455705170237,34,59,80,65,84,72,66,94,394,160,554,28.880866425992778
15668,330455705170238,25,74,64,73,78,85,47,78,399,125,524,23.85496183206107
15669,330455705170239,72,82,140,103,96,111,74,138,604,212,816,25.980392156862745
15670,330455705170240,41,69,69,76,91,98,67,116,444,183,627,29.1866028708134
15671,330455705170241,14,44,49,34,43,48,43,49,232,92,324,28.395061728395063
15672,330455705170242,28,55,69,68,67,89,75,91,376,166,542,30.627306273062732
15673,330455705170243,85,112,137,158,136,132,82,87,760,169,929,18.191603875134554
15674,330455705170244,45,67,104,98,76,85,58,65,475,123,598,20.568561872909697
15675,330455705170245,63,92,128,111,114,151,95,97,659,192,851,22.561692126909517
15676,330455705170246,45,45,49,69,82,78,38,52,368,90,458,19.650655021834062
15677,330455705170247,73,68,109,104,122,108,83,75,584,158,742,21.29380053908356
15678,330455705170248,23,57,84,57,82,75,63,61,378,124,502,24.701195219123505
15679,330455705170249,61,78,92,109,110,85,58,54,535,112,647,17.31066460587326
15680,330455705170250,59,69,118,118,107,89,45,60,560,105,665,15.789473684210526
15681,330455705170251,41,81,84,94,101,101,66,56,502,122,624,19.55128205128205
15682,330455705170252,17,24,38,29,29,28,17,33,165,50,215,23.25581395348837
15683,330455705170253,66,88,118,109,114,116,55,45,611,100,711,14.064697609001406
15684,330455705170254,28,35,65,54,56,52,37,56,290,93,383,24.281984334203656
15685,330455705170255,27,49,66,76,58,65,67,47,341,114,455,25.054945054945055
15686,330455705170256,35,60,68,91,77,88,54,78,419,132,551,23.95644283121597
15687,330455705170257,46,48,93,84,73,75,81,59,419,140,559,25.044722719141323
15688,330455705170258,46,45,66,63,76,58,39,57,354,96,450,21.333333333333332
15689,330455705170259,55,78,86,120,69,87,54,82,495,136,631,21.55309033280507
15690,330455705170260,131,210,207,190,308,218,120,142,1264,262,1526,17.169069462647446
15691,330455705170261,71,96,122,98,124,123,114,83,634,197,831,23.70637785800241
15692,330455705170262,78,110,145,149,150,136,91,90,768,181,949,19.072708113804005
15693,330455705170263,0,0,1,1,0,2,1,1,4,2,6,33.333333333333336
15694,330455705170264,93,138,139,213,205,173,94,103,961,197,1158,17.012089810017272
15695,330455705170265,52,63,89,112,97,125,59,73,538,132,670,19.70149253731343
15696,330455705170266,32,60,107,82,90,104,58,65,475,123,598,20.568561872909697
15697,330455705170267,59,65,77,108,89,99,58,60,497,118,615,19.1869918699187
15698,330455705170268,55,87,108,113,89,109,87,113,561,200,761,26.281208935611037
15699,330455705170269,107,129,133,207,179,157,88,111,912,199,1111,17.911791179117913
15700,330455705170270,43,83,99,94,88,89,82,49,496,131,627,20.893141945773525
15701,330455705170271,53,50,70,81,77,82,70,103,413,173,586,29.522184300341298
15702,330455705170272,57,77,113,127,113,108,67,52,595,119,714,16.666666666666668
15703,330455705170273,58,88,117,113,127,143,89,112,646,201,847,23.73081463990555
15704,330455705170274,38,82,119,107,105,159,86,102,610,188,798,23.55889724310777
15705,330455705170275,89,103,138,132,141,103,68,83,706,151,857,17.6196032672112
15706,330455705170276,69,71,116,103,96,90,77,89,545,166,711,23.347398030942333
15707,330455705170277,59,88,119,102,119,94,63,71,581,134,715,18.74125874125874
15708,330455705170278,50,55,152,141,124,111,66,99,633,165,798,20.67669172932331
15709,330455705170279,53,63,88,101,82,72,65,67,459,132,591,22.33502538071066
15710,330455705170280,64,87,106,130,137,98,96,92,622,188,810,23.209876543209877
15711,330455705170281,35,36,46,48,56,53,25,52,274,77,351,21.937321937321936
15712,330455705170282,82,82,73,147,134,67,49,46,585,95,680,13.970588235294118
15713,330455705170283,91,84,134,130,142,137,70,99,718,169,887,19.052987598647125
15714,330455705170284,41,53,97,83,63,107,45,46,444,91,535,17.009345794392523
15715,330455705170285,37,62,98,97,74,84,62,69,452,131,583,22.46998284734134
15717,330455705170287,39,54,95,82,99,118,79,82,487,161,648,24.84567901234568
15718,330455705170288,33,95,117,93,70,92,39,32,500,71,571,12.43432574430823
15719,330455705170289,55,70,98,102,108,98,61,46,531,107,638,16.771159874608152
15720,330455705170290,27,60,53,66,59,71,44,39,336,83,419,19.809069212410503
15721,330455705170291,31,34,54,47,47,55,47,51,268,98,366,26.775956284153004
15722,330455705170292,55,81,117,111,129,126,101,97,619,198,817,24.23500611995104
15723,330455705170293,42,77,86,88,92,90,69,60,475,129,604,21.357615894039736
15724,330455705170294,31,26,48,55,47,54,30,30,261,60,321,18.69158878504673
15725,330455705170295,50,51,78,116,75,53,49,42,423,91,514,17.704280155642024
15726,330455705170296,75,106,119,128,110,97,43,82,635,125,760,16.44736842105263
15727,330455705170297,41,39,96,62,66,79,59,60,383,119,502,23.705179282868524
15728,330455705170298,64,67,116,110,92,103,67,70,552,137,689,19.88388969521045
15729,330455705170299,100,118,127,249,147,111,67,64,852,131,983,13.326551373346897
15730,330455705170300,43,70,99,100,94,117,60,67,523,127,650,19.53846153846154
15731,330455705170301,63,80,123,106,103,106,67,66,581,133,714,18.627450980392158
15732,330455705170302,108,122,159,184,122,141,77,76,836,153,989,15.470171890798786
15733,330455705170303,27,67,62,58,76,69,57,66,359,123,482,25.518672199170126
15734,330455705170304,144,162,182,169,156,121,71,85,934,156,1090,14.311926605504587
15735,330455705170305,54,65,70,71,70,75,55,57,405,112,517,21.663442940038685
15736,330455705170306,54,89,90,89,86,71,58,79,479,137,616,22.24025974025974
15737,330455705170307,54,96,133,97,116,122,77,64,618,141,759,18.57707509881423
15738,330455705170308,65,90,139,169,133,81,51,39,677,90,767,11.734028683181226
15739,330455705170309,35,49,73,75,49,64,44,44,345,88,433,20.323325635103927
15740,330455705170310,43,58,58,50,59,59,40,51,327,91,418,21.770334928229666
15741,330455705170311,96,99,99,148,117,133,84,87,692,171,863,19.81460023174971
15742,330455705170312,39,70,86,72,64,67,59,71,398,130,528,24.62121212121212
15743,330455705170313,100,112,84,70,61,34,21,13,461,34,495,6.8686868686868685
15744,330455705170314,49,88,62,87,58,72,58,29,416,87,503,17.296222664015904
15745,330455705170315,61,59,111,103,82,113,65,79,529,144,673,21.39673105497771
15746,330455705170316,95,161,115,194,194,89,71,75,848,146,994,14.688128772635816
15747,330455705170317,24,9,13,12,9,8,2,3,75,5,80,6.25
15748,330455705170318,69,63,96,129,85,76,60,57,518,117,635,18.4251968503937
15749,330455705170319,68,103,85,125,104,84,62,99,569,161,730,22.054794520547944
15750,330455705170320,46,44,23,36,13,11,10,3,173,13,186,6.989247311827957
15751,330455705170321,69,99,143,137,100,129,69,70,677,139,816,17.034313725490197
15752,330455705170322,81,138,103,153,145,90,62,58,710,120,830,14.457831325301205
15753,330455705170323,74,122,152,199,134,127,69,95,808,164,972,16.872427983539094
15754,330455705170324,61,64,70,87,75,70,47,53,427,100,527,18.975332068311197
15755,330455705170325,59,75,82,87,87,48,40,44,438,84,522,16.091954022988507
15756,330455705170326,45,69,105,97,86,107,70,91,509,161,670,24.029850746268657
15757,330455705170327,47,71,78,94,94,95,51,67,479,118,597,19.765494137353432
15758,330455705170328,36,67,78,92,96,88,76,74,457,150,607,24.71169686985173
15759,330455705170329,36,55,58,59,58,78,48,76,344,124,468,26.495726495726494
15760,330455705170330,27,49,38,53,35,54,50,59,256,109,365,29.863013698630137
15761,330455705170331,32,51,80,96,74,92,79,93,425,172,597,28.8107202680067
15762,330455705170332,48,57,96,98,99,103,74,86,501,160,661,24.20574886535552
15763,330455705170333,23,42,65,39,63,64,42,52,296,94,390,24.102564102564102
15764,330455705170334,50,71,115,127,98,110,72,81,571,153,724,21.132596685082873
15765,330455705170335,55,68,112,96,122,123,66,81,576,147,723,20.33195020746888
15766,330455705170336,50,68,74,64,63,58,42,64,377,106,483,21.946169772256727
15767,330455705170337,57,79,132,125,141,88,69,72,622,141,763,18.479685452162517
15768,330455705170338,109,111,135,139,117,110,70,73,721,143,864,16.550925925925927
15769,330455705170339,65,96,118,118,113,118,63,69,628,132,760,17.36842105263158
15770,330455705170340,59,83,86,65,103,115,66,79,511,145,656,22.103658536585368
15771,330455705170341,64,62,93,79,77,96,70,82,471,152,623,24.398073836276083
15773,330455705170343,37,47,94,74,69,89,58,66,410,124,534,23.220973782771537
15774,330455705170344,43,47,77,73,59,83,63,60,382,123,505,24.356435643564357
15775,330455705170345,81,93,120,134,125,129,89,93,682,182,864,21.064814814814813
15776,330455705170346,130,137,126,190,163,116,65,65,862,130,992,13.10483870967742
15777,330455705170347,28,53,58,55,78,78,46,76,350,122,472,25.847457627118644
15778,330455705170348,66,103,114,99,114,131,63,73,627,136,763,17.82437745740498
15779,330455705170349,36,66,65,65,74,89,55,73,395,128,523,24.47418738049713
15780,330455705170350,32,60,79,89,101,73,53,87,434,140,574,24.390243902439025
15781,330455705170351,32,46,71,55,50,81,66,61,335,127,462,27.48917748917749
15782,330455705170352,40,75,83,81,83,64,59,69,426,128,554,23.104693140794225
15783,330455705170353,46,56,71,67,63,50,60,62,353,122,475,25.68421052631579
15784,330455705170354,51,62,88,73,77,88,53,63,439,116,555,20.9009009009009
15785,330455705170355,62,57,77,78,66,75,47,64,415,111,526,21.102661596958175
15786,330455705170356,58,102,122,112,110,123,68,86,627,154,781,19.718309859154928
15787,330455705170357,28,54,61,66,79,60,62,78,348,140,488,28.688524590163933
15788,330455705170358,51,84,80,78,98,85,41,53,476,94,570,16.49122807017544
15789,330455705170359,48,35,73,59,55,79,39,51,349,90,439,20.50113895216401
15790,330455705170360,112,161,104,132,93,62,42,28,664,70,734,9.536784741144414
15791,330455705170361,46,62,94,72,68,81,39,59,423,98,521,18.809980806142036
15792,330455705170362,54,49,63,84,55,51,30,27,356,57,413,13.801452784503631
15793,330455705170363,82,120,102,102,81,62,47,33,549,80,629,12.718600953895072
15794,330455705170364,87,85,125,78,90,77,41,34,542,75,617,12.155591572123177
15795,330455705170365,159,191,219,206,152,122,77,44,1049,121,1170,10.341880341880342
15796,330455705170366,49,92,109,74,92,102,61,86,518,147,665,22.105263157894736
15797,330455705170367,53,79,88,101,105,86,46,82,512,128,640,20.0
15798,330455705170369,62,74,91,86,79,77,44,76,469,120,589,20.37351443123939
15799,330455705170370,58,52,106,88,81,95,73,75,480,148,628,23.56687898089172
15800,330455705170371,51,97,104,96,110,107,71,88,565,159,724,21.96132596685083
15802,330455705170373,74,106,151,139,143,128,96,110,741,206,947,21.752903907074973
15803,330455705170374,63,83,113,109,97,116,91,88,581,179,760,23.55263157894737
15804,330455705170375,63,95,136,124,109,114,84,95,641,179,820,21.829268292682926
15805,330455705170376,34,60,66,65,68,73,46,55,366,101,467,21.62740899357602
15806,330455705170377,47,73,99,82,91,108,81,104,500,185,685,27.00729927007299
15807,330455705170378,105,106,156,128,65,68,30,21,628,51,679,7.511045655375552
15808,330455705170379,73,76,82,100,78,78,78,83,487,161,648,24.84567901234568
15809,330455705170380,129,119,170,163,112,109,47,42,802,89,891,9.988776655443322
15810,330455705170381,53,58,89,98,95,77,71,56,470,127,597,21.273031825795645
15811,330455705170382,83,96,54,56,57,36,13,21,382,34,416,8.173076923076923
15812,330455705170383,172,192,162,147,109,89,46,29,871,75,946,7.928118393234672
15813,330455705170384,53,59,94,91,77,49,35,23,423,58,481,12.058212058212058
15814,330455705170385,69,77,104,82,70,83,38,38,485,76,561,13.547237076648841
15815,330455705170386,108,163,145,104,128,90,48,49,738,97,835,11.616766467065869
15816,330455705170387,98,96,103,74,65,41,17,13,477,30,507,5.9171597633136095
15817,330455705170388,110,136,84,122,95,54,38,22,601,60,661,9.07715582450832
15818,330455705170389,123,96,115,106,82,62,33,22,584,55,639,8.60719874804382
15819,330455705170390,70,127,126,134,119,118,68,88,694,156,850,18.352941176470587
15820,330455705170391,188,195,214,169,175,129,78,60,1070,138,1208,11.42384105960265
15821,330455705170392,97,131,139,116,128,133,69,67,744,136,880,15.454545454545455
15822,330455705170393,59,81,75,57,93,59,41,34,424,75,499,15.030060120240481
15823,330455705170394,78,100,113,89,104,129,69,69,613,138,751,18.37549933422104
15824,330455705170395,57,82,94,78,107,113,86,90,531,176,707,24.893917963224894
15825,330455705170396,69,88,108,110,94,70,59,41,539,100,639,15.64945226917058
15826,330455705170397,0,34,485,345,207,78,10,2,1149,12,1161,1.0335917312661498
15827,330455705170398,86,69,133,111,111,113,75,106,623,181,804,22.512437810945272
15828,330455705170399,32,37,76,71,38,65,55,25,319,80,399,20.050125313283207
15829,330455705170400,90,86,138,104,92,114,59,56,624,115,739,15.561569688768607
15830,330455705170401,43,47,51,43,36,20,8,8,240,16,256,6.25
15831,330455705170402,51,73,92,67,84,75,43,61,442,104,546,19.047619047619047
15832,330455705170403,124,151,146,145,153,130,64,68,849,132,981,13.45565749235474
15833,330455705170404,93,89,121,139,111,89,69,47,642,116,758,15.303430079155673
15834,330455705170405,47,67,35,45,25,25,6,4,244,10,254,3.937007874015748
15835,330455705170406,51,48,49,40,21,29,11,3,238,14,252,5.555555555555555
15836,330455705170407,49,63,79,65,63,73,48,45,392,93,485,19.175257731958762
15837,330455705170408,74,94,76,89,86,68,46,36,487,82,569,14.411247803163445
15838,330455705170409,81,96,114,118,96,108,60,90,613,150,763,19.65923984272608
15839,330455705170410,62,110,129,90,115,116,79,78,622,157,779,20.154043645699616
15840,330455705170411,80,91,112,110,121,113,73,69,627,142,769,18.46553966189857
15841,330455705170412,91,116,177,144,122,122,77,87,772,164,936,17.521367521367523
15842,330455705170413,60,80,147,88,106,97,53,54,578,107,685,15.620437956204379
15843,330455705170414,28,50,57,68,58,55,54,52,316,106,422,25.118483412322274
15844,330455705170415,29,67,79,67,68,65,42,47,375,89,464,19.18103448275862
15845,330455705170416,51,86,101,86,99,77,60,69,500,129,629,20.508744038155804
15846,330455705170417,69,89,121,129,125,126,78,103,659,181,840,21.547619047619047
15847,330455705170418,47,65,105,90,74,71,48,36,452,84,536,15.671641791044776
15848,330455705170419,31,50,79,70,50,87,53,54,367,107,474,22.573839662447256
15849,330455705170420,52,80,101,111,90,95,62,77,529,139,668,20.808383233532933
15850,330455705170421,45,100,155,93,110,97,58,75,600,133,733,18.144611186903138
15851,330455705170422,38,56,75,60,65,84,45,48,378,93,471,19.745222929936304
15852,330455705170423,77,98,131,125,119,111,91,66,661,157,818,19.193154034229828
15853,330455705170424,66,77,90,86,82,74,58,46,475,104,579,17.962003454231432
15854,330455705170425,96,137,201,162,138,110,73,69,844,142,986,14.401622718052739
15855,330455705170426,49,53,100,81,77,73,46,76,433,122,555,21.98198198198198
15856,330455705170427,75,83,112,108,105,114,88,73,597,161,758,21.240105540897098
15857,330455705170428,54,104,118,102,102,115,74,48,595,122,717,17.01534170153417
15858,330455705170429,102,116,132,112,112,127,73,76,701,149,850,17.529411764705884
15859,330455705170430,71,87,88,89,79,72,37,33,486,70,556,12.589928057553957
15860,330455705170431,103,136,154,139,131,135,81,79,798,160,958,16.701461377870565
15861,330455705170432,53,61,88,67,87,68,34,81,424,115,539,21.335807050092765
15862,330455705170433,87,105,154,132,135,139,86,106,752,192,944,20.338983050847457
15863,330455705170434,58,81,89,109,104,100,70,103,541,173,714,24.2296918767507
15864,330455705170435,66,72,105,85,102,102,67,83,532,150,682,21.994134897360702
15865,330455705170436,68,106,92,90,81,99,65,82,536,147,683,21.52269399707174
15866,330455705170437,49,63,44,107,146,74,32,22,483,54,537,10.05586592178771
15867,330455705170438,83,113,100,95,108,103,66,83,602,149,751,19.840213049267643
15868,330455705170439,118,129,179,181,175,80,79,34,862,113,975,11.58974358974359
15869,330455705170440,96,117,120,110,80,73,53,38,596,91,687,13.24599708879185
15870,330455705170441,118,155,142,138,164,101,55,42,818,97,915,10.601092896174864
15871,330455705170442,27,48,43,58,54,48,24,34,278,58,336,17.261904761904763
15872,330455705170443,4,3,4,2,4,4,2,4,21,6,27,22.22222222222222
15873,330455705170444,64,84,101,96,89,78,60,61,512,121,633,19.115323854660346
15874,330455705170445,79,97,110,95,93,84,39,36,558,75,633,11.848341232227488
15875,330455705170446,82,121,129,126,118,122,93,83,698,176,874,20.137299771167047
15876,330455705170447,147,199,223,223,195,129,74,40,1116,114,1230,9.268292682926829
15877,330455705170448,112,149,140,120,132,98,56,40,751,96,847,11.334120425029516
15878,330455705170449,93,115,154,134,113,117,71,79,726,150,876,17.123287671232877
15879,330455705170450,65,82,109,60,82,77,43,30,475,73,548,13.321167883211679
15880,330455705170451,31,43,61,49,47,52,30,24,283,54,337,16.023738872403563
15881,330455705170452,102,82,123,109,113,112,72,86,641,158,799,19.774718397997496
15882,330455705170453,49,56,73,61,90,98,57,75,427,132,559,23.613595706618963
15883,330455705170454,45,63,89,84,81,115,76,67,477,143,620,23.06451612903226
15884,330455705170455,38,49,70,68,59,76,54,57,360,111,471,23.56687898089172
15885,330455705170456,27,52,57,60,75,68,54,66,339,120,459,26.143790849673202
15886,330455705170457,50,64,89,90,83,92,66,39,468,105,573,18.32460732984293
15887,330455705170458,54,68,83,89,98,77,58,105,469,163,632,25.79113924050633
15888,330455705170459,24,51,70,51,56,45,26,40,297,66,363,18.181818181818183
15889,330455705170460,76,103,144,122,92,98,66,69,635,135,770,17.532467532467532
15890,330455705170461,59,81,115,83,88,71,37,47,497,84,581,14.457831325301205
15891,330455705170462,70,92,95,106,79,87,64,81,529,145,674,21.513353115727003
15892,330455705170463,106,102,116,116,118,117,105,105,675,210,885,23.728813559322035
15893,330455705170464,44,51,74,56,52,64,34,44,341,78,419,18.615751789976134
15894,330455705170465,71,93,107,97,89,104,69,71,561,140,701,19.971469329529246
15895,330455705170466,36,47,49,55,65,39,42,57,291,99,390,25.384615384615383
15896,330455705170467,56,87,85,67,110,109,73,82,514,155,669,23.168908819133033
15897,330455705170468,57,79,93,91,82,93,43,24,495,67,562,11.921708185053381
15898,330455705170469,20,9,12,19,16,13,8,10,89,18,107,16.822429906542055
15899,330455705170470,63,85,87,76,76,61,33,37,448,70,518,13.513513513513514
15900,330455705170471,149,167,171,153,108,85,45,30,833,75,908,8.259911894273127
15901,330455705170472,97,135,141,140,102,76,25,24,691,49,740,6.621621621621622
15902,330455705170473,170,266,227,220,176,123,55,32,1182,87,1269,6.855791962174941
15903,330455705170474,88,126,141,89,116,138,60,75,698,135,833,16.206482593037215
15904,330455705170475,84,119,145,152,126,128,99,83,754,182,936,19.444444444444443
15905,330455705170476,73,73,109,123,93,114,64,83,585,147,732,20.081967213114755
15906,330455705170477,72,96,108,100,149,116,78,140,641,218,859,25.378346915017463
15907,330455705170478,87,125,118,105,133,118,81,83,686,164,850,19.294117647058822
15908,330455705170479,89,90,71,77,53,37,35,8,417,43,460,9.347826086956522
15909,330455705170480,223,229,241,186,147,116,50,33,1142,83,1225,6.775510204081633
15910,330455705170481,65,100,114,127,116,149,89,105,671,194,865,22.427745664739884
15911,330455705170482,75,85,97,90,97,82,45,69,526,114,640,17.8125
15912,330455705170483,80,93,114,117,81,93,85,67,578,152,730,20.82191780821918
15913,330455705170484,81,111,141,135,145,134,100,89,747,189,936,20.192307692307693
15914,330455705170485,66,81,106,92,82,96,63,55,523,118,641,18.408736349453978
15915,330455705170486,55,68,114,101,87,98,62,87,523,149,672,22.172619047619047
15916,330455705170487,59,89,138,88,101,129,73,114,604,187,791,23.640960809102403
15917,330455705170488,77,120,121,139,135,149,82,120,741,202,943,21.420996818663838
15918,330455705170489,39,48,94,57,57,74,58,59,369,117,486,24.074074074074073
15919,330455705170490,69,79,116,82,94,115,88,88,555,176,731,24.076607387140903
15920,330455705170491,29,42,69,60,60,73,44,66,333,110,443,24.830699774266364
15921,330455705170492,37,54,67,78,61,67,57,55,364,112,476,23.529411764705884
15922,330455705170493,60,61,91,120,89,89,70,42,510,112,622,18.006430868167204
15923,330455705170494,76,92,127,112,136,116,69,60,659,129,788,16.370558375634516
15924,330455705170495,30,51,72,45,68,44,40,38,310,78,388,20.103092783505154
15925,330455705170496,81,76,102,91,102,112,65,85,564,150,714,21.008403361344538
15926,330455705170497,93,89,101,107,94,113,73,80,597,153,750,20.4
15927,330455705170498,28,41,62,43,48,37,25,27,259,52,311,16.720257234726688
15928,330455705170499,69,71,95,84,84,73,57,62,476,119,595,20.0
15929,330455705170500,60,84,86,97,110,98,58,70,535,128,663,19.306184012066364
15930,330455705170501,24,37,25,38,35,25,20,17,184,37,221,16.742081447963802
15931,330455705170502,64,93,180,142,98,119,80,66,696,146,842,17.339667458432302
15932,330455705170503,78,103,84,79,72,72,44,31,488,75,563,13.321492007104796
15933,330455705170504,67,94,79,54,48,54,16,13,396,29,425,6.823529411764706
15934,330455705170505,122,149,102,100,78,59,35,26,610,61,671,9.090909090909092
15935,330455705170506,125,198,185,176,191,150,92,91,1025,183,1208,15.149006622516556
15936,330455705170507,208,184,154,189,130,74,59,47,939,106,1045,10.14354066985646
15937,330455705170508,108,134,169,114,168,164,70,84,857,154,1011,15.2324431256182
15938,330455705170509,40,54,100,106,53,69,59,62,422,121,543,22.283609576427256
15939,330455705170510,22,23,37,22,22,23,18,16,149,34,183,18.579234972677597
15940,330455705170511,112,130,121,98,88,63,51,48,612,99,711,13.924050632911392
15941,330455705170512,134,153,167,175,120,121,43,46,870,89,959,9.280500521376434
15942,330455705170513,127,161,171,158,149,118,65,63,884,128,1012,12.648221343873518
15943,330455705170514,54,65,94,81,77,97,51,54,468,105,573,18.32460732984293
15944,330455705170515,60,111,99,107,114,109,105,99,600,204,804,25.37313432835821
15945,330455705170516,65,82,98,106,80,85,75,93,516,168,684,24.56140350877193
15946,330455705170517,56,84,113,93,112,89,58,106,547,164,711,23.066104078762308
15947,330455705170518,39,65,85,101,115,84,61,89,489,150,639,23.474178403755868
15948,330455705170519,44,53,74,69,84,81,47,63,405,110,515,21.359223300970875
15949,330455705170520,62,139,154,115,145,136,63,119,751,182,933,19.506966773847804
15950,330455705170521,65,96,134,94,117,77,69,94,583,163,746,21.84986595174263
15951,330455705170522,1,4,4,5,5,5,11,14,24,25,49,51.02040816326531
15952,330455705170523,81,96,100,110,101,108,74,88,596,162,758,21.37203166226913
15953,330455705170524,75,93,102,103,115,115,50,71,603,121,724,16.712707182320443
15954,330455705170525,88,120,119,121,148,143,83,115,739,198,937,21.13127001067236
15955,330455705170526,81,80,121,74,94,108,63,77,558,140,698,20.05730659025788
15956,330455705170527,148,157,132,189,103,53,15,9,782,24,806,2.977667493796526
15957,330455705170528,96,123,145,124,134,122,53,75,744,128,872,14.678899082568808
15958,330455705170529,49,80,85,67,93,94,44,76,468,120,588,20.408163265306122
15959,330455705170530,48,45,69,57,66,59,54,70,344,124,468,26.495726495726494
15960,330455705170531,59,80,97,84,88,96,69,90,504,159,663,23.981900452488688
15961,330455705170532,87,117,136,113,155,112,80,119,720,199,919,21.653971708378673
15962,330455705170533,14,26,37,14,34,25,13,21,150,34,184,18.47826086956522
15963,330455705170534,36,71,60,55,55,49,18,22,326,40,366,10.92896174863388
15964,330455705170535,37,73,78,102,93,69,26,40,452,66,518,12.741312741312742
15965,330455705170536,40,36,78,62,68,67,52,41,351,93,444,20.945945945945947
15966,330455705170537,19,21,41,33,43,50,15,27,207,42,249,16.867469879518072
15967,330455705170538,66,50,78,88,63,90,39,31,435,70,505,13.861386138613861
15968,330455705170539,64,71,112,101,83,96,67,58,527,125,652,19.171779141104295
15969,330455705170540,48,77,85,83,100,83,57,90,476,147,623,23.59550561797753
15970,330455705170541,7,8,13,5,9,9,6,6,51,12,63,19.047619047619047
15971,330455705170542,18,14,21,24,17,6,22,10,100,32,132,24.242424242424242
15972,330455705170543,10,7,27,14,13,19,14,18,90,32,122,26.229508196721312
15973,330455705170544,27,30,44,42,40,49,38,25,232,63,295,21.35593220338983
15974,330455705170545,102,119,108,117,87,59,36,25,592,61,653,9.341500765696784
15975,330455705170546,107,115,66,59,36,35,11,16,418,27,445,6.067415730337078
15976,330455705170547,140,166,131,111,88,51,30,17,687,47,734,6.4032697547683926
15977,330455705170548,40,47,71,70,45,59,33,54,332,87,419,20.763723150357997
15978,330455705170549,97,109,132,102,128,82,56,53,650,109,759,14.361001317523057
15979,330455705170550,30,40,24,38,26,19,18,13,177,31,208,14.903846153846153
15980,330455705170551,40,57,87,79,85,102,50,62,450,112,562,19.9288256227758
15981,330455705170552,22,51,75,56,63,69,39,61,336,100,436,22.93577981651376
15982,330455705170553,55,66,105,121,96,82,66,61,525,127,652,19.478527607361965
15983,330455705170554,47,60,101,72,80,104,41,59,464,100,564,17.73049645390071
15984,330455705170555,33,46,66,76,44,87,40,43,352,83,435,19.080459770114942
15985,330455705170556,27,43,45,62,63,51,29,60,291,89,380,23.42105263157895
15986,330455705170557,55,61,92,70,81,85,43,53,444,96,540,17.77777777777778
15987,330455705170558,37,46,66,78,51,44,30,42,322,72,394,18.274111675126903
15988,330455705170559,75,79,80,92,69,58,27,26,453,53,506,10.474308300395258
15989,330455705170560,41,37,77,60,70,74,64,81,359,145,504,28.76984126984127
15990,330455705170561,71,98,76,88,120,86,53,55,539,108,647,16.69242658423493
15991,330455705170562,34,43,74,58,62,63,44,30,334,74,408,18.137254901960784
15992,330455705170563,15,20,44,28,42,45,36,27,194,63,257,24.513618677042803
15993,330455705170564,4,12,24,16,15,19,21,41,90,62,152,40.78947368421053
15994,330455705170565,18,30,45,30,39,37,22,21,199,43,242,17.768595041322314
15995,330455705170566,39,59,79,115,91,78,67,72,461,139,600,23.166666666666668
15996,330455705170567,46,56,64,99,76,71,34,40,412,74,486,15.22633744855967
15997,330455705170568,53,73,78,68,80,89,63,81,441,144,585,24.615384615384617
15998,330455705170569,47,69,103,89,101,123,133,160,532,293,825,35.515151515151516
15999,330455705170570,38,44,53,69,65,64,47,58,333,105,438,23.972602739726028
16000,330455705170571,34,50,78,61,65,96,57,103,384,160,544,29.41176470588235
16001,330455705170572,65,87,128,135,95,148,95,143,658,238,896,26.5625
16002,330455705170573,28,45,58,45,56,58,43,46,290,89,379,23.482849604221634
16003,330455705170574,65,85,107,90,110,88,50,49,545,99,644,15.372670807453416
16004,330455705170575,27,67,108,69,85,113,65,56,469,121,590,20.508474576271187
16005,330455705170576,58,76,99,95,83,98,73,77,509,150,659,22.76176024279211
16006,330455705170577,35,44,56,67,52,79,46,43,333,89,422,21.09004739336493
16007,330455705170578,92,114,93,154,155,82,33,48,690,81,771,10.505836575875486
16008,330455705170579,22,41,58,43,83,75,41,63,322,104,426,24.413145539906104
16009,330455705170580,79,70,105,169,109,83,48,68,615,116,731,15.868673050615595
16010,330455705170581,20,50,83,59,70,95,77,65,377,142,519,27.360308285163775
16011,330455705170582,57,75,116,64,125,122,50,55,559,105,664,15.813253012048193
16012,330455705170583,17,31,38,38,40,31,22,32,195,54,249,21.686746987951807
16013,330455705170584,36,43,73,69,68,76,44,56,365,100,465,21.50537634408602
16014,330455705170585,25,46,49,88,61,55,50,45,324,95,419,22.673031026252982
16015,330455705170586,22,28,67,47,56,76,65,75,296,140,436,32.11009174311926
16016,330455705170587,28,42,57,36,54,44,36,48,261,84,345,24.347826086956523
16017,330455705170588,60,61,86,108,94,77,62,60,486,122,608,20.06578947368421
16018,330455705170589,20,26,33,28,31,47,39,30,185,69,254,27.165354330708663
16019,330455705170590,73,60,107,93,91,97,66,65,521,131,652,20.0920245398773
16020,330455705170591,51,73,75,77,69,63,42,33,408,75,483,15.527950310559007
16021,330455705170592,73,66,120,124,105,94,72,71,582,143,725,19.724137931034484
16022,330455705170593,69,75,115,89,101,95,57,53,544,110,654,16.819571865443425
16023,330455705170594,30,43,61,83,82,78,71,76,377,147,524,28.053435114503817
16024,330455705170595,25,24,38,36,26,25,24,21,174,45,219,20.54794520547945
16025,330455705170596,17,18,28,23,29,41,26,43,156,69,225,30.666666666666668
16026,330455705170597,50,70,82,79,77,101,46,64,459,110,569,19.332161687170476
16027,330455705170598,26,61,94,79,80,56,45,31,396,76,472,16.10169491525424
16028,330455705170599,44,57,84,75,73,52,52,58,385,110,495,22.22222222222222
16029,330455705170600,39,55,72,77,73,66,63,79,382,142,524,27.099236641221374
16030,330455705170605,46,51,99,95,78,70,53,50,439,103,542,19.00369003690037
16031,330455705170606,30,49,64,60,55,83,45,54,341,99,440,22.5
16032,330455705170607,103,121,110,124,83,95,51,40,636,91,727,12.5171939477304
16033,330455705170608,101,57,84,197,99,34,19,8,572,27,599,4.507512520868113
16034,330455705170609,84,138,151,143,149,127,81,60,792,141,933,15.112540192926046
16035,330455705170610,54,93,92,87,99,79,56,50,504,106,610,17.37704918032787
16036,330455705170611,18,39,65,43,37,53,30,39,255,69,324,21.296296296296298
16037,330455705170612,52,41,56,63,52,48,44,34,312,78,390,20.0
16038,330455705170613,53,104,52,97,146,68,16,13,520,29,549,5.2823315118397085
16039,330455705170614,53,79,72,94,75,75,66,52,448,118,566,20.848056537102472
16040,330455705170615,96,73,114,149,104,73,87,57,609,144,753,19.12350597609562
16041,330455705170616,36,47,45,56,59,63,46,55,306,101,407,24.815724815724817
16042,330455705170617,38,49,89,65,55,67,44,45,363,89,452,19.690265486725664
16043,330455705170618,38,42,66,57,68,61,41,54,332,95,427,22.24824355971897
16044,330455705170619,52,69,82,78,96,76,65,63,453,128,581,22.030981067125644
16045,330455705170620,51,54,86,76,72,81,67,60,420,127,547,23.217550274223036
16046,330455705170621,62,68,91,105,91,75,59,73,492,132,624,21.153846153846153
16047,330455705170622,52,49,83,62,50,71,64,59,367,123,490,25.102040816326532
16048,330455705170623,44,59,82,92,88,107,71,60,472,131,603,21.724709784411278
16049,330455705170624,13,31,26,20,18,25,15,17,133,32,165,19.393939393939394
16050,330455705170625,47,55,55,50,45,37,27,27,289,54,343,15.743440233236152
16051,330455705170626,83,110,122,99,86,94,41,39,594,80,674,11.869436201780415
16052,330455705170628,4,4,10,12,8,7,3,0,45,3,48,6.25
16054,330455705170630,4,3,6,19,4,1,2,2,37,4,41,9.75609756097561
16055,330455705170633,24,16,21,27,17,15,13,4,120,17,137,12.408759124087592
16056,330455705170634,79,122,125,100,93,73,25,22,592,47,639,7.355242566510172
16057,330455705170635,27,43,46,39,43,45,29,43,243,72,315,22.857142857142858
16058,330455705170644,86,101,88,84,77,56,36,32,492,68,560,12.142857142857142
16059,330455705170645,143,146,140,126,99,79,53,45,733,98,831,11.793020457280385
16060,330455705170646,66,103,127,114,109,97,67,79,616,146,762,19.16010498687664
16061,330455705170647,64,87,111,85,91,109,53,65,547,118,665,17.74436090225564
16062,330455705170648,111,90,79,72,36,22,12,8,410,20,430,4.651162790697675
16063,330455705170649,84,96,65,65,44,24,21,7,378,28,406,6.896551724137931
16064,330455705170650,146,167,137,103,92,39,23,15,684,38,722,5.2631578947368425
16065,330455705190001,51,57,95,58,66,64,26,40,391,66,457,14.442013129102845
16066,330455705190002,56,80,96,79,95,84,44,65,490,109,599,18.196994991652755
16067,330455705190003,34,56,71,58,54,56,46,65,329,111,440,25.227272727272727
16068,330455705190004,50,62,96,101,83,98,67,86,490,153,643,23.79471228615863
16069,330455705190005,49,105,104,109,115,91,70,78,573,148,721,20.527045769764218
16070,330455705190006,53,57,103,87,82,107,80,85,489,165,654,25.229357798165136
16071,330455705190007,39,73,65,80,77,93,55,77,427,132,559,23.613595706618963
16072,330455705190008,40,85,97,92,91,105,79,83,510,162,672,24.107142857142858
16073,330455705190009,51,33,76,57,70,73,53,76,360,129,489,26.380368098159508
16074,330455705190010,65,85,90,109,111,94,79,74,554,153,707,21.64073550212164
16075,330455705190011,42,77,98,86,101,129,75,120,533,195,728,26.785714285714285
16076,330455705190012,55,80,103,89,110,118,67,87,555,154,709,21.720733427362482
16077,330455705190013,109,141,152,143,155,136,56,86,836,142,978,14.519427402862986
16078,330455705190014,69,133,126,102,164,160,55,100,754,155,909,17.051705170517053
16079,330455705190015,49,60,68,62,52,76,20,23,367,43,410,10.487804878048781
16080,330455705190016,45,81,79,73,89,106,36,48,473,84,557,15.080789946140037
16081,330455705190017,149,198,199,148,199,221,66,79,1114,145,1259,11.517077045274027
16082,330455705190018,97,157,157,118,180,151,52,87,860,139,999,13.913913913913914
16083,330455705190019,104,157,131,104,146,137,46,83,779,129,908,14.20704845814978
16084,330455705190020,82,117,135,90,126,120,43,61,670,104,774,13.436692506459949
16085,330455705190021,184,228,260,144,153,78,34,18,1047,52,1099,4.731574158325751
16086,330455705190022,132,185,217,183,187,151,76,78,1055,154,1209,12.737799834574028
16087,330455705190023,85,122,108,125,104,104,53,59,648,112,760,14.736842105263158
16088,330455705190024,87,108,129,138,124,135,72,81,721,153,874,17.505720823798626
16089,330455705190025,67,85,106,102,106,111,65,63,577,128,705,18.156028368794328
16090,330455705190026,80,129,127,122,147,110,80,87,715,167,882,18.934240362811792
16091,330455705190027,38,51,111,92,83,84,74,60,459,134,593,22.596964586846543
16092,330455705190028,54,72,72,113,132,89,48,56,532,104,636,16.352201257861637
16093,330455705190029,71,66,88,84,81,77,65,50,467,115,582,19.759450171821307
16094,330455705190030,55,70,86,79,62,68,67,43,420,110,530,20.754716981132077
16095,330455705190031,54,91,66,79,78,75,41,49,443,90,533,16.885553470919323
16096,330455705190032,83,114,101,86,73,73,40,25,530,65,595,10.92436974789916
16097,330455705190033,108,120,126,140,106,99,71,53,699,124,823,15.066828675577156
16098,330455705190034,77,95,89,103,82,59,66,39,505,105,610,17.21311475409836
16099,330455705190035,118,139,158,116,131,100,57,62,762,119,881,13.507377979568671
16100,330455705190036,134,119,116,108,84,81,50,30,642,80,722,11.0803324099723
16101,330455705190037,127,147,150,119,107,79,48,24,729,72,801,8.98876404494382
16102,330455705190038,125,234,222,198,118,72,47,29,969,76,1045,7.2727272727272725
16103,330455705190039,135,178,168,126,111,51,38,18,769,56,825,6.787878787878788
16104,330455705190040,107,81,63,66,37,33,11,4,387,15,402,3.7313432835820897
16105,330455705190041,12,13,11,11,9,10,6,3,66,9,75,12.0
16106,330455705190042,116,149,91,84,90,52,29,18,582,47,629,7.472178060413355
16107,330455705190043,55,72,43,47,39,24,20,5,280,25,305,8.19672131147541
16108,330455705190044,132,173,124,142,84,48,23,23,703,46,749,6.141522029372497
16109,330455705190045,65,64,52,47,30,18,10,8,276,18,294,6.122448979591836
16110,330455705190046,189,239,128,155,93,39,7,20,843,27,870,3.103448275862069
16111,330455705190047,71,85,77,48,38,41,16,20,360,36,396,9.090909090909092
16112,330455705190048,261,275,242,198,169,109,66,29,1254,95,1349,7.042253521126761
16113,330455705190049,94,111,111,106,109,96,52,48,627,100,727,13.75515818431912
16114,330455705190050,49,53,83,53,80,68,44,38,386,82,468,17.521367521367523
16115,330455705190051,87,87,93,80,93,76,61,50,516,111,627,17.70334928229665
16116,330455705190052,52,67,66,70,69,54,32,29,378,61,439,13.895216400911162
16117,330455705190053,62,73,83,75,74,75,42,61,442,103,545,18.89908256880734
16118,330455705190054,64,82,99,93,84,116,59,74,538,133,671,19.821162444113263
16119,330455705190055,61,77,104,88,84,111,59,72,525,131,656,19.96951219512195
16120,330455705190056,60,79,113,113,99,120,84,62,584,146,730,20.0
16121,330455705190057,47,83,108,71,88,104,53,55,501,108,609,17.733990147783253
16122,330455705190058,70,124,126,120,136,110,70,78,686,148,834,17.74580335731415
16123,330455705190059,89,98,95,110,101,76,80,60,569,140,709,19.746121297602258
16124,330455705190060,110,116,120,126,113,97,67,65,682,132,814,16.216216216216218
16125,330455705190061,55,51,99,103,85,104,76,66,497,142,639,22.22222222222222
16126,330455705190062,55,64,94,78,105,99,93,75,495,168,663,25.339366515837103
16127,330455705190063,56,48,96,86,85,90,66,48,461,114,575,19.82608695652174
16128,330455705190064,40,36,62,58,68,50,56,37,314,93,407,22.85012285012285
16129,330455705190065,43,68,85,86,81,83,56,61,446,117,563,20.78152753108348
16130,330455705190066,48,74,96,99,95,117,69,75,529,144,673,21.39673105497771
16131,330455705190067,42,63,96,80,83,75,68,54,439,122,561,21.74688057040998
16132,330455705190068,58,50,74,79,66,68,64,40,395,104,499,20.841683366733466
16133,330455705190069,52,74,85,104,82,80,57,50,477,107,584,18.32191780821918
16134,330455705190070,57,83,112,89,110,108,71,68,559,139,698,19.91404011461318
16135,330455705190071,56,80,118,88,94,131,84,67,567,151,718,21.030640668523677
16136,330455705190072,66,71,98,96,103,104,61,65,538,126,664,18.97590361445783
16137,330455705190073,42,58,110,84,74,132,72,61,500,133,633,21.011058451816744
16138,330455705190074,41,63,94,84,81,89,45,52,452,97,549,17.66848816029144
16139,330455705190075,40,72,68,80,77,98,61,59,435,120,555,21.62162162162162
16140,330455705190076,63,65,117,88,90,132,95,86,555,181,736,24.592391304347824
16141,330455705190077,63,77,121,105,118,111,106,74,595,180,775,23.225806451612904
16142,330455705190078,37,59,71,65,79,76,43,51,387,94,481,19.542619542619544
16143,330455705190079,81,69,96,125,124,98,93,84,593,177,770,22.98701298701299
16144,330455705190080,40,45,66,66,63,91,57,34,371,91,462,19.696969696969695
16145,330455705190081,44,55,84,92,87,87,67,74,449,141,590,23.89830508474576
16146,330455705190082,47,64,86,91,96,90,75,82,474,157,631,24.881141045958795
16147,330455705190083,43,57,70,78,85,88,67,60,421,127,548,23.175182481751825
16148,330455705190084,60,78,110,108,92,108,62,82,556,144,700,20.571428571428573
16149,330455705190085,75,111,143,110,170,148,68,80,757,148,905,16.353591160220994
16150,330455705190086,39,51,76,80,71,74,69,62,391,131,522,25.095785440613028
16151,330455705190087,31,51,65,71,80,61,49,68,359,117,476,24.57983193277311
16152,330455705190088,51,65,75,74,95,76,59,64,436,123,559,22.003577817531305
16153,330455705190089,95,93,140,155,122,124,71,78,729,149,878,16.970387243735765
16154,330455705190090,36,37,83,84,83,80,56,61,403,117,520,22.5
16155,330455705190091,55,54,61,89,78,96,60,64,433,124,557,22.262118491921004
16156,330455705190092,67,74,123,108,95,116,91,80,583,171,754,22.679045092838198
16157,330455705190093,58,74,91,87,93,67,70,61,470,131,601,21.79700499168053
16158,330455705190094,52,64,100,85,88,89,62,61,478,123,601,20.465890183028286
16159,330455705190095,77,81,118,101,115,96,69,73,588,142,730,19.45205479452055
16160,330455705190096,34,55,73,74,71,91,86,61,398,147,545,26.972477064220183
16161,330455705190097,41,68,93,95,105,108,64,67,510,131,641,20.43681747269891
16162,330455705190098,32,38,49,33,35,64,39,33,251,72,323,22.291021671826627
16163,330455705190099,39,53,82,68,79,98,76,70,419,146,565,25.84070796460177
16164,330455705190100,44,92,110,89,125,115,83,93,575,176,751,23.435419440745672
16165,330455705190101,70,111,152,105,145,143,88,103,726,191,917,20.828789531079607
16166,330455705190102,51,63,93,88,81,100,67,70,476,137,613,22.34910277324633
16167,330455705190103,62,124,112,102,154,142,104,117,696,221,917,24.10032715376227
16168,330455705190104,48,56,82,61,72,102,36,63,421,99,520,19.03846153846154
16169,330455705190105,57,77,91,89,94,90,51,64,498,115,613,18.760195758564436
16170,330455705190106,62,68,95,80,77,81,49,54,463,103,566,18.197879858657245
16171,330455705190107,49,73,87,87,78,106,57,63,480,120,600,20.0
16172,330455705190108,58,80,79,82,112,94,54,59,505,113,618,18.284789644012946
16173,330455705190109,51,80,75,88,92,106,65,70,492,135,627,21.5311004784689
16174,330455705190110,44,96,76,85,96,74,49,80,471,129,600,21.5
16175,330455705190111,57,81,110,111,100,124,67,64,583,131,714,18.34733893557423
16176,330455705190112,59,84,92,86,104,110,68,73,535,141,676,20.857988165680474
16177,330455705190113,60,71,113,99,86,107,52,53,536,105,641,16.380655226209047
16178,330455705190114,76,105,141,110,129,121,87,100,682,187,869,21.518987341772153
16179,330455705190115,44,95,81,63,98,69,49,35,450,84,534,15.730337078651685
16180,330455705190116,73,86,107,109,93,116,63,63,584,126,710,17.746478873239436
16181,330455705190117,65,83,89,89,67,75,30,36,468,66,534,12.359550561797754
16182,330455705190118,74,94,132,110,118,132,70,84,660,154,814,18.91891891891892
16183,330455705190119,53,86,88,95,98,99,44,49,519,93,612,15.196078431372548
16184,330455705190120,47,66,58,62,94,57,57,62,384,119,503,23.658051689860834
16185,330455705190121,65,72,129,134,93,135,76,54,628,130,758,17.150395778364118
16186,330455705190122,45,78,107,98,97,79,73,58,504,131,635,20.62992125984252
16187,330455705190123,55,65,82,98,104,63,56,56,467,112,579,19.34369602763385
16188,330455705190124,84,102,117,128,84,110,77,80,625,157,782,20.076726342710998
16189,330455705190125,93,121,147,130,119,117,71,77,727,148,875,16.914285714285715
16190,330455705190126,72,76,101,103,92,92,60,54,536,114,650,17.53846153846154
16191,330455705190127,57,62,76,100,67,88,61,61,450,122,572,21.32867132867133
16192,330455705190128,85,132,142,135,131,132,91,91,757,182,939,19.382321618743344
16193,330455705190129,92,93,117,112,115,111,57,61,640,118,758,15.567282321899736
16194,330455705190130,66,104,113,95,114,107,58,71,599,129,728,17.71978021978022
16195,330455705190131,54,79,115,96,97,107,62,65,548,127,675,18.814814814814813
16196,330455705190132,44,70,75,72,82,78,58,43,421,101,522,19.34865900383142
16197,330455705190133,69,70,94,94,78,72,62,61,477,123,600,20.5
16198,330455705190134,89,132,140,99,119,140,66,77,719,143,862,16.589327146171694
16199,330455705190135,90,142,138,153,151,121,81,83,795,164,959,17.101147028154326
16200,330455705190136,69,93,124,113,83,125,72,89,607,161,768,20.963541666666668
16201,330455705190137,66,82,140,107,92,141,79,42,628,121,749,16.15487316421896
16202,330455705190138,55,75,128,95,72,109,52,25,534,77,611,12.602291325695582
16203,330455705190139,75,88,161,123,110,175,94,75,732,169,901,18.756936736958934
16204,330455705190140,63,113,91,80,116,57,56,51,520,107,627,17.065390749601274
16205,330455705190141,96,147,159,163,155,155,112,134,875,246,1121,21.944692239072257
16206,330455705190142,73,100,129,122,114,126,111,88,664,199,863,23.05909617612978
16207,330455705190143,6,6,14,14,14,6,7,10,60,17,77,22.07792207792208
16208,330455705190144,51,47,80,66,68,69,40,65,381,105,486,21.604938271604937
16209,330455705190145,78,74,116,147,107,110,83,77,632,160,792,20.2020202020202
16210,330455705190146,48,86,79,82,81,73,71,67,449,138,587,23.509369676320272
16211,330455705190147,82,99,116,129,111,102,115,55,639,170,809,21.013597033374538
16212,330455705190148,65,84,96,95,89,104,87,58,533,145,678,21.386430678466077
16213,330455705190149,49,81,77,67,110,64,49,81,448,130,578,22.491349480968857
16214,330455705190150,56,84,88,87,91,86,66,73,492,139,631,22.02852614896989
16215,330455705190151,86,90,145,122,90,151,71,64,684,135,819,16.483516483516482
16216,330455705190152,117,155,217,175,181,166,125,78,1011,203,1214,16.72158154859967
16217,330455705190153,69,92,130,121,104,154,99,72,670,171,841,20.33293697978597
16218,330455705190154,48,43,75,87,63,62,73,62,378,135,513,26.31578947368421
16219,330455705190155,61,102,90,85,76,103,68,70,517,138,655,21.068702290076335
16220,330455705190156,42,41,54,62,40,51,54,42,290,96,386,24.870466321243523
16221,330455705190157,48,56,68,58,57,63,44,55,350,99,449,22.048997772828507
16222,330455705190158,39,79,84,76,63,105,51,58,446,109,555,19.63963963963964
16223,330455705190159,39,53,66,49,63,64,43,44,334,87,421,20.665083135391924
16224,330455705190160,111,135,145,153,119,129,83,95,792,178,970,18.350515463917525
16225,330455705190161,96,110,116,131,109,144,105,86,706,191,897,21.29319955406912
16226,330455705190162,54,87,88,90,66,101,73,61,486,134,620,21.612903225806452
16227,330455705190163,87,102,107,112,104,112,65,85,624,150,774,19.37984496124031
16228,330455705190164,105,111,142,127,128,154,93,89,767,182,949,19.17808219178082
16229,330455705190165,34,45,55,60,71,60,52,56,325,108,433,24.942263279445726
16230,330455705190166,50,48,92,82,68,66,55,35,406,90,496,18.14516129032258
16231,330455705190167,53,61,98,87,84,88,50,36,471,86,557,15.439856373429084
16232,330455705190168,35,39,71,69,56,62,48,39,332,87,419,20.763723150357997
16233,330455705190169,45,54,74,75,63,58,55,52,369,107,476,22.478991596638654
16234,330455705190170,48,62,77,81,59,62,56,55,389,111,500,22.2
16235,330455705190171,51,70,94,89,85,81,84,75,470,159,629,25.278219395866454
16236,330455705190172,51,51,68,76,47,60,45,42,353,87,440,19.772727272727273
16237,330455705190173,44,47,81,94,64,66,74,54,396,128,524,24.427480916030536
16238,330455705190174,22,43,41,52,39,46,41,47,243,88,331,26.58610271903323
16239,330455705190175,36,49,67,70,64,79,54,64,365,118,483,24.43064182194617
16240,330455705190176,37,63,58,78,64,59,61,48,359,109,468,23.29059829059829
16241,330455705190177,63,69,121,114,81,83,69,43,531,112,643,17.418351477449455
16242,330455705190178,43,71,101,90,72,80,81,47,457,128,585,21.88034188034188
16243,330455705190179,42,79,87,89,101,89,78,49,487,127,614,20.684039087947884
16244,330455705190180,54,60,92,84,96,77,66,48,463,114,577,19.75736568457539
16245,330455705190181,56,61,74,100,79,104,94,54,474,148,622,23.794212218649516
16246,330455705190182,74,136,129,124,147,150,73,74,760,147,907,16.207276736493935
16247,330455705190183,77,128,124,121,137,136,56,69,723,125,848,14.74056603773585
16248,330455705190184,101,121,175,132,146,162,87,152,837,239,1076,22.21189591078067
16249,330455705190185,60,122,107,94,113,101,55,58,597,113,710,15.915492957746478
16250,330455705190186,74,122,152,98,133,169,98,164,748,262,1010,25.940594059405942
16251,330455705190187,64,75,97,129,93,75,84,44,533,128,661,19.36459909228442
16252,330455705190188,66,112,166,160,144,148,107,81,796,188,984,19.10569105691057
16253,330455705190189,61,41,66,89,72,57,39,26,386,65,451,14.412416851441241
16254,330455705190190,57,64,101,71,81,86,69,53,460,122,582,20.962199312714777
16255,330455705190191,48,67,88,111,73,83,69,44,470,113,583,19.382504288164665
16256,330455705190192,61,73,103,123,112,114,103,101,586,204,790,25.82278481012658
16257,330455705190193,45,59,99,89,87,92,63,54,471,117,588,19.897959183673468
16258,330455705190194,74,93,114,114,101,123,60,73,619,133,752,17.68617021276596
16259,330455705190195,48,104,174,111,128,162,90,75,727,165,892,18.49775784753363
16260,330455705190196,42,77,100,94,77,94,64,62,484,126,610,20.65573770491803
16261,330455705190197,45,78,102,105,82,108,77,77,520,154,674,22.8486646884273
16262,330455705190198,78,113,146,110,135,116,87,75,698,162,860,18.837209302325583
16263,330455705190199,71,93,109,105,130,117,86,83,625,169,794,21.28463476070529
16264,330455705190200,60,90,123,95,117,140,96,120,625,216,841,25.68370986920333
16265,330455705190201,38,58,66,53,54,64,36,38,333,74,407,18.181818181818183
16266,330455705190202,51,75,83,90,88,82,59,59,469,118,587,20.10221465076661
16267,330455705190203,63,90,116,96,104,106,58,51,575,109,684,15.935672514619883
16268,330455705190204,53,63,107,95,89,87,47,46,494,93,587,15.843270868824531
16269,330455705190205,70,97,113,124,108,94,74,34,606,108,714,15.126050420168067
16270,330455705190206,57,86,72,92,89,70,42,48,466,90,556,16.18705035971223
16271,330455705190207,99,129,149,163,130,131,83,51,801,134,935,14.331550802139038
16272,330455705190208,100,114,145,133,152,141,82,65,785,147,932,15.772532188841202
16273,330455705190209,66,70,109,85,95,80,94,67,505,161,666,24.174174174174173
16274,330455705190210,33,22,47,51,42,42,28,23,237,51,288,17.708333333333332
16275,330455705190211,65,60,80,71,113,46,27,29,435,56,491,11.405295315682281
16276,330455705190212,83,112,106,105,171,76,51,26,653,77,730,10.547945205479452
16277,330455705190213,52,69,91,79,83,97,60,64,471,124,595,20.840336134453782
16278,330455705190214,45,69,70,58,71,54,35,23,367,58,425,13.647058823529411
16279,330455705190215,84,126,135,109,149,117,71,84,720,155,875,17.714285714285715
16280,330455705190216,127,141,142,123,113,85,93,56,731,149,880,16.931818181818183
16281,330455705190217,74,99,78,91,71,66,59,51,479,110,589,18.67572156196944
16282,330455705190218,76,97,115,87,124,92,63,48,591,111,702,15.811965811965813
16283,330455705190219,40,57,61,30,38,23,9,5,249,14,263,5.32319391634981
16284,330455705190220,37,50,50,57,49,46,55,52,289,107,396,27.02020202020202
16285,330455705190221,48,82,86,59,80,58,31,25,413,56,469,11.940298507462687
16286,330455705190222,196,186,192,174,113,131,50,37,992,87,1079,8.063021316033364
16287,330455705190223,98,109,129,99,94,70,40,36,599,76,675,11.25925925925926
16288,330455705190224,147,130,156,114,89,90,36,20,726,56,782,7.161125319693094
16289,330455705190225,85,102,130,104,114,96,65,57,631,122,753,16.201859229747676
16290,330455705190226,60,65,77,93,81,69,55,69,445,124,569,21.79261862917399
16291,330455705190227,62,70,76,96,101,84,79,55,489,134,623,21.508828250401283
16292,330455705190228,42,65,74,60,87,61,55,57,389,112,501,22.355289421157686
16293,330455705190229,146,155,174,217,180,180,65,53,1052,118,1170,10.085470085470085
16294,330455705190230,57,66,115,73,72,76,54,40,459,94,553,16.998191681735985
16295,330455705190231,93,92,124,125,109,131,76,99,674,175,849,20.61248527679623
16296,330455705190232,67,80,103,91,89,86,50,74,516,124,640,19.375
16297,330455705190233,55,68,97,71,98,99,55,82,488,137,625,21.92
16298,330455705190234,101,107,123,113,106,94,73,91,644,164,808,20.297029702970296
16299,330455705190235,81,97,102,105,88,74,47,65,547,112,659,16.99544764795144
16300,330455705190236,55,75,116,87,102,109,59,67,544,126,670,18.80597014925373
16301,330455705190237,104,149,115,146,153,103,82,85,770,167,937,17.822838847385274
16302,330455705190238,51,64,80,92,66,67,66,37,420,103,523,19.694072657743785
16303,330455705190239,55,78,95,93,81,95,54,62,497,116,613,18.92332789559543
16304,330455705190240,113,160,158,152,119,123,78,59,825,137,962,14.241164241164242
16305,330455705190241,67,82,83,86,66,88,55,42,472,97,569,17.047451669595784
16306,330455705190242,89,83,94,77,84,72,51,31,499,82,581,14.113597246127366
16307,330455705190243,81,86,52,51,24,46,8,4,340,12,352,3.409090909090909
16308,330455705190244,59,68,95,73,75,80,61,54,450,115,565,20.353982300884955
16309,330455705190245,68,85,96,96,99,98,80,59,542,139,681,20.411160058737153
16310,330455705190246,83,132,93,127,100,102,64,66,637,130,767,16.949152542372882
16311,330455705190247,35,57,73,69,72,69,58,40,375,98,473,20.718816067653275
16312,330455705190248,89,137,126,114,122,99,63,46,687,109,796,13.693467336683417
16313,330455705190249,90,124,132,115,134,120,88,76,715,164,879,18.657565415244598
16314,330455705190250,77,133,164,121,126,119,83,66,740,149,889,16.76040494938133
16315,330455705190251,119,177,167,150,157,142,96,75,912,171,1083,15.789473684210526
16316,330455705190252,58,73,65,122,69,73,48,38,460,86,546,15.750915750915752
16317,330455705190253,76,103,157,135,102,133,86,95,706,181,887,20.405862457722662
16318,330455705190254,44,57,71,50,45,58,31,27,325,58,383,15.143603133159269
16319,330455705190255,34,47,55,33,53,50,28,22,272,50,322,15.527950310559007
16320,330455705190256,59,63,72,59,30,40,18,11,323,29,352,8.238636363636363
16321,330455705190257,73,85,107,93,91,106,67,58,555,125,680,18.38235294117647
16322,330455705190258,60,73,94,83,96,69,43,45,475,88,563,15.630550621669627
16323,330455705190259,66,71,101,74,84,88,53,53,484,106,590,17.966101694915253
16324,330455705190260,82,99,124,119,104,120,76,83,648,159,807,19.702602230483272
16325,330455705190261,61,71,91,98,88,91,78,59,500,137,637,21.50706436420722
16326,330455705190262,119,105,130,151,103,94,64,56,702,120,822,14.598540145985401
16327,330455705190263,69,73,103,66,81,68,61,56,460,117,577,20.27729636048527
16328,330455705190264,84,121,107,98,101,104,50,46,615,96,711,13.50210970464135
16329,330455705190265,111,169,162,151,125,136,77,67,854,144,998,14.428857715430862
16330,330455705190266,95,107,141,136,135,93,49,43,707,92,799,11.514392991239049
16331,330455705190267,79,93,131,126,115,86,69,63,630,132,762,17.322834645669293
16332,330455705190268,114,135,140,140,131,108,65,63,768,128,896,14.285714285714286
16333,330455705190269,147,141,143,152,165,102,68,51,850,119,969,12.280701754385966
16334,330455705190270,127,116,116,90,80,61,48,19,590,67,657,10.197869101978691
16335,330455705190271,12,22,25,26,14,24,10,9,123,19,142,13.380281690140846
16336,330455705190272,58,59,43,36,42,20,10,17,258,27,285,9.473684210526315
16337,330455705190273,44,67,52,54,36,34,17,11,287,28,315,8.88888888888889
16338,330455705190274,24,18,28,14,11,11,4,0,106,4,110,3.6363636363636362
16339,330455705190275,125,156,159,134,121,138,72,61,833,133,966,13.768115942028986
16340,330455705190276,162,186,145,136,116,80,61,34,825,95,920,10.326086956521738
16341,330455705190277,41,42,51,61,54,47,51,40,296,91,387,23.51421188630491
16342,330455705190278,219,263,256,219,301,158,74,29,1416,103,1519,6.780776826859777
16343,330455705190279,214,233,253,190,182,106,62,30,1178,92,1270,7.244094488188976
16344,330455705190280,287,269,298,233,165,118,66,48,1370,114,1484,7.681940700808625
16345,330455705190281,76,129,113,80,98,76,20,24,572,44,616,7.142857142857143
16346,330455705190282,108,106,126,116,66,58,38,15,580,53,633,8.372827804107425
16347,330455705190283,97,150,152,135,132,85,40,36,751,76,827,9.189842805320435
16348,330455705190284,74,92,85,128,63,61,37,26,503,63,566,11.130742049469964
16349,330455705190285,172,166,140,137,116,95,36,27,826,63,889,7.086614173228346
16350,330455705190286,139,178,203,203,113,95,58,13,931,71,1002,7.0858283433133735
16351,330455705190287,230,204,206,184,151,82,66,25,1057,91,1148,7.926829268292683
16352,330455705190288,99,91,102,89,69,58,33,28,508,61,569,10.720562390158172
16353,330455705190289,111,147,141,94,117,85,26,23,695,49,744,6.586021505376344
16354,330455705190290,99,125,124,88,106,40,17,12,582,29,611,4.746317512274959
16355,330455705190292,77,55,61,138,77,40,14,8,448,22,470,4.680851063829787
16356,330455705190293,65,92,88,105,83,70,68,53,503,121,624,19.391025641025642
16357,330455705190294,40,58,58,66,56,54,43,54,332,97,429,22.61072261072261
16358,330455705190295,30,42,59,46,42,58,26,32,277,58,335,17.313432835820894
16359,330455705190296,48,48,103,78,84,100,47,49,461,96,557,17.235188509874327
16360,330455705190297,58,66,69,74,62,61,83,39,390,122,512,23.828125
16361,330455705190300,124,136,89,184,170,75,46,39,778,85,863,9.84936268829664
16362,330455705190301,76,85,94,80,38,42,28,19,415,47,462,10.173160173160174
16363,330455705190302,50,26,29,19,18,8,3,2,150,5,155,3.225806451612903
16364,330455705190303,96,127,167,133,163,179,60,109,865,169,1034,16.344294003868473
16365,330455705190304,66,91,130,118,121,139,100,114,665,214,879,24.34584755403868
16366,330455705190305,6,10,10,4,9,10,1,4,49,5,54,9.25925925925926
16367,330455705200001,50,84,73,82,91,96,46,55,476,101,577,17.504332755632582
16368,330455705200002,50,69,81,81,81,63,75,68,425,143,568,25.176056338028168
16369,330455705200003,38,73,105,77,102,97,67,90,492,157,649,24.19106317411402
16370,330455705200004,47,80,83,81,67,70,40,45,428,85,513,16.569200779727094
16371,330455705200005,125,126,97,102,59,28,16,10,537,26,563,4.618117229129663
16372,330455705200006,9,17,25,22,21,15,13,14,109,27,136,19.852941176470587
16373,330455705200007,37,48,53,84,65,48,52,89,335,141,476,29.6218487394958
16374,330455705200008,58,57,84,83,87,67,46,48,436,94,530,17.735849056603772
16375,330455705200009,67,72,108,107,79,85,65,58,518,123,641,19.18876755070203
16376,330455705200010,67,73,124,139,94,103,83,91,600,174,774,22.48062015503876
16377,330455705200011,42,76,48,70,67,63,41,33,366,74,440,16.818181818181817
16378,330455705200012,55,86,85,79,88,80,73,71,473,144,617,23.3387358184765
16379,330455705200013,46,83,91,91,93,93,57,70,497,127,624,20.352564102564102
16380,330455705200014,46,51,52,74,53,59,53,49,335,102,437,23.340961098398168
16381,330455705200015,66,83,86,87,92,103,76,74,517,150,667,22.488755622188904
16382,330455705200016,37,67,73,62,66,65,29,26,370,55,425,12.941176470588236
16383,330455705200017,16,29,52,41,54,64,26,27,256,53,309,17.15210355987055
16384,330455705200018,75,108,129,110,127,121,93,89,670,182,852,21.36150234741784
16385,330455705200019,102,118,154,150,129,111,71,65,764,136,900,15.11111111111111
16386,330455705200020,70,92,112,108,109,91,70,72,582,142,724,19.613259668508288
16387,330455705200021,20,27,21,18,20,13,13,8,119,21,140,15.0
16388,330455705200022,22,49,46,42,56,52,46,45,267,91,358,25.41899441340782
16389,330455705200023,77,111,144,128,146,131,88,108,737,196,933,21.007502679528404
16390,330455705200024,72,104,126,98,104,116,75,70,620,145,765,18.954248366013072
16391,330455705200025,64,79,86,91,77,91,44,65,488,109,597,18.257956448911223
16392,330455705200026,72,107,102,127,88,82,58,59,578,117,695,16.834532374100718
16393,330455705200027,177,237,223,195,182,130,93,52,1144,145,1289,11.249030256012412
16394,330455705200028,72,94,132,131,122,123,84,120,674,204,878,23.234624145785876
16395,330455705200029,45,78,106,95,88,107,84,63,519,147,666,22.07207207207207
16396,330455705200030,68,79,111,117,60,116,62,53,551,115,666,17.26726726726727
16397,330455705200031,49,65,76,99,90,78,65,70,457,135,592,22.804054054054053
16398,330455705200032,57,52,71,76,91,75,57,69,422,126,548,22.99270072992701
16399,330455705200033,98,91,122,129,121,135,97,93,696,190,886,21.44469525959368
16400,330455705200034,106,119,155,144,133,100,43,53,757,96,853,11.254396248534583
16401,330455705200035,94,145,133,126,116,76,59,29,690,88,778,11.311053984575835
16402,330455705200036,203,215,209,205,151,109,48,38,1092,86,1178,7.300509337860781
16403,330455705200037,125,135,144,159,101,93,68,55,757,123,880,13.977272727272727
16404,330455705200038,95,99,101,87,89,69,36,42,540,78,618,12.62135922330097
16405,330455705200039,20,18,14,13,17,4,7,1,86,8,94,8.51063829787234
16406,330455705200040,76,105,87,88,76,48,30,29,480,59,539,10.946196660482375
16407,330455705200041,80,102,98,91,57,76,29,22,504,51,555,9.18918918918919
16408,330455705200042,110,133,106,111,93,82,51,35,635,86,721,11.927877947295423
16409,330455705200043,72,115,119,110,96,83,58,59,595,117,712,16.43258426966292
16410,330455705200044,30,44,55,59,52,50,48,35,290,83,373,22.25201072386059
16411,330455705200045,37,94,118,97,121,106,65,73,573,138,711,19.40928270042194
16412,330455705200046,42,57,85,83,91,76,62,73,434,135,569,23.725834797891036
16413,330455705200047,78,102,172,135,149,158,73,91,794,164,958,17.11899791231733
16414,330455705200048,33,46,41,59,44,41,32,41,264,73,337,21.661721068249257
16415,330455705200049,28,52,69,58,68,66,62,77,341,139,480,28.958333333333332
16416,330455705200050,54,72,98,118,93,81,52,67,516,119,635,18.74015748031496
16417,330455705200051,79,92,143,104,107,87,72,56,612,128,740,17.2972972972973
16418,330455705200052,67,80,77,72,58,64,33,27,418,60,478,12.552301255230125
16419,330455705200053,85,79,107,124,88,115,73,63,598,136,734,18.52861035422343
16420,330455705200054,75,118,172,116,140,106,74,66,727,140,867,16.147635524798154
16421,330455705200055,61,66,128,95,96,109,71,67,555,138,693,19.913419913419915
16422,330455705200056,38,36,69,51,54,56,38,27,304,65,369,17.615176151761517
16423,330455705200057,87,102,136,120,113,127,87,94,685,181,866,20.900692840646652
16424,330455705200058,81,86,117,108,106,109,53,60,607,113,720,15.694444444444445
16425,330455705200059,110,115,135,126,99,109,78,68,694,146,840,17.38095238095238
16426,330455705200060,107,92,117,94,96,74,57,34,580,91,671,13.561847988077496
16427,330455705200061,88,112,131,103,120,106,67,53,660,120,780,15.384615384615385
16428,330455705200062,89,83,113,82,87,66,55,56,520,111,631,17.591125198098258
16429,330455705200063,109,140,144,117,141,106,67,62,757,129,886,14.559819413092551
16430,330455705200064,25,21,24,24,10,19,17,7,123,24,147,16.3265306122449
16431,330455705200065,49,67,78,94,57,81,60,51,426,111,537,20.670391061452513
16432,330455705200066,56,83,52,81,91,70,50,49,433,99,532,18.60902255639098
16433,330455705200067,57,57,69,70,51,53,43,31,357,74,431,17.16937354988399
16434,330455705200068,64,121,87,125,103,71,72,55,571,127,698,18.19484240687679
16435,330455705200069,80,114,118,88,93,97,50,33,590,83,673,12.332838038632987
16436,330455705200070,69,103,92,115,103,102,74,77,584,151,735,20.54421768707483
16437,330455705200071,154,197,155,161,131,75,56,40,873,96,969,9.907120743034056
16438,330455705200072,126,164,137,109,104,67,65,55,707,120,827,14.510278113663846
16439,330455705200073,98,142,126,119,161,107,66,74,753,140,893,15.677491601343785
16440,330455705200074,78,109,145,136,118,102,99,86,688,185,873,21.191294387170675
16441,330455705200075,84,94,99,118,110,93,67,62,598,129,727,17.744154057771663
16442,330455705200076,58,71,100,97,89,69,42,27,484,69,553,12.47739602169982
16443,330455705200077,93,108,144,125,99,99,53,58,668,111,779,14.249037227214377
16444,330455705200078,68,93,105,91,85,63,54,40,505,94,599,15.692821368948247
16445,330455705200079,113,168,134,126,106,76,23,18,723,41,764,5.366492146596858
16446,330455705200080,153,124,119,81,65,41,37,31,583,68,651,10.44546850998464
16447,330455705200081,101,148,129,113,94,81,46,39,666,85,751,11.318242343541945
16448,330455705200082,64,94,140,103,158,121,51,35,680,86,766,11.22715404699739
16449,330455705200083,79,129,155,142,127,120,66,71,752,137,889,15.410573678290215
16450,330455705200084,31,64,49,57,52,42,26,40,295,66,361,18.282548476454295
16451,330455705200085,61,95,102,81,105,92,55,73,536,128,664,19.27710843373494
16452,330455705200086,47,56,95,70,67,95,69,68,430,137,567,24.16225749559083
16453,330455705200087,38,41,63,56,54,69,45,58,321,103,424,24.29245283018868
16454,330455705200088,46,97,88,92,98,111,70,81,532,151,683,22.10834553440703
16455,330455705200089,53,60,74,66,55,44,43,36,352,79,431,18.329466357308586
16456,330455705200090,41,80,63,65,86,59,69,111,394,180,574,31.358885017421603
16457,330455705200091,47,89,116,96,118,112,77,79,578,156,734,21.25340599455041
16458,330455705200092,43,62,91,66,74,90,41,67,426,108,534,20.224719101123597
16459,330455705200093,84,105,101,117,114,101,86,86,622,172,794,21.662468513853906
16460,330455705200094,68,106,106,114,100,114,69,111,608,180,788,22.84263959390863
16461,330455705200095,60,88,98,94,93,112,64,63,545,127,672,18.898809523809526
16462,330455705200096,59,63,62,73,57,39,36,46,353,82,435,18.850574712643677
16463,330455705200097,53,92,117,107,120,97,73,86,586,159,745,21.34228187919463
16464,330455705200098,52,63,82,75,71,67,37,51,410,88,498,17.670682730923694
16465,330455705200099,47,71,80,99,64,73,72,64,434,136,570,23.859649122807017
16466,330455705200100,55,64,80,72,80,112,63,49,463,112,575,19.47826086956522
16467,330455705200101,49,54,69,70,64,68,56,51,374,107,481,22.245322245322246
16468,330455705200102,66,95,120,89,112,102,88,95,584,183,767,23.859191655801826
16469,330455705200103,134,151,160,154,132,124,96,88,855,184,1039,17.709335899903753
16470,330455705200104,85,125,129,130,137,114,85,81,720,166,886,18.73589164785553
16471,330455705200105,44,50,50,51,52,56,32,31,303,63,366,17.21311475409836
16472,330455705200106,84,97,133,117,71,109,71,74,611,145,756,19.17989417989418
16473,330455705200107,55,86,96,84,92,86,60,80,499,140,639,21.90923317683881
16474,330455705200108,97,130,139,165,119,115,73,64,765,137,902,15.188470066518846
16475,330455705200109,71,108,110,123,132,121,80,100,665,180,845,21.301775147928993
16476,330455705200110,72,118,140,123,109,130,80,85,692,165,857,19.25320886814469
16477,330455705200111,64,99,113,66,67,71,64,67,480,131,611,21.44026186579378
16478,330455705200112,181,214,242,227,176,132,69,37,1172,106,1278,8.294209702660407
16479,330455705200113,103,123,198,165,143,155,89,87,887,176,1063,16.556914393226716
16480,330455705200114,66,95,94,97,70,77,53,50,499,103,602,17.109634551495017
16481,330455705200115,52,68,55,71,55,52,31,21,353,52,405,12.839506172839506
16482,330455705200116,140,176,180,158,172,119,70,58,945,128,1073,11.929170549860205
16483,330455705200117,26,31,22,27,16,12,9,8,134,17,151,11.258278145695364
16484,330455705200118,149,140,168,138,113,103,57,54,811,111,922,12.039045553145336
16485,330455705200119,86,94,106,92,94,78,45,50,550,95,645,14.728682170542635
16486,330455705200120,155,187,108,95,80,53,26,12,678,38,716,5.307262569832402
16487,330455705200121,74,91,83,67,68,42,21,7,425,28,453,6.181015452538631
16488,330455705200122,234,257,189,168,122,80,41,31,1050,72,1122,6.4171122994652405
16489,330455705200123,111,80,86,57,47,35,12,19,416,31,447,6.935123042505593
16490,330455705200124,152,105,93,81,38,28,15,7,497,22,519,4.238921001926783
16491,330455705200125,54,85,67,40,40,27,7,6,313,13,326,3.9877300613496933
16492,330455705200126,147,205,160,151,121,85,37,23,869,60,929,6.458557588805167
16493,330455705200127,36,57,58,47,50,47,28,26,295,54,349,15.472779369627506
16494,330455705200128,30,29,40,44,31,29,29,28,203,57,260,21.923076923076923
16495,330455705200129,68,58,79,71,39,48,18,21,363,39,402,9.701492537313433
16496,330455705200130,76,32,81,87,65,24,35,22,365,57,422,13.507109004739336
16497,330455705200131,77,68,99,100,81,85,62,80,510,142,652,21.779141104294478
16498,330455705200132,44,46,87,89,69,84,64,54,419,118,537,21.973929236499067
16499,330455705200133,46,70,93,97,93,95,67,86,494,153,647,23.64760432766615
16500,330455705200134,27,25,38,33,36,44,33,31,203,64,267,23.970037453183522
16501,330455705200135,4,11,21,10,13,14,18,11,73,29,102,28.431372549019606
16502,330455705200136,57,84,79,65,69,67,60,50,421,110,531,20.715630885122412
16503,330455705200137,64,75,137,105,105,104,81,54,590,135,725,18.620689655172413
16504,330455705200138,2,12,18,10,9,6,3,2,57,5,62,8.064516129032258
16505,330455705200139,44,34,67,73,67,60,46,53,345,99,444,22.2972972972973
16506,330455705200140,37,52,66,70,53,65,47,62,343,109,452,24.115044247787612
16507,330455705200141,43,38,69,62,72,76,41,73,360,114,474,24.050632911392405
16508,330455705200142,30,78,72,68,69,76,45,69,393,114,507,22.485207100591715
16509,330455705200143,46,56,113,78,79,94,52,54,466,106,572,18.53146853146853
16510,330455705200144,54,62,81,66,55,61,20,28,379,48,427,11.241217798594848
16511,330455705200145,34,46,50,38,42,24,18,18,234,36,270,13.333333333333334
16512,330455705200146,60,91,66,60,32,36,15,13,345,28,373,7.506702412868632
16513,330455705200147,90,81,89,108,62,56,31,10,486,41,527,7.7798861480075905
16514,330455705200148,100,111,109,81,62,59,34,22,522,56,578,9.688581314878892
16515,330455705200149,95,128,77,102,80,69,48,22,551,70,621,11.272141706924316
16516,330455705200150,87,117,90,120,111,97,64,50,622,114,736,15.48913043478261
16517,330455705200151,60,118,104,81,91,83,58,52,537,110,647,17.001545595054097
16518,330455705200152,56,103,95,74,107,82,42,38,517,80,597,13.40033500837521
16519,330455705200153,84,102,65,75,48,36,28,11,410,39,449,8.68596881959911
16520,330455705200154,133,154,141,154,121,113,52,51,816,103,919,11.207834602829163
16521,330455705200155,57,67,94,73,83,82,56,37,456,93,549,16.939890710382514
16522,330455705200156,83,99,100,107,79,84,53,49,552,102,654,15.596330275229358
16523,330455705200157,71,104,114,69,58,48,12,9,464,21,485,4.329896907216495
16524,330455705200158,38,51,40,62,48,21,18,6,260,24,284,8.450704225352112
16525,330455705200159,72,102,169,154,131,88,47,29,716,76,792,9.595959595959595
16526,330455705200160,110,102,160,94,86,81,41,24,633,65,698,9.312320916905444
16527,330455705200161,125,115,111,92,68,76,38,31,587,69,656,10.518292682926829
16528,330455705200162,49,93,98,71,78,45,43,51,434,94,528,17.803030303030305
16529,330455705200163,50,56,54,55,50,68,36,31,333,67,400,16.75
16530,330455705200164,108,137,123,111,118,148,86,66,745,152,897,16.9453734671126
16531,330455705200165,81,88,94,106,89,96,54,57,554,111,665,16.69172932330827
16532,330455705200166,100,81,124,134,95,108,88,67,642,155,797,19.44792973651192
16533,330455705200167,73,92,111,126,110,96,59,70,608,129,737,17.5033921302578
16534,330455705200168,69,97,122,116,106,113,76,78,623,154,777,19.81981981981982
16535,330455705200169,70,91,107,123,98,82,66,65,571,131,702,18.66096866096866
16536,330455705200170,68,105,119,100,105,109,62,97,606,159,765,20.784313725490197
16537,330455705200171,112,132,117,138,127,92,64,78,718,142,860,16.511627906976745
16538,330455705200172,101,77,73,56,47,33,21,16,387,37,424,8.726415094339623
16539,330455705200173,108,155,104,108,87,46,19,10,608,29,637,4.552590266875981
16540,330455705200174,85,99,87,69,46,44,18,12,430,30,460,6.521739130434782
16541,330455705200175,113,136,144,132,127,121,72,60,773,132,905,14.585635359116022
16542,330455705200176,30,61,53,69,71,67,64,58,351,122,473,25.792811839323466
16543,330455705200177,76,84,97,80,72,86,46,37,495,83,578,14.359861591695502
16544,330455705200178,94,161,111,138,114,92,58,54,710,112,822,13.62530413625304
16545,330455705200179,95,176,203,133,178,113,73,51,898,124,1022,12.13307240704501
16546,330455705200180,77,122,165,108,97,96,27,74,665,101,766,13.18537859007833
16547,330455705200181,39,80,100,84,89,93,42,73,485,115,600,19.166666666666668
16548,330455705200182,51,83,95,99,79,94,79,87,501,166,667,24.887556221889056
16549,330455705200183,78,95,117,97,84,91,55,60,562,115,677,16.986706056129986
16550,330455705200184,60,86,133,120,103,160,84,117,662,201,863,23.290845886442643
16551,330455705200185,49,88,87,93,92,100,59,70,509,129,638,20.219435736677116
16552,330455705200186,42,79,113,89,82,123,77,69,528,146,674,21.661721068249257
16553,330455705200187,96,124,135,131,145,121,82,80,752,162,914,17.72428884026258
16554,330455705200188,26,52,62,54,50,81,53,45,325,98,423,23.167848699763592
16555,330455705200189,90,104,126,112,102,105,83,75,639,158,797,19.824341279799246
16556,330455705200190,35,48,69,54,71,84,56,93,361,149,510,29.215686274509803
16557,330455705200191,64,120,116,71,111,104,42,63,586,105,691,15.195369030390738
16558,330455705200192,52,77,85,64,78,85,50,79,441,129,570,22.63157894736842
16559,330455705200193,67,109,126,135,155,122,100,135,714,235,949,24.76290832455216
16560,330455705200194,21,34,63,48,43,62,33,75,271,108,379,28.496042216358838
16561,330455705200195,41,59,78,51,55,66,64,64,350,128,478,26.778242677824267
16562,330455705200196,69,112,122,89,105,88,53,64,585,117,702,16.666666666666668
16563,330455705200197,60,80,121,100,82,123,86,116,566,202,768,26.302083333333332
16564,330455705200198,15,27,42,39,44,44,32,28,211,60,271,22.14022140221402
16565,330455705200199,46,54,80,66,64,76,54,48,386,102,488,20.901639344262296
16566,330455705200200,112,115,173,144,145,132,54,67,821,121,942,12.845010615711253
16567,330455705200201,77,93,110,98,87,86,48,62,551,110,661,16.64145234493192
16568,330455705200202,63,148,130,153,99,110,72,65,703,137,840,16.30952380952381
16569,330455705200203,67,88,115,103,112,109,82,102,594,184,778,23.65038560411311
16570,330455705200204,54,81,102,80,93,119,73,91,529,164,693,23.665223665223664
16571,330455705200205,44,62,75,86,73,71,67,55,411,122,533,22.889305816135085
16572,330455705200206,115,105,156,121,136,118,75,57,751,132,883,14.949037372593432
16573,330455705200207,54,83,134,119,122,145,93,97,657,190,847,22.43211334120425
16574,330455705200208,193,100,106,252,78,106,69,60,835,129,964,13.381742738589212
16575,330455705200209,45,68,84,69,64,75,56,73,405,129,534,24.15730337078652
16576,330455705200210,13,30,21,34,14,32,28,22,144,50,194,25.77319587628866
16577,330455705200211,134,158,154,147,118,156,84,69,867,153,1020,15.0
16578,330455705200212,115,123,136,124,98,92,87,57,688,144,832,17.307692307692307
16579,330455705200213,68,159,421,369,213,83,33,12,1313,45,1358,3.313696612665685
16580,330455705200214,83,116,117,119,116,105,69,92,656,161,817,19.7062423500612
16581,330455705200215,93,103,123,127,128,99,72,56,673,128,801,15.980024968789014
16582,330455705200216,113,157,160,138,144,133,86,68,845,154,999,15.415415415415415
16583,330455705200217,97,111,68,62,44,27,10,13,409,23,432,5.324074074074074
16584,330455705200218,65,70,106,96,67,75,50,62,479,112,591,18.95093062605753
16585,330455705200219,88,114,147,127,119,125,76,72,720,148,868,17.05069124423963
16586,330455705200220,64,80,88,90,68,71,27,70,461,97,558,17.38351254480287
16587,330455705200221,110,143,126,147,152,125,89,69,803,158,961,16.441207075962538
16588,330455705200222,70,85,84,103,77,101,60,69,520,129,649,19.87673343605547
16589,330455705200223,93,105,123,119,100,85,48,53,625,101,726,13.911845730027549
16590,330455705200224,58,90,116,107,86,79,51,57,536,108,644,16.770186335403725
16591,330455705200225,116,133,138,112,117,82,51,51,698,102,800,12.75
16592,330455705200226,169,166,178,122,102,92,33,35,829,68,897,7.58082497212932
16593,330455705200227,89,51,81,59,53,57,20,21,390,41,431,9.51276102088167
16594,330455705200228,79,97,135,120,111,111,57,65,653,122,775,15.741935483870968
16595,330455705200229,80,74,98,95,92,66,54,41,505,95,600,15.833333333333334
16596,330455705200230,213,244,205,195,184,151,92,62,1192,154,1346,11.441307578008916
16597,330455705200231,115,112,114,103,101,92,58,37,637,95,732,12.978142076502733
16598,330455705200232,83,170,152,156,132,136,81,72,829,153,982,15.580448065173115
16599,330455705200233,78,114,125,99,118,105,64,58,639,122,761,16.031537450722734
16600,330455705200234,58,90,61,82,79,65,38,27,435,65,500,13.0
16601,330455705200235,61,100,110,97,78,91,53,22,537,75,612,12.254901960784315
16602,330455705200236,80,81,90,114,98,83,50,21,546,71,617,11.507293354943274
16603,330455705200237,131,99,105,67,47,34,19,12,483,31,514,6.031128404669261
16604,330455705200238,266,182,161,146,74,46,40,4,875,44,919,4.787812840043525
16605,330455705200239,97,85,128,111,78,73,36,31,572,67,639,10.485133020344287
16606,330455705200240,117,142,178,180,143,148,76,68,908,144,1052,13.688212927756654
16607,330455705200241,91,113,101,87,98,92,44,49,582,93,675,13.777777777777779
16608,330455705200242,120,122,114,97,85,56,42,20,594,62,656,9.451219512195122
16609,330455705200243,121,127,203,155,144,113,71,77,863,148,1011,14.63897131552918
16610,330455705200244,53,97,63,71,65,48,45,34,397,79,476,16.596638655462186
16611,330455705200245,5,12,9,9,6,5,2,0,46,2,48,4.166666666666667
16612,330455705200246,60,75,93,98,96,84,63,61,506,124,630,19.682539682539684
16613,330455705200247,45,49,47,50,54,50,26,45,295,71,366,19.398907103825138
16614,330455705200248,64,82,104,88,83,95,65,64,516,129,645,20.0
16615,330455705200249,86,135,134,119,110,122,82,68,706,150,856,17.523364485981308
16616,330455705200250,162,209,231,179,173,126,81,33,1080,114,1194,9.547738693467336
16617,330455705200251,35,63,47,28,47,47,24,19,267,43,310,13.870967741935484
16618,330455705200252,66,66,63,54,55,38,14,11,342,25,367,6.8119891008174385
16619,330455705200253,143,152,148,140,109,131,60,75,823,135,958,14.091858037578287
16620,330455705200254,79,114,135,148,145,136,87,89,757,176,933,18.863879957127544
16621,330455705200255,92,134,130,126,146,119,83,75,747,158,905,17.4585635359116
16622,330455705200256,60,61,91,81,88,80,39,40,461,79,540,14.62962962962963
16623,330455705200257,42,71,60,53,80,49,35,27,355,62,417,14.86810551558753
16624,330455705200258,68,129,122,126,135,117,97,71,697,168,865,19.421965317919074
16625,330455705200259,52,69,88,61,65,74,34,40,409,74,483,15.320910973084887
16626,330455705200260,109,148,134,121,125,139,76,68,776,144,920,15.652173913043478
16627,330455705200261,60,75,92,78,78,61,54,28,444,82,526,15.5893536121673
16628,330455705200262,121,114,159,129,101,95,71,65,719,136,855,15.90643274853801
16629,330455705200263,161,150,193,167,137,122,70,60,930,130,1060,12.264150943396226
16630,330455705200264,84,93,122,89,74,83,47,35,545,82,627,13.078149920255184
16631,330455705200265,49,86,94,96,89,87,47,50,501,97,598,16.220735785953178
16632,330455705200266,124,142,150,117,135,94,67,42,762,109,871,12.51435132032147
16633,330455705200267,114,136,148,150,121,122,74,67,791,141,932,15.128755364806867
16634,330455705200268,54,61,96,79,87,85,28,24,462,52,514,10.116731517509727
16635,330455705200269,90,116,128,135,108,101,62,47,678,109,787,13.850063532401524
16636,330455705200270,116,139,139,135,135,113,64,67,777,131,908,14.427312775330396
16637,330455705200271,83,137,158,166,135,143,95,71,822,166,988,16.80161943319838
16638,330455705200272,73,98,115,112,107,113,48,77,618,125,743,16.823687752355315
16639,330455705200273,127,156,168,155,142,116,54,49,864,103,967,10.651499482936918
16640,330455705200274,163,161,181,176,123,152,80,53,956,133,1089,12.213039485766759
16641,330455705200275,106,122,119,110,91,94,54,57,642,111,753,14.741035856573705
16642,330455705200276,82,122,109,98,121,87,58,71,619,129,748,17.245989304812834
16643,330455705200277,87,119,112,86,99,96,53,52,599,105,704,14.914772727272727
16644,330455705200278,80,125,105,117,112,83,66,53,622,119,741,16.059379217273953
16645,330455705200279,64,90,87,79,90,70,34,53,480,87,567,15.343915343915343
16646,330455705200280,50,68,66,67,71,47,46,42,369,88,457,19.25601750547046
16647,330455705200281,141,141,149,156,153,124,89,83,864,172,1036,16.602316602316602
16648,330455705200282,68,109,111,112,95,112,46,49,607,95,702,13.532763532763532
16649,330455705200283,80,89,110,110,85,110,71,58,584,129,713,18.09256661991585
16650,330455705200284,55,109,102,83,98,81,60,44,528,104,632,16.455696202531644
16651,330455705200285,80,121,121,109,125,110,99,83,666,182,848,21.462264150943398
16652,330455705200286,116,160,148,162,151,142,99,103,879,202,1081,18.68640148011101
16653,330455705200287,128,194,171,178,147,185,99,107,1003,206,1209,17.03887510339123
16654,330455705200288,128,159,102,127,100,75,35,35,691,70,761,9.198423127463863
16655,330455705200289,192,189,171,143,101,78,35,27,874,62,936,6.6239316239316235
16656,330455705200290,177,188,125,122,92,64,49,21,768,70,838,8.353221957040573
16657,330455705200291,129,135,142,136,111,112,57,51,765,108,873,12.371134020618557
16658,330455705200292,125,110,128,142,106,77,56,51,688,107,795,13.459119496855346
16659,330455705200293,139,149,171,170,133,101,89,52,863,141,1004,14.04382470119522
16660,330455705200294,76,104,134,86,137,101,71,78,638,149,787,18.932655654383737
16661,330455705200295,82,139,134,110,112,109,56,44,686,100,786,12.72264631043257
16662,330455705200296,78,94,96,80,72,63,40,21,483,61,544,11.213235294117647
16663,330455705200297,122,145,166,134,148,116,85,75,831,160,991,16.145307769929364
16664,330455705200298,159,166,205,211,157,154,141,100,1052,241,1293,18.638824439288477
16665,330455705200299,53,83,115,72,108,82,27,22,513,49,562,8.718861209964412
16666,330455705200300,92,128,115,128,125,123,64,60,711,124,835,14.850299401197605
16667,330455705200301,104,122,147,165,118,121,82,71,777,153,930,16.451612903225808
16668,330455705200302,103,116,146,123,120,121,84,75,729,159,888,17.905405405405407
16669,330455705200303,57,67,79,61,66,80,56,64,410,120,530,22.641509433962263
16670,330455705200304,61,102,88,86,93,84,77,50,514,127,641,19.81279251170047
16671,330455705200305,64,106,64,91,96,79,52,52,500,104,604,17.218543046357617
16672,330455705200306,84,137,107,119,123,98,69,48,668,117,785,14.904458598726114
16673,330455705200307,93,153,155,143,144,109,90,79,797,169,966,17.494824016563147
16674,330455705200308,89,102,113,103,83,93,41,33,583,74,657,11.263318112633181
16675,330455705200309,129,196,153,142,129,97,30,48,846,78,924,8.441558441558442
16676,330455705200310,96,113,84,103,67,49,31,26,512,57,569,10.017574692442881
16677,330455705200311,84,83,72,66,59,43,24,23,407,47,454,10.352422907488986
16678,330455705200312,194,271,191,232,216,123,79,58,1227,137,1364,10.043988269794722
16679,330455705200313,157,131,97,83,43,33,14,5,544,19,563,3.374777975133215
16680,330455705200314,134,146,190,165,148,146,98,81,929,179,1108,16.15523465703971
16681,330455705200315,102,129,117,136,75,102,86,49,661,135,796,16.959798994974875
16682,330455705200316,114,107,110,106,73,85,40,39,595,79,674,11.72106824925816
16683,330455705200317,54,60,70,64,60,46,26,25,354,51,405,12.592592592592593
16684,330455705200318,65,69,97,74,59,73,41,48,437,89,526,16.920152091254753
16685,330455705200319,57,96,88,76,72,75,29,35,464,64,528,12.121212121212121
16686,330455705200320,53,63,56,41,36,28,18,7,277,25,302,8.278145695364238
16687,330455705200321,81,86,104,79,96,67,53,34,513,87,600,14.5
16688,330455705200322,105,106,120,98,120,80,63,45,629,108,737,14.654002713704207
16689,330455705200323,79,106,103,106,92,65,68,58,551,126,677,18.61152141802068
16690,330455705200324,115,126,155,120,117,99,82,60,732,142,874,16.247139588100687
16691,330455705200325,61,83,97,103,82,83,75,53,509,128,637,20.09419152276295
16692,330455705200326,49,66,74,75,86,60,67,31,410,98,508,19.291338582677167
16693,330455705200327,107,128,172,151,145,149,91,54,852,145,997,14.543630892678035
16694,330455705200328,78,96,101,112,87,103,79,62,577,141,718,19.637883008356546
16695,330455705200329,109,149,153,118,135,88,69,67,752,136,888,15.315315315315315
16696,330455705200330,90,120,104,119,87,88,55,46,608,101,709,14.245416078984485
16697,330455705200331,97,110,116,108,130,107,75,74,668,149,817,18.2374541003672
16698,330455705200332,42,59,77,49,69,43,58,45,339,103,442,23.30316742081448
16699,330455705200333,48,71,79,72,72,75,56,35,417,91,508,17.913385826771652
16700,330455705200334,69,81,105,88,78,92,50,64,513,114,627,18.181818181818183
16701,330455705200335,85,101,92,121,91,67,45,44,557,89,646,13.777089783281733
16702,330455705200336,63,79,90,108,73,67,74,57,480,131,611,21.44026186579378
16703,330455705200337,41,66,59,66,73,54,39,45,359,84,443,18.96162528216704
16704,330455705200338,65,133,112,111,139,102,108,93,662,201,863,23.290845886442643
16705,330455705200339,36,45,47,45,55,50,48,40,278,88,366,24.043715846994534
16706,330455705200340,40,54,59,51,50,55,41,49,309,90,399,22.55639097744361
16707,330455705200341,59,108,86,78,109,90,40,54,530,94,624,15.064102564102564
16708,330455705200342,50,71,97,96,91,86,64,67,491,131,622,21.061093247588424
16709,330455705200343,14,14,19,18,15,14,8,4,94,12,106,11.320754716981131
16710,330455705200344,67,130,110,91,116,102,43,50,616,93,709,13.11706629055007
16711,330455705200345,68,98,88,79,90,108,49,75,531,124,655,18.931297709923665
16712,330455705200346,71,110,88,96,97,80,47,52,542,99,641,15.444617784711388
16713,330455705200347,76,141,108,141,107,105,88,66,678,154,832,18.509615384615383
16714,330455705200348,112,142,129,127,134,109,74,73,753,147,900,16.333333333333332
16715,330455705200349,89,98,133,112,127,103,70,69,662,139,801,17.35330836454432
16716,330455705200350,74,121,104,87,125,96,64,80,607,144,751,19.174434087882823
16717,330455705200351,78,79,100,101,88,93,56,54,539,110,649,16.949152542372882
16718,330455705200352,83,92,104,118,99,74,76,62,570,138,708,19.491525423728813
16719,330455705200353,67,135,111,114,96,112,75,70,635,145,780,18.58974358974359
16720,330455705200354,56,71,79,85,89,76,54,61,456,115,571,20.140105078809107
16721,330455705200355,47,77,77,80,74,59,44,49,414,93,507,18.34319526627219
16722,330455705200356,62,84,124,100,105,123,67,64,598,131,729,17.969821673525377
16723,330455705200357,52,76,86,62,75,60,43,52,411,95,506,18.774703557312254
16724,330455705200358,70,76,96,88,83,75,49,46,488,95,583,16.295025728987994
16725,330455705200359,92,120,154,120,137,134,93,74,757,167,924,18.073593073593074
16726,330455705200360,53,77,121,91,88,113,64,83,543,147,690,21.304347826086957
16727,330455705200361,46,84,88,111,119,88,67,75,536,142,678,20.94395280235988
16728,330455705200362,47,43,69,60,66,57,50,51,342,101,443,22.799097065462753
16729,330455705200363,87,77,89,107,68,104,52,52,532,104,636,16.352201257861637
16730,330455705200364,36,42,63,49,57,44,37,43,291,80,371,21.5633423180593
16731,330455705200365,71,93,118,120,100,110,89,66,612,155,767,20.208604954367665
16732,330455705200366,37,58,65,59,58,63,36,37,340,73,413,17.675544794188863
16733,330455705200367,65,67,83,82,91,76,52,54,464,106,570,18.596491228070175
16734,330455705200368,63,71,60,70,64,68,47,50,396,97,493,19.675456389452332
16735,330455705200369,63,82,81,117,107,81,50,86,531,136,667,20.389805097451273
16736,330455705200370,74,105,130,97,111,110,83,80,627,163,790,20.632911392405063
16737,330455705200371,73,132,142,96,114,125,48,61,682,109,791,13.780025284450064
16738,330455705200372,73,115,95,94,88,94,49,56,559,105,664,15.813253012048193
16739,330455705200373,44,52,109,63,58,100,47,32,426,79,505,15.643564356435643
16740,330455705200374,41,57,116,94,68,83,40,26,459,66,525,12.571428571428571
16741,330455705200375,42,99,83,91,101,95,60,61,511,121,632,19.145569620253166
16742,330455705200376,72,106,95,97,82,77,49,53,529,102,631,16.164817749603802
16743,330455705200377,66,78,97,73,86,84,53,36,484,89,573,15.532286212914485
16744,330455705200378,92,131,151,117,137,138,85,70,766,155,921,16.829533116178066
16745,330455705200379,59,107,113,100,105,104,72,63,588,135,723,18.672199170124482
16746,330455705200380,94,116,149,119,120,130,74,72,728,146,874,16.704805491990847
16747,330455705200381,95,116,102,99,108,71,56,54,591,110,701,15.691868758915835
16748,330455705200382,49,70,51,75,62,64,48,54,371,102,473,21.56448202959831
16749,330455705200383,70,106,88,74,71,69,35,21,478,56,534,10.486891385767791
16750,330455705200384,86,126,144,139,121,154,96,76,770,172,942,18.259023354564757
16751,330455705200385,21,53,55,54,67,73,37,39,323,76,399,19.047619047619047
16752,330455705200386,42,58,103,62,93,104,75,65,462,140,602,23.25581395348837
16753,330455705200387,5,7,5,10,9,6,7,2,42,9,51,17.647058823529413
16754,330455705200388,84,101,120,125,117,113,67,71,660,138,798,17.293233082706767
16755,330455705200389,43,84,89,62,104,105,46,100,487,146,633,23.06477093206951
16756,330455705200390,59,86,93,85,100,96,54,108,519,162,681,23.788546255506606
16757,330455705200391,71,89,79,102,82,83,56,54,506,110,616,17.857142857142858
16758,330455705200392,37,30,29,25,29,13,13,12,163,25,188,13.297872340425531
16759,330455705200393,60,78,103,81,97,97,73,72,516,145,661,21.936459909228443
16760,330455705200394,52,74,107,77,76,84,57,57,470,114,584,19.52054794520548
16761,330455705200395,46,93,93,76,96,100,58,59,504,117,621,18.840579710144926
16762,330455705200396,76,83,92,96,81,85,61,53,513,114,627,18.181818181818183
16763,330455705200397,95,155,163,154,130,143,88,80,840,168,1008,16.666666666666668
16764,330455705200398,89,98,121,114,106,114,79,86,642,165,807,20.44609665427509
16765,330455705200399,104,136,125,136,150,142,89,99,793,188,981,19.164118246687053
16766,330455705200400,96,122,150,134,141,143,78,86,786,164,950,17.263157894736842
16767,330455705200401,46,42,54,38,31,28,16,9,239,25,264,9.469696969696969
16768,330455705200402,51,49,70,64,63,62,38,27,359,65,424,15.330188679245284
16769,330455705200403,68,72,98,96,69,60,53,40,463,93,556,16.72661870503597
16770,330455705200404,67,92,105,131,101,94,60,47,590,107,697,15.351506456241033
16771,330455705200405,107,156,135,142,127,113,78,79,780,157,937,16.755602988260407
16772,330455705200406,87,100,95,131,117,74,75,72,604,147,751,19.573901464713714
16773,330455705200407,94,126,126,122,127,125,76,86,720,162,882,18.367346938775512
16774,330455705200408,69,96,95,86,93,85,43,52,524,95,619,15.347334410339258
16775,330455705200409,71,80,114,110,92,94,69,56,561,125,686,18.221574344023324
16776,330455705200410,55,61,71,81,76,74,49,54,418,103,521,19.769673704414586
16777,330455705200411,80,131,126,103,110,101,59,47,651,106,757,14.002642007926024
16778,330455705200412,72,92,93,113,92,99,67,59,561,126,687,18.34061135371179
16779,330455705200413,42,45,71,46,62,66,35,43,332,78,410,19.024390243902438
16780,330455705200414,55,67,94,67,98,54,55,39,435,94,529,17.76937618147448
16781,330455705200415,58,62,86,79,84,65,50,59,434,109,543,20.07366482504604
16782,330455705200416,50,67,72,78,64,56,48,47,387,95,482,19.70954356846473
16783,330455705200417,73,105,91,101,106,92,64,33,568,97,665,14.586466165413533
16784,330455705200418,64,83,82,70,63,77,46,42,439,88,527,16.698292220113853
16785,330455705200419,110,163,169,164,157,146,105,78,909,183,1092,16.75824175824176
16786,330455705200420,62,79,96,83,89,91,56,53,500,109,609,17.898193760262725
16787,330455705200421,38,63,78,76,70,82,41,53,407,94,501,18.7624750499002
16788,330455705200422,106,148,144,152,153,130,94,83,833,177,1010,17.524752475247524
16789,330455705200423,98,125,135,147,126,112,93,81,743,174,917,18.974918211559434
16790,330455705200424,91,105,94,98,108,81,69,58,577,127,704,18.039772727272727
16791,330455705200425,66,110,117,107,159,107,63,82,666,145,811,17.87916152897657
16792,330455705200426,63,103,110,93,125,130,69,78,624,147,771,19.06614785992218
16793,330455705200427,58,72,94,89,79,82,53,42,474,95,569,16.695957820738137
16794,330455705200428,56,67,96,75,63,89,62,67,446,129,575,22.434782608695652
16795,330455705200429,61,91,122,119,96,115,109,82,604,191,795,24.0251572327044
16796,330455705200430,4,4,9,9,6,5,5,6,37,11,48,22.916666666666668
16797,330455705200431,59,99,92,99,107,97,63,95,553,158,711,22.22222222222222
16798,330455705200432,108,142,168,152,152,164,98,118,886,216,1102,19.600725952813068
16799,330455705200433,47,67,59,63,76,60,42,27,372,69,441,15.646258503401361
16800,330455705200434,81,122,109,137,129,135,102,72,713,174,887,19.616685456595263
16801,330455705200435,64,60,97,82,80,65,41,28,448,69,517,13.346228239845262
16802,330455705200436,55,82,107,83,88,76,65,55,491,120,611,19.639934533551553
16803,330455705200437,37,52,50,28,46,33,23,15,246,38,284,13.380281690140846
16804,330455705200438,46,65,83,69,77,73,42,53,413,95,508,18.700787401574804
16805,330455705200439,37,34,38,25,19,24,6,2,177,8,185,4.324324324324325
16806,330455705200440,95,105,125,129,114,106,56,49,674,105,779,13.478818998716303
16807,330455705200441,69,86,101,80,91,76,49,66,503,115,618,18.6084142394822
16808,330455705200442,88,118,142,128,136,127,79,87,739,166,905,18.34254143646409
16809,330455705200443,72,125,126,104,121,98,90,81,646,171,817,20.930232558139537
16810,330455705200444,75,119,101,93,97,87,59,80,572,139,711,19.549929676511955
16811,330455705200445,91,119,158,167,125,157,127,74,817,201,1018,19.74459724950884
16812,330455705200446,54,58,66,79,62,56,44,31,375,75,450,16.666666666666668
16813,330455705200447,78,107,137,105,115,122,78,91,664,169,833,20.28811524609844
16814,330455705200448,44,65,71,46,69,74,40,58,369,98,467,20.985010706638114
16815,330455705200449,81,124,162,144,109,131,101,64,751,165,916,18.013100436681224
16816,330455705200450,45,56,81,73,74,81,36,52,410,88,498,17.670682730923694
16817,330455705200451,75,87,111,80,86,116,51,58,555,109,664,16.41566265060241
16818,330455705200452,65,86,105,93,95,72,69,63,516,132,648,20.37037037037037
16819,330455705200453,54,67,106,76,76,85,56,61,464,117,581,20.137693631669535
16820,330455705200454,41,51,54,57,57,51,44,56,311,100,411,24.330900243309003
16821,330455705200455,58,112,129,103,123,107,56,69,632,125,757,16.512549537648614
16822,330455705200456,79,105,110,92,109,102,58,71,597,129,726,17.768595041322314
16823,330455705200457,32,57,47,49,54,53,37,39,292,76,368,20.652173913043477
16824,330455705200458,86,97,124,114,92,114,55,52,627,107,734,14.577656675749319
16825,330455705200459,76,80,89,84,76,72,56,46,477,102,579,17.616580310880828
16826,330455705200460,104,114,128,123,115,94,67,60,678,127,805,15.77639751552795
16827,330455705200461,105,131,154,156,142,126,93,82,814,175,989,17.69464105156724
16828,330455705200462,72,108,104,116,109,124,83,95,633,178,811,21.948212083847103
16829,330455705200463,55,64,94,85,77,84,45,47,459,92,551,16.696914700544465
16830,330455705200464,78,98,117,121,95,127,72,71,636,143,779,18.35686777920411
16831,330455705200465,75,117,113,128,117,111,73,69,661,142,803,17.68368617683686
16832,330455705200466,80,99,112,125,123,101,81,81,640,162,802,20.199501246882793
16833,330455705200467,88,94,96,80,77,62,30,23,497,53,550,9.636363636363637
16834,330455705200468,95,128,125,129,121,104,49,47,702,96,798,12.030075187969924
16835,330455705200469,89,108,119,126,105,116,81,73,663,154,817,18.849449204406366
16836,330455705200470,93,109,108,79,100,75,42,43,564,85,649,13.097072419106317
16837,330455705200471,41,66,46,52,51,49,26,21,305,47,352,13.352272727272727
16838,330455705200472,53,44,50,57,30,29,17,16,263,33,296,11.14864864864865
16839,330455705200473,139,195,121,128,109,104,37,29,796,66,862,7.65661252900232
16840,330455705200474,74,73,52,61,55,30,26,11,345,37,382,9.68586387434555
16841,330455705200475,51,75,88,56,81,60,27,18,411,45,456,9.868421052631579
16842,330455705200476,134,161,141,128,105,94,57,34,763,91,854,10.655737704918034
16843,330455705200477,31,58,40,34,21,23,8,9,207,17,224,7.589285714285714
16844,330455705200478,170,172,154,103,114,78,40,22,791,62,853,7.268464243845252
16845,330455705200479,75,92,77,57,45,38,22,12,384,34,418,8.133971291866029
16846,330455705200480,72,87,97,84,88,83,35,33,511,68,579,11.744386873920552
16847,330455705200481,81,94,90,102,120,85,59,61,572,120,692,17.341040462427745
16848,330455705200482,151,188,145,169,122,92,47,25,867,72,939,7.667731629392971
16849,330455705200483,153,171,107,130,111,92,28,12,764,40,804,4.975124378109452
16850,330455705200484,155,216,161,136,158,108,47,23,934,70,1004,6.972111553784861
16851,330455705200485,17,29,33,21,23,23,12,8,146,20,166,12.048192771084338
16852,330455705200486,79,88,116,97,100,85,36,50,565,86,651,13.210445468509985
16853,330455705200487,69,73,83,65,85,58,38,38,433,76,509,14.931237721021612
16854,330455705200488,77,104,116,113,93,88,55,43,591,98,689,14.223512336719883
16855,330455705200489,75,94,113,96,82,96,45,30,556,75,631,11.885895404120443
16856,330455705200490,59,62,71,62,64,61,49,37,379,86,465,18.49462365591398
16857,330455705200491,66,78,87,90,90,96,57,56,507,113,620,18.225806451612904
16858,330455705200492,93,125,150,133,138,144,97,104,783,201,984,20.426829268292682
16859,330455705200493,62,84,111,89,99,82,84,94,527,178,705,25.24822695035461
16860,330455705200494,125,147,179,145,113,114,86,32,823,118,941,12.539851222104145
16861,330455705200495,64,91,101,91,85,112,73,61,544,134,678,19.764011799410028
16862,330455705200496,78,119,97,108,90,67,61,43,559,104,663,15.686274509803921
16863,330455705200497,78,134,134,104,107,89,67,54,646,121,767,15.775749674054758
16864,330455705200498,25,28,30,30,22,21,12,10,156,22,178,12.359550561797754
16865,330455705200499,47,61,81,72,65,56,42,30,382,72,454,15.859030837004406
16866,330455705200500,48,91,74,67,63,63,28,29,406,57,463,12.311015118790497
16867,330455705200501,91,96,118,117,81,82,48,46,585,94,679,13.843888070692195
16868,330455705200502,76,97,109,107,101,74,51,32,564,83,647,12.828438948995363
16869,330455705200503,79,84,109,61,78,60,38,34,471,72,543,13.259668508287293
16870,330455705200504,140,175,177,162,163,98,90,52,915,142,1057,13.434247871333964
16871,330455705200505,73,86,115,76,93,85,52,52,528,104,632,16.455696202531644
16872,330455705200506,56,57,72,73,84,63,47,47,405,94,499,18.837675350701403
16873,330455705200507,32,52,87,64,61,47,38,38,343,76,419,18.13842482100239
16874,330455705200508,84,118,148,127,140,119,81,74,736,155,891,17.39618406285073
16875,330455705200509,69,74,100,100,82,89,51,66,514,117,631,18.54199683042789
16876,330455705200510,63,98,105,99,91,108,55,35,564,90,654,13.761467889908257
16877,330455705200511,16,37,47,38,37,41,26,33,216,59,275,21.454545454545453
16878,330455705200512,78,87,122,83,129,108,89,103,607,192,799,24.030037546933666
16879,330455705200513,52,72,71,88,71,92,67,79,446,146,592,24.66216216216216
16880,330455705200514,111,137,145,154,145,147,128,134,839,262,1101,23.79654859218892
16881,330455705200515,36,59,103,76,70,103,64,73,447,137,584,23.458904109589042
16882,330455705200516,65,78,102,104,97,95,88,73,541,161,702,22.934472934472936
16883,330455705200517,76,44,79,187,85,45,27,14,516,41,557,7.360861759425494
16884,330455705200518,44,55,67,68,58,40,43,36,332,79,411,19.221411192214113
16885,330455705200519,25,50,37,46,37,33,33,25,228,58,286,20.27972027972028
16886,330455705200520,48,59,95,86,87,99,65,66,474,131,605,21.65289256198347
16887,330455705200521,84,97,94,102,87,88,49,55,552,104,656,15.853658536585366
16888,330455705200522,108,131,120,109,102,82,50,59,652,109,761,14.323258869908015
16889,330455705200523,83,114,101,98,94,72,46,29,562,75,637,11.773940345368917
16890,330455705200524,39,59,52,52,56,49,25,34,307,59,366,16.120218579234972
16891,330455705200525,51,70,78,61,60,88,56,32,408,88,496,17.741935483870968
16892,330455705200526,75,106,97,80,93,83,40,40,534,80,614,13.029315960912053
16893,330455705200527,63,55,63,54,55,54,31,24,344,55,399,13.784461152882205
16894,330455705200528,42,56,56,55,61,46,38,37,316,75,391,19.18158567774936
16895,330455705200529,59,113,135,98,128,58,39,25,591,64,655,9.770992366412214
16896,330455705200530,42,79,73,71,81,72,55,60,418,115,533,21.575984990619137
16897,330455705200531,49,57,73,77,62,80,38,29,398,67,465,14.408602150537634
16898,330455705200532,43,52,77,62,61,51,50,52,346,102,448,22.767857142857142
16899,330455705200533,27,68,58,93,47,64,43,33,357,76,433,17.551963048498845
16900,330455705200534,91,91,95,76,50,75,31,32,478,63,541,11.645101663585953
16901,330455705200535,46,51,70,58,82,64,40,44,371,84,455,18.46153846153846
16902,330455705200536,40,71,69,60,71,61,38,61,372,99,471,21.019108280254777
16903,330455705200538,56,72,60,83,80,77,54,40,428,94,522,18.007662835249043
16904,330455705200539,57,67,78,51,50,38,15,8,341,23,364,6.318681318681318
16905,330455705200540,6,17,6,9,7,5,8,9,50,17,67,25.37313432835821
16906,330455705200541,15,18,24,29,18,9,4,2,113,6,119,5.042016806722689
16907,330455705200542,15,24,16,19,13,10,3,3,97,6,103,5.825242718446602
16908,330455705200543,11,20,21,15,22,24,6,4,113,10,123,8.130081300813009
16909,330455705200544,14,25,24,16,16,14,11,11,109,22,131,16.793893129770993
16910,330455705200545,6,12,13,9,10,2,4,0,52,4,56,7.142857142857143
16911,330455705200546,23,19,27,15,22,18,8,9,124,17,141,12.056737588652481
16912,330455705200547,27,29,46,33,17,34,11,8,186,19,205,9.268292682926829
16913,330455705200548,25,27,23,27,22,13,4,7,137,11,148,7.4324324324324325
16914,330455705200549,28,40,34,47,38,20,17,12,207,29,236,12.288135593220339
16915,330455705200550,55,61,45,44,48,34,18,22,287,40,327,12.232415902140673
16916,330455705200551,93,140,158,74,86,68,46,24,619,70,689,10.159651669085632
16917,330455705200552,13,25,15,18,21,8,5,3,100,8,108,7.407407407407407
16918,330455705200553,116,141,166,134,121,68,32,16,746,48,794,6.045340050377834
16919,330455705200554,27,27,32,21,23,13,3,1,143,4,147,2.7210884353741496
16920,330455705200555,175,160,157,125,105,85,44,22,807,66,873,7.560137457044673
16921,330455705200556,66,87,91,69,62,52,11,14,427,25,452,5.530973451327434
16922,330455705200557,136,107,131,84,65,69,38,27,592,65,657,9.89345509893455
16923,330455705200558,73,104,94,72,65,48,33,23,456,56,512,10.9375
16924,330455705200559,101,147,115,91,81,80,37,16,615,53,668,7.934131736526946
16925,330455705200560,43,51,66,56,46,46,32,25,308,57,365,15.616438356164384
16926,330455705200561,88,108,99,96,98,65,27,12,554,39,593,6.57672849915683
16927,330455705200562,128,131,179,140,116,116,83,53,810,136,946,14.376321353065538
16928,330455705200563,21,30,25,20,16,26,9,7,138,16,154,10.38961038961039
16929,330455705200564,16,25,25,19,14,10,11,4,109,15,124,12.096774193548388
16930,330455705200565,41,53,38,48,27,33,11,8,240,19,259,7.335907335907336
16931,330455705200566,91,85,61,62,56,49,13,11,404,24,428,5.607476635514018
16932,330455705200567,236,271,241,219,172,132,61,52,1271,113,1384,8.164739884393063
16933,330455705200568,144,137,137,138,96,93,55,38,745,93,838,11.097852028639618
16934,330455705200569,75,61,62,64,44,46,21,20,352,41,393,10.432569974554708
16935,330455705200570,73,98,102,76,81,88,35,42,518,77,595,12.941176470588236
16936,330455705200571,64,68,61,47,26,30,8,2,296,10,306,3.2679738562091503
16937,330455705200572,186,181,161,148,111,70,27,16,857,43,900,4.777777777777778
16938,330455705200573,91,97,63,69,36,29,19,4,385,23,408,5.637254901960785
16939,330455705200574,13,16,26,10,15,7,2,5,87,7,94,7.446808510638298
16940,330455705200575,94,113,92,97,57,52,20,15,505,35,540,6.481481481481482
16941,330455705200576,32,25,49,47,37,48,39,50,238,89,327,27.217125382262996
16942,330455705200585,41,37,45,37,36,19,10,7,215,17,232,7.327586206896552
16943,330455705200586,20,30,35,16,21,22,17,16,144,33,177,18.64406779661017
16944,330455705200587,2,10,8,7,8,9,6,3,44,9,53,16.9811320754717
16945,330455705200588,36,43,40,29,27,29,14,8,204,22,226,9.734513274336283
16946,330455705210001,26,43,62,50,47,56,44,27,284,71,355,20.0
16947,330455705210002,49,80,113,132,94,120,86,102,588,188,776,24.22680412371134
16948,330455705210003,61,68,129,94,92,116,58,58,560,116,676,17.159763313609467
16949,330455705210004,49,82,116,112,102,98,74,62,559,136,695,19.568345323741006
16950,330455705210005,25,41,73,74,46,66,49,45,325,94,419,22.43436754176611
16951,330455705210006,49,62,73,66,93,81,57,46,424,103,527,19.54459203036053
16952,330455705210007,43,65,68,64,92,100,62,63,432,125,557,22.44165170556553
16953,330455705210008,100,89,165,196,138,113,71,45,801,116,917,12.649945474372956
16954,330455705210009,121,120,144,208,148,140,83,55,881,138,1019,13.54268891069676
16955,330455705210010,95,107,123,111,139,88,66,58,663,124,787,15.756035578144854
16956,330455705210011,166,192,111,232,236,108,41,30,1045,71,1116,6.362007168458781
16957,330455705210012,98,106,171,164,127,131,46,17,797,63,860,7.325581395348837
16958,330455705210013,55,72,87,91,88,93,40,29,486,69,555,12.432432432432432
16959,330455705210014,72,100,159,113,102,123,65,32,669,97,766,12.663185378590079
16960,330455705210015,69,101,98,99,121,79,45,38,567,83,650,12.76923076923077
16961,330455705210016,51,53,80,85,72,66,34,16,407,50,457,10.940919037199125
16962,330455705210017,100,107,114,169,152,102,77,42,744,119,863,13.789107763615295
16963,330455705210018,58,71,109,128,106,100,44,39,572,83,655,12.67175572519084
16964,330455705210019,97,111,107,126,135,123,61,33,699,94,793,11.853720050441362
16965,330455705210020,71,73,83,116,75,75,58,31,493,89,582,15.292096219931272
16966,330455705210021,44,61,91,84,74,87,39,32,441,71,512,13.8671875
16967,330455705210022,109,117,137,135,166,126,78,73,790,151,941,16.046758767268862
16968,330455705210023,62,86,99,97,94,90,70,68,528,138,666,20.72072072072072
16969,330455705210024,121,138,193,160,145,137,56,59,894,115,1009,11.397423191278493
16970,330455705210025,77,85,112,76,65,43,22,4,458,26,484,5.371900826446281
16971,330455705210026,15,26,40,44,39,49,44,45,213,89,302,29.47019867549669
16972,330455705210027,74,68,116,129,78,101,116,90,566,206,772,26.683937823834196
16973,330455705210028,46,66,100,126,84,105,94,104,527,198,725,27.310344827586206
16974,330455705210029,47,77,94,95,81,99,69,96,493,165,658,25.075987841945288
16975,330455705210030,77,101,100,143,144,135,98,99,700,197,897,21.962095875139354
16976,330455705210031,52,61,111,81,94,89,56,86,488,142,630,22.53968253968254
16977,330455705210032,55,80,103,83,67,84,58,45,472,103,575,17.91304347826087
16978,330455705210033,55,83,74,100,90,70,62,44,472,106,578,18.33910034602076
16979,330455705210034,118,111,190,207,171,132,76,72,929,148,1077,13.741875580315691
16980,330455705210035,91,105,130,140,123,114,42,49,703,91,794,11.46095717884131
16981,330455705210036,128,123,175,185,145,156,101,106,912,207,1119,18.498659517426272
16982,330455705210037,56,64,115,103,87,123,85,52,548,137,685,20.0
16983,330455705210038,36,26,68,97,46,64,39,36,337,75,412,18.203883495145632
16984,330455705210039,55,83,106,119,121,115,88,81,599,169,768,22.005208333333332
16985,330455705210040,33,53,36,41,39,43,27,32,245,59,304,19.407894736842106
16986,330455705210041,41,68,62,63,54,73,50,33,361,83,444,18.693693693693692
16987,330455705210042,124,203,207,157,211,139,70,32,1041,102,1143,8.923884514435695
16988,330455705210043,104,146,134,139,168,118,56,34,809,90,899,10.011123470522802
16989,330455705210044,37,51,85,79,89,79,42,27,420,69,489,14.110429447852761
16990,330455705210045,62,78,101,96,81,89,58,62,507,120,627,19.138755980861244
16991,330455705210046,84,153,126,131,165,120,50,40,779,90,869,10.356731875719218
16992,330455705210047,75,91,98,124,104,96,79,50,588,129,717,17.99163179916318
16993,330455705210048,57,101,137,120,112,151,73,69,678,142,820,17.317073170731707
16994,330455705210049,127,158,129,216,200,123,70,89,953,159,1112,14.298561151079136
16995,330455705210050,68,98,111,90,104,109,69,81,580,150,730,20.54794520547945
16996,330455705210051,62,105,107,116,123,127,85,78,640,163,803,20.298879202988793
16997,330455705210052,62,99,130,127,105,151,77,72,674,149,823,18.1044957472661
16998,330455705210053,64,88,117,131,103,115,99,84,618,183,801,22.846441947565545
16999,330455705210054,69,109,142,125,118,154,87,56,717,143,860,16.627906976744185
17000,330455705210055,47,90,120,77,92,103,66,39,529,105,634,16.561514195583594
17001,330455705210056,76,79,130,131,121,106,67,42,643,109,752,14.49468085106383
17002,330455705210057,30,17,39,41,30,39,26,15,196,41,237,17.29957805907173
17003,330455705210058,89,108,158,154,129,163,94,56,801,150,951,15.772870662460567
17004,330455705210059,79,131,210,170,176,202,95,73,968,168,1136,14.788732394366198
17005,330455705210060,60,61,78,94,75,69,61,43,437,104,541,19.22365988909427
17006,330455705210061,39,62,71,86,79,48,59,34,385,93,478,19.456066945606693
17007,330455705210062,45,48,104,81,61,76,69,67,415,136,551,24.682395644283122
17008,330455705210063,38,54,82,82,64,70,58,56,390,114,504,22.61904761904762
17009,330455705210064,63,88,126,125,104,117,84,60,623,144,767,18.77444589308996
17010,330455705210065,55,93,92,92,93,92,77,73,517,150,667,22.488755622188904
17011,330455705210066,63,89,142,136,106,141,101,54,677,155,832,18.629807692307693
17012,330455705210067,78,104,115,113,123,122,69,80,655,149,804,18.53233830845771
17013,330455705210068,69,103,156,144,115,123,66,43,710,109,819,13.30891330891331
17014,330455705210069,82,95,128,115,112,89,28,25,621,53,674,7.863501483679525
17015,330455705210070,66,112,102,137,120,76,32,27,613,59,672,8.779761904761905
17016,330455705210071,53,82,101,86,73,67,49,33,462,82,544,15.073529411764707
17017,330455705210072,64,129,109,89,150,116,53,38,657,91,748,12.165775401069519
17018,330455705210073,120,172,152,167,152,114,93,80,877,173,1050,16.476190476190474
17019,330455705210074,64,75,72,107,89,76,84,50,483,134,617,21.71799027552674
17020,330455705210075,130,177,193,158,151,132,69,60,941,129,1070,12.05607476635514
17021,330455705210076,132,179,237,175,142,101,58,33,966,91,1057,8.609271523178808
17022,330455705210077,108,149,158,157,129,82,60,36,783,96,879,10.921501706484642
17023,330455705210078,239,254,269,270,228,188,98,70,1448,168,1616,10.396039603960396
17024,330455705210079,44,60,62,73,68,56,33,28,363,61,424,14.38679245283019
17025,330455705210080,41,45,35,53,44,36,25,30,254,55,309,17.79935275080906
17026,330455705210081,93,109,114,109,108,82,65,38,615,103,718,14.345403899721449
17027,330455705210082,100,135,169,127,162,114,71,53,807,124,931,13.319011815252416
17028,330455705210083,124,144,171,143,146,145,102,73,873,175,1048,16.698473282442748
17029,330455705210084,74,74,77,73,48,28,13,7,374,20,394,5.0761421319796955
17030,330455705210085,94,127,120,132,125,114,62,64,712,126,838,15.035799522673031
17031,330455705210086,119,172,187,177,152,142,92,54,949,146,1095,13.333333333333334
17032,330455705210087,107,384,360,226,286,146,76,60,1509,136,1645,8.267477203647417
17033,330455705210088,79,123,138,152,116,110,71,55,718,126,844,14.928909952606634
17034,330455705210089,49,73,130,87,111,91,54,61,541,115,656,17.53048780487805
17035,330455705210090,68,86,114,87,117,122,76,72,594,148,742,19.946091644204852
17036,330455705210091,70,67,92,109,77,72,99,74,487,173,660,26.21212121212121
17037,330455705210092,55,58,125,101,79,74,80,64,492,144,636,22.641509433962263
17038,330455705210093,40,62,63,92,79,63,63,67,399,130,529,24.574669187145556
17039,330455705210094,55,97,114,94,91,91,72,81,542,153,695,22.014388489208635
17040,330455705210095,45,80,96,71,99,104,71,72,495,143,638,22.413793103448278
17041,330455705210096,117,165,201,189,185,163,112,112,1020,224,1244,18.006430868167204
17042,330455705210097,71,88,112,110,109,97,56,71,587,127,714,17.787114845938376
17043,330455705210098,40,74,121,84,89,137,69,95,545,164,709,23.1311706629055
17044,330455705210099,37,52,68,72,80,74,55,69,383,124,507,24.45759368836292
17045,330455705210100,28,33,52,70,42,36,24,16,261,40,301,13.289036544850498
17046,330455705210101,65,98,110,94,101,124,68,59,592,127,719,17.663421418636997
17047,330455705210102,59,71,98,75,95,95,62,61,493,123,616,19.967532467532468
17048,330455705210103,84,109,160,103,154,121,73,94,731,167,898,18.596881959910913
17049,330455705210104,73,109,153,130,102,129,66,43,696,109,805,13.540372670807454
17050,330455705210105,32,44,40,36,31,44,19,5,227,24,251,9.56175298804781
17051,330455705210106,62,83,111,115,113,109,51,56,593,107,700,15.285714285714286
17052,330455705210107,77,122,152,106,142,106,71,83,705,154,859,17.92782305005821
17053,330455705210108,65,112,120,108,100,113,62,58,618,120,738,16.260162601626018
17054,330455705210109,115,131,161,136,137,118,89,55,798,144,942,15.286624203821656
17055,330455705210110,126,149,192,170,164,171,99,62,972,161,1133,14.210061782877316
17056,330455705210111,20,31,35,31,30,32,28,20,179,48,227,21.145374449339208
17057,330455705210112,84,112,143,130,134,145,127,56,748,183,931,19.656283566058
17058,330455705210113,83,95,154,140,112,169,142,67,753,209,962,21.725571725571726
17059,330455705210114,39,80,94,99,109,113,100,71,534,171,705,24.25531914893617
17060,330455705210115,57,74,82,126,85,114,100,95,538,195,733,26.60300136425648
17061,330455705210116,59,83,134,119,93,115,98,72,603,170,773,21.99223803363519
17062,330455705210117,75,110,102,85,100,90,44,36,562,80,642,12.461059190031152
17063,330455705210118,55,88,73,109,84,82,44,29,491,73,564,12.943262411347519
17064,330455705210119,64,81,112,141,107,112,70,56,617,126,743,16.95827725437416
17065,330455705210120,66,71,63,68,43,34,13,13,345,26,371,7.008086253369272
17066,330455705210121,154,188,188,260,232,185,101,79,1207,180,1387,12.977649603460707
17067,330455705210122,146,150,195,171,165,138,75,66,965,141,1106,12.74864376130199
17068,330455705210123,178,211,176,218,172,85,41,22,1040,63,1103,5.7116953762466
17069,330455705210124,73,79,105,117,98,85,76,84,557,160,717,22.315202231520225
17070,330455705210125,77,116,158,139,106,141,85,104,737,189,926,20.41036717062635
17071,330455705210126,139,141,164,183,184,106,58,61,917,119,1036,11.486486486486486
17072,330455705210127,95,135,112,132,129,97,52,29,700,81,781,10.371318822023047
17073,330455705210128,65,66,79,99,131,79,46,23,519,69,588,11.73469387755102
17074,330455705210129,109,152,155,138,145,139,103,131,838,234,1072,21.828358208955223
17075,330455705210130,47,75,80,88,76,72,56,62,438,118,556,21.223021582733814
17076,330455705210131,139,333,306,190,245,159,80,67,1372,147,1519,9.67741935483871
17077,330455705210132,59,62,64,67,53,30,27,9,335,36,371,9.703504043126685
17078,330455705210133,307,315,341,292,229,117,40,27,1601,67,1668,4.016786570743405
17079,330455705210134,145,194,206,168,168,123,69,64,1004,133,1137,11.697449428320141
17080,330455705210135,88,108,136,133,118,118,78,64,701,142,843,16.844602609727165
17081,330455705210136,114,176,150,134,120,71,43,27,765,70,835,8.383233532934131
17082,330455705210137,119,159,136,139,135,87,48,31,775,79,854,9.250585480093676
17083,330455705210138,73,130,181,141,204,125,85,69,854,154,1008,15.277777777777779
17084,330455705210139,55,67,109,137,146,63,47,39,577,86,663,12.971342383107089
17085,330455705210140,75,112,151,93,124,107,54,41,662,95,757,12.549537648612946
17086,330455705210141,46,67,59,66,47,62,49,83,347,132,479,27.55741127348643
17087,330455705210142,92,101,114,110,107,65,36,30,589,66,655,10.076335877862595
17088,330455705210143,89,86,111,107,112,64,58,36,569,94,663,14.177978883861236
17089,330455705210144,8,3,4,8,3,2,0,0,28,0,28,0.0
17090,330455705210145,119,131,216,149,139,183,134,81,937,215,1152,18.663194444444443
17091,330455705210146,102,141,147,107,126,119,46,44,742,90,832,10.817307692307692
17092,330455705210147,29,38,37,36,45,38,20,18,223,38,261,14.559386973180077
17093,330455705210148,128,144,199,174,139,129,71,54,913,125,1038,12.042389210019268
17094,330455705210149,111,128,137,115,130,75,63,44,696,107,803,13.325031133250311
17095,330455705210150,101,142,160,154,135,142,66,71,834,137,971,14.109165808444903
17096,330455705210151,91,127,94,92,84,44,28,16,532,44,576,7.638888888888889
17097,330455705210152,68,63,76,86,76,48,37,22,417,59,476,12.394957983193278
17098,330455705210153,39,69,63,55,46,56,30,15,328,45,373,12.064343163538874
17099,330455705210154,97,123,130,139,159,138,81,53,786,134,920,14.565217391304348
17100,330455705210155,66,79,69,56,35,28,13,6,333,19,352,5.3977272727272725
17101,330455705210156,70,86,101,98,90,89,58,53,534,111,645,17.209302325581394
17102,330455705210157,53,66,103,93,104,122,66,35,541,101,642,15.73208722741433
17103,330455705210158,92,124,137,139,132,110,49,57,734,106,840,12.619047619047619
17104,330455705210159,88,141,149,162,170,138,84,58,848,142,990,14.343434343434344
17105,330455705210160,53,50,62,72,53,67,30,31,357,61,418,14.5933014354067
17106,330455705210161,108,146,141,145,138,131,75,77,809,152,961,15.816857440166494
17107,330455705210162,146,203,198,180,124,95,58,41,946,99,1045,9.473684210526315
17108,330455705210163,84,104,124,145,111,104,66,73,672,139,811,17.13933415536375
17109,330455705210164,60,76,91,96,92,75,46,50,490,96,586,16.38225255972696
17110,330455705210165,74,98,152,136,120,95,62,73,675,135,810,16.666666666666668
17111,330455705210166,72,111,99,117,105,80,73,73,584,146,730,20.0
17112,330455705210167,21,26,42,42,30,64,40,30,225,70,295,23.728813559322035
17113,330455705210168,29,39,58,59,52,65,34,27,302,61,363,16.804407713498623
17114,330455705210169,194,226,238,297,247,195,111,94,1397,205,1602,12.796504369538077
17115,330455705210170,96,105,109,86,133,89,56,60,618,116,734,15.803814713896458
17116,330455705210171,153,151,195,231,164,85,50,43,979,93,1072,8.675373134328359
17117,330455705210172,117,152,165,172,135,117,61,70,858,131,989,13.245702730030334
17118,330455705210173,71,138,186,130,150,106,93,83,781,176,957,18.39080459770115
17119,330455705210174,42,46,77,55,55,81,52,33,356,85,441,19.27437641723356
17120,330455705210175,28,17,43,47,34,33,37,29,202,66,268,24.62686567164179
17121,330455705210176,43,81,90,77,92,85,67,93,468,160,628,25.477707006369428
17122,330455705210177,68,93,119,115,119,108,69,77,622,146,768,19.010416666666668
17123,330455705210178,26,23,42,47,39,38,28,39,215,67,282,23.75886524822695
17124,330455705210179,20,33,41,42,41,36,21,25,213,46,259,17.76061776061776
17125,330455705210180,93,132,127,113,115,112,62,74,692,136,828,16.42512077294686
17126,330455705210181,78,115,121,121,118,117,92,107,670,199,869,22.89988492520138
17127,330455705210182,125,148,146,201,137,110,45,40,867,85,952,8.928571428571429
17128,330455705210183,98,126,158,152,148,141,84,55,823,139,962,14.44906444906445
17129,330455705210184,61,87,120,92,95,92,64,53,547,117,664,17.620481927710845
17130,330455705210185,61,92,110,110,98,84,48,38,555,86,641,13.41653666146646
17131,330455705210186,42,57,52,68,58,64,40,30,341,70,411,17.0316301703163
17132,330455705210187,92,95,76,42,65,80,72,86,450,158,608,25.986842105263158
17133,330455705210188,156,218,234,189,226,172,104,96,1195,200,1395,14.336917562724015
17134,330455705210189,88,103,104,129,99,83,55,26,606,81,687,11.790393013100436
17135,330455705210190,116,162,165,136,162,147,63,78,888,141,1029,13.70262390670554
17136,330455705210191,38,91,90,68,79,74,34,19,440,53,493,10.75050709939148
17137,330455705210192,97,134,181,112,155,160,103,54,839,157,996,15.763052208835342
17138,330455705210193,42,96,135,72,117,125,69,57,587,126,713,17.67180925666199
17139,330455705210194,82,89,138,118,102,113,55,53,642,108,750,14.4
17140,330455705210195,97,120,171,152,158,129,74,51,827,125,952,13.130252100840336
17141,330455705210196,126,185,194,184,183,144,79,62,1016,141,1157,12.186689714779602
17142,330455705210197,118,154,98,123,78,59,39,10,630,49,679,7.216494845360825
17143,330455705210198,188,208,170,140,107,102,35,17,915,52,967,5.377456049638056
17144,330455705210199,121,155,143,128,119,85,60,31,751,91,842,10.807600950118765
17145,330455705210200,59,65,93,91,62,38,13,11,408,24,432,5.555555555555555
17146,330455705210201,64,53,62,53,39,41,14,5,312,19,331,5.740181268882175
17147,330455705210202,43,41,63,58,18,22,20,4,245,24,269,8.921933085501859
17148,330455705210203,78,73,83,58,63,40,10,2,395,12,407,2.9484029484029484
17149,330455705210204,62,80,92,75,71,56,59,38,436,97,533,18.19887429643527
17150,330455705210205,153,141,174,157,120,102,70,67,847,137,984,13.922764227642276
17151,330455705210206,71,78,126,131,97,87,61,62,590,123,713,17.251051893408135
17152,330455705210207,90,100,103,109,100,94,52,88,596,140,736,19.02173913043478
17153,330455705210208,183,206,202,267,219,136,86,71,1213,157,1370,11.459854014598541
17154,330455705210209,87,107,130,140,138,141,79,84,743,163,906,17.991169977924944
17155,330455705210210,95,125,146,166,151,137,80,112,820,192,1012,18.972332015810277
17156,330455705210211,132,198,231,236,224,170,127,95,1191,222,1413,15.711252653927813
17157,330455705210212,80,83,106,94,98,68,47,50,529,97,626,15.495207667731629
17158,330455705210213,45,70,72,48,48,42,17,6,325,23,348,6.609195402298851
17159,330455705210214,73,71,71,66,62,48,33,14,391,47,438,10.730593607305936
17160,330455705210215,152,189,199,201,174,145,51,64,1060,115,1175,9.787234042553191
17161,330455705210216,44,51,39,29,40,12,8,6,215,14,229,6.11353711790393
17162,330455705210217,152,228,230,194,239,195,107,78,1238,185,1423,13.000702740688686
17163,330455705210218,108,170,141,210,170,192,107,70,991,177,1168,15.154109589041095
17164,330455705210219,84,109,129,134,160,123,94,111,739,205,944,21.716101694915253
17165,330455705210220,48,85,114,112,116,95,94,82,570,176,746,23.592493297587133
17166,330455705210221,87,102,99,145,138,110,64,83,681,147,828,17.753623188405797
17167,330455705210222,180,167,193,252,231,191,117,103,1214,220,1434,15.341701534170154
17168,330455705210223,55,111,122,106,119,127,86,67,640,153,793,19.293820933165197
17169,330455705210224,94,121,140,186,164,159,118,70,864,188,1052,17.870722433460077
17170,330455705210225,30,36,70,60,61,75,50,26,332,76,408,18.627450980392158
17171,330455705210226,61,89,132,120,136,137,86,40,675,126,801,15.730337078651685
17172,330455705210227,49,98,134,112,95,151,91,66,639,157,796,19.723618090452263
17173,330455705210228,91,141,158,148,170,154,87,84,862,171,1033,16.55372700871249
17174,330455705210229,59,77,82,84,89,92,55,49,483,104,587,17.717206132879046
17175,330455705210230,39,63,81,86,65,54,38,35,388,73,461,15.835140997830802
17176,330455705210231,36,54,73,63,74,75,61,62,375,123,498,24.698795180722893
17177,330455705210232,65,101,102,112,106,96,79,75,582,154,736,20.92391304347826
17178,330455705210233,41,74,89,84,90,101,65,72,479,137,616,22.24025974025974
17179,330455705210234,49,69,80,80,101,83,65,60,462,125,587,21.29471890971039
17180,330455705210235,88,111,149,129,142,143,98,86,762,184,946,19.45031712473573
17181,330455705210236,74,94,138,115,143,153,94,96,717,190,907,20.948180815876515
17182,330455705210237,55,80,95,79,102,109,72,67,520,139,659,21.09256449165402
17183,330455705210238,115,169,168,200,211,147,93,74,1010,167,1177,14.188615123194563
17184,330455705210239,46,60,76,56,78,85,52,52,401,104,505,20.594059405940595
17185,330455705210240,49,43,49,65,58,50,44,50,314,94,408,23.03921568627451
17186,330455705210241,62,93,115,114,108,141,85,90,633,175,808,21.65841584158416
17187,330455705210242,60,101,124,119,104,126,81,83,634,164,798,20.551378446115287
17188,330455705210243,85,108,130,127,138,136,81,87,724,168,892,18.83408071748879
17189,330455705210244,66,50,114,89,76,67,60,50,462,110,572,19.23076923076923
17190,330455705210245,94,132,144,119,118,115,70,80,722,150,872,17.201834862385322
17191,330455705210246,89,107,144,131,150,130,89,108,751,197,948,20.780590717299578
17192,330455705210247,75,91,120,110,114,137,68,63,647,131,778,16.838046272493575
17193,330455705210248,65,97,89,104,108,103,53,61,566,114,680,16.764705882352942
17194,330455705210249,56,59,74,46,57,41,13,14,333,27,360,7.5
17195,330455705210250,76,125,82,74,56,39,20,19,452,39,491,7.942973523421589
17196,330455705210251,107,146,176,158,148,140,98,93,875,191,1066,17.917448405253282
17197,330455705210252,48,54,76,91,78,71,40,38,418,78,496,15.725806451612904
17198,330455705210253,104,124,146,135,129,112,82,86,750,168,918,18.30065359477124
17199,330455705210254,74,87,89,105,96,126,74,51,577,125,702,17.806267806267805
17200,330455705210255,108,156,141,139,146,143,78,86,833,164,997,16.449348044132396
17201,330455705210256,71,85,138,98,73,78,40,24,543,64,607,10.543657331136737
17202,330455705210257,96,131,160,124,104,126,60,63,741,123,864,14.23611111111111
17203,330455705210258,100,137,119,95,86,54,34,24,591,58,649,8.936825885978429
17204,330455705210259,123,145,144,127,122,84,52,47,745,99,844,11.729857819905213
17205,330455705210260,101,127,157,173,137,101,48,39,796,87,883,9.85277463193658
17206,330455705210261,73,90,101,91,97,79,70,62,531,132,663,19.90950226244344
17207,330455705210262,66,86,112,104,112,116,79,68,596,147,743,19.784656796769852
17208,330455705210263,75,90,117,140,103,129,98,91,654,189,843,22.419928825622776
17209,330455705210264,57,91,133,70,103,105,61,64,559,125,684,18.27485380116959
17210,330455705210265,78,110,133,138,132,111,68,57,702,125,827,15.114873035066505
17211,330455705210266,64,86,123,92,109,131,73,72,605,145,750,19.333333333333332
17212,330455705210267,78,105,113,112,118,114,83,83,640,166,806,20.595533498759306
17213,330455705210268,89,137,166,118,136,129,88,77,775,165,940,17.5531914893617
17214,330455705210269,79,71,47,58,37,20,16,7,312,23,335,6.865671641791045
17215,330455705210270,66,95,117,124,143,163,104,117,708,221,929,23.78902045209903
17216,330455705210271,47,67,67,73,71,80,35,30,405,65,470,13.829787234042554
17217,330455705210272,44,51,69,70,61,56,45,43,351,88,439,20.045558086560366
17218,330455705210273,54,104,102,104,123,118,82,157,605,239,844,28.317535545023695
17219,330455705210274,82,111,138,143,133,126,87,57,733,144,877,16.419612314709237
17220,330455705210275,42,46,62,55,60,54,53,70,319,123,442,27.828054298642535
17221,330455705210276,34,32,70,69,47,90,71,56,342,127,469,27.078891257995735
17222,330455705210277,32,45,61,56,68,63,64,60,325,124,449,27.616926503340757
17223,330455705210278,39,66,97,90,82,102,95,113,476,208,684,30.4093567251462
17224,330455705210279,126,106,150,262,151,119,100,102,914,202,1116,18.100358422939067
17225,330455705210280,49,91,112,99,131,110,111,134,592,245,837,29.27120669056153
17226,330455705210281,140,100,154,188,164,168,110,121,914,231,1145,20.17467248908297
17227,330455705210282,101,98,139,160,146,149,99,108,793,207,1000,20.7
17228,330455705210283,73,78,123,109,73,115,75,84,571,159,730,21.78082191780822
17229,330455705210284,85,101,131,122,106,104,61,66,649,127,776,16.3659793814433
17230,330455705210285,122,97,101,80,60,46,24,15,506,39,545,7.155963302752293
17231,330455705210286,112,151,121,114,113,89,40,50,700,90,790,11.39240506329114
17232,330455705210287,66,85,49,50,52,25,10,8,327,18,345,5.217391304347826
17233,330455705210288,129,164,125,103,84,36,20,11,641,31,672,4.613095238095238
17234,330455705210289,113,147,194,163,146,114,87,80,877,167,1044,15.996168582375478
17235,330455705210290,50,42,54,31,29,33,24,6,239,30,269,11.152416356877323
17236,330455705210291,69,80,61,61,34,22,14,14,327,28,355,7.887323943661972
17237,330455705210292,56,69,68,50,49,31,14,6,323,20,343,5.830903790087463
17238,330455705210293,68,82,75,75,45,47,39,20,392,59,451,13.082039911308204
17239,330455705210294,116,119,101,109,81,36,27,15,562,42,604,6.953642384105961
17240,330455705210295,199,240,143,184,138,103,45,16,1007,61,1068,5.711610486891386
17241,330455705210296,58,62,70,44,40,36,15,6,310,21,331,6.3444108761329305
17242,330455705210297,59,107,67,120,80,41,30,18,474,48,522,9.195402298850574
17243,330455705210298,56,91,90,118,93,86,65,64,534,129,663,19.457013574660632
17244,330455705210299,77,130,146,145,131,120,101,93,749,194,943,20.572640509013787
17245,330455705210300,24,63,85,110,94,84,35,44,460,79,539,14.656771799628942
17246,330455705210301,79,105,105,96,103,101,55,136,589,191,780,24.487179487179485
17247,330455705210302,115,124,147,170,146,135,97,241,837,338,1175,28.76595744680851
17248,330455705210303,46,54,75,77,63,63,52,53,378,105,483,21.73913043478261
17249,330455705210304,33,35,54,70,44,61,52,41,297,93,390,23.846153846153847
17250,330455705210305,78,104,107,102,122,94,61,82,607,143,750,19.066666666666666
17251,330455705210306,28,71,61,59,95,71,45,124,385,169,554,30.505415162454874
17252,330455705210307,38,72,76,47,68,90,28,52,391,80,471,16.985138004246284
17253,330455705210308,70,98,81,102,90,87,72,80,528,152,680,22.352941176470587
17254,330455705210309,45,71,77,81,79,79,73,70,432,143,575,24.869565217391305
17255,330455705210310,74,106,137,121,134,122,113,127,694,240,934,25.69593147751606
17256,330455705210311,35,55,90,63,80,63,67,81,386,148,534,27.715355805243444
17257,330455705210312,79,109,119,126,127,120,100,98,680,198,878,22.55125284738041
17258,330455705210313,96,94,136,163,115,124,95,99,728,194,922,21.0412147505423
17259,330455705210314,82,130,129,129,146,129,79,136,745,215,960,22.395833333333332
17260,330455705210315,55,82,131,105,103,134,75,66,610,141,751,18.77496671105193
17261,330455705210316,105,95,120,134,120,92,46,68,666,114,780,14.615384615384615
17262,330455705210317,131,140,156,170,150,146,82,62,893,144,1037,13.886210221793636
17263,330455705210318,68,72,87,71,84,82,52,116,464,168,632,26.582278481012658
17264,330455705210319,97,94,97,97,59,51,30,13,495,43,538,7.992565055762082
17265,330455705210320,78,91,68,70,63,36,20,14,406,34,440,7.7272727272727275
17266,330455705210321,129,145,121,121,79,78,41,29,673,70,743,9.421265141318978
17267,330455705210322,182,190,167,179,119,82,26,21,919,47,966,4.865424430641822
17268,330455705210323,60,111,98,105,93,77,50,33,544,83,627,13.237639553429027
17269,330455705210324,82,65,89,84,59,27,24,10,406,34,440,7.7272727272727275
17270,330455705210325,75,97,94,91,84,62,32,16,503,48,551,8.711433756805807
17271,330455705210326,155,205,215,285,228,186,117,102,1274,219,1493,14.668452779638312
17272,330455705210327,123,121,157,136,116,120,55,56,773,111,884,12.55656108597285
17273,330455705210328,179,198,258,247,218,203,100,80,1303,180,1483,12.137559002022927
17274,330455705210329,82,124,105,151,107,129,95,60,698,155,853,18.17116060961313
17275,330455705210330,57,81,95,78,98,119,62,89,528,151,679,22.23858615611193
17276,330455705210331,43,52,86,66,76,79,44,64,402,108,510,21.176470588235293
17277,330455705210332,110,129,132,99,102,75,46,25,647,71,718,9.88857938718663
17278,330455705210333,91,97,103,62,84,61,25,17,498,42,540,7.777777777777778
17279,330455705210334,192,226,190,143,156,110,33,28,1017,61,1078,5.658627087198516
17280,330455705210335,96,104,114,94,61,42,17,8,511,25,536,4.664179104477612
17281,330455705210336,152,219,151,150,93,42,16,4,807,20,827,2.418379685610641
17282,330455705210337,286,255,195,185,115,49,10,5,1085,15,1100,1.3636363636363635
17283,330455705210338,91,97,103,118,87,59,50,29,555,79,634,12.46056782334385
17284,330455705210339,166,149,175,129,100,95,48,30,814,78,892,8.74439461883408
17285,330455705210340,125,146,114,106,96,75,27,18,662,45,707,6.364922206506365
17286,330455705210341,65,87,103,120,128,129,86,67,632,153,785,19.49044585987261
17287,330455705210342,32,69,100,69,85,111,63,48,466,111,577,19.23743500866551
17288,330455705210343,60,63,77,101,83,74,54,43,458,97,555,17.47747747747748
17289,330455705210344,92,82,66,114,106,70,36,28,530,64,594,10.774410774410775
17290,330455705210345,72,70,123,125,114,93,53,37,597,90,687,13.100436681222707
17291,330455705210346,122,133,127,195,154,127,68,53,858,121,979,12.359550561797754
17292,330455705210347,105,128,156,182,158,140,104,58,869,162,1031,15.712900096993211
17293,330455705210348,139,132,153,218,179,137,79,60,958,139,1097,12.670920692798541
17294,330455705210349,138,135,208,152,181,133,107,84,947,191,1138,16.783831282952548
17295,330455705210350,72,104,146,110,143,138,85,74,713,159,872,18.23394495412844
17296,330455705210351,90,107,118,127,126,84,74,48,652,122,774,15.762273901808786
17297,330455705210352,74,69,92,90,98,61,37,25,484,62,546,11.355311355311356
17298,330455705210353,98,158,178,159,174,144,77,61,911,138,1049,13.15538608198284
17299,330455705210354,22,44,66,69,61,48,57,65,310,122,432,28.24074074074074
17300,330455705210355,49,95,117,112,116,118,88,74,607,162,769,21.06631989596879
17301,330455705210356,55,65,82,94,94,70,53,66,460,119,579,20.552677029360968
17302,330455705210357,31,42,69,40,58,78,37,64,318,101,419,24.105011933174225
17303,330455705210358,40,76,114,91,92,85,44,54,498,98,596,16.44295302013423
17304,330455705210359,56,65,81,71,115,61,36,31,449,67,516,12.984496124031008
17305,330455705210360,65,98,158,89,135,174,113,66,719,179,898,19.933184855233854
17306,330455705210361,46,55,65,84,76,67,30,33,393,63,456,13.81578947368421
17307,330455705210362,47,70,83,79,72,87,53,67,438,120,558,21.50537634408602
17308,330455705210363,57,87,89,82,86,87,59,57,488,116,604,19.205298013245034
17309,330455705210364,83,103,135,123,156,145,97,87,745,184,929,19.806243272335845
17310,330455705210365,77,90,135,137,117,149,100,85,705,185,890,20.786516853932586
17311,330455705210366,67,89,118,113,134,94,103,122,615,225,840,26.785714285714285
17312,330455705210367,57,52,42,90,67,36,22,8,344,30,374,8.02139037433155
17313,330455705210368,44,79,69,105,84,56,87,72,437,159,596,26.677852348993287
17314,330455705210369,38,45,105,79,69,66,75,88,402,163,565,28.849557522123895
17315,330455705210370,47,73,96,110,92,84,66,89,502,155,657,23.59208523592085
17316,330455705210371,39,64,58,76,74,54,74,82,365,156,521,29.942418426103647
17317,330455705210372,52,76,87,99,99,83,56,60,496,116,612,18.954248366013072
17318,330455705210373,67,53,57,116,64,32,19,11,389,30,419,7.159904534606206
17319,330455705210374,250,258,375,267,234,132,59,28,1516,87,1603,5.427323767935122
17320,330455705210375,103,148,102,108,97,78,40,20,636,60,696,8.620689655172415
17321,330455705210376,55,49,66,92,70,47,28,21,379,49,428,11.448598130841122
17322,330455705210377,35,70,108,62,78,99,76,89,452,165,617,26.74230145867099
17323,330455705210378,93,121,187,201,155,100,62,47,857,109,966,11.283643892339544
17324,330455705210379,121,130,121,208,175,136,74,44,891,118,1009,11.694747274529236
17325,330455705210380,148,164,145,243,227,165,84,45,1092,129,1221,10.565110565110565
17326,330455705210381,56,102,129,135,141,123,130,108,686,238,924,25.757575757575758
17327,330455705210382,44,44,50,68,51,63,50,58,320,108,428,25.233644859813083
17328,330455705210383,20,30,85,65,51,65,47,78,316,125,441,28.34467120181406
17329,330455705210384,57,121,116,76,122,129,84,123,621,207,828,25.0
17330,330455705210385,29,53,45,55,71,45,59,55,298,114,412,27.66990291262136
17331,330455705210386,37,73,92,77,80,87,64,59,446,123,569,21.61687170474517
17332,330455705210387,50,63,121,86,101,126,73,93,547,166,713,23.281907433380084
17333,330455705210388,27,25,53,61,45,53,37,42,264,79,343,23.03206997084548
17334,330455705210389,48,103,128,86,102,123,49,59,590,108,698,15.472779369627506
17335,330455705210390,154,116,173,242,183,131,84,70,999,154,1153,13.356461405030355
17336,330455705210391,29,31,42,42,49,60,55,15,253,70,323,21.671826625387
17337,330455705210392,80,99,122,133,104,127,74,74,665,148,813,18.204182041820417
17338,330455705210393,121,167,187,171,155,161,107,88,962,195,1157,16.853932584269664
17339,330455705210394,201,244,255,239,193,133,48,40,1265,88,1353,6.504065040650406
17340,330455705210395,53,44,83,85,75,70,52,63,410,115,525,21.904761904761905
17341,330455705210396,95,138,143,136,163,140,66,110,815,176,991,17.7598385469223
17342,330455705210397,54,81,91,105,127,67,42,47,525,89,614,14.495114006514658
17343,330455705210398,57,83,82,111,103,68,25,21,504,46,550,8.363636363636363
17344,330455705210399,39,53,70,55,54,54,30,24,325,54,379,14.248021108179419
17345,330455705210400,63,88,74,67,62,44,16,11,398,27,425,6.352941176470588
17346,330455705210401,111,171,158,160,178,127,93,66,905,159,1064,14.943609022556391
17347,330455705210402,67,92,97,96,127,91,69,91,570,160,730,21.91780821917808
17348,330455705210403,53,80,114,64,89,102,46,30,502,76,578,13.14878892733564
17349,330455705210404,161,247,186,155,145,88,39,23,982,62,1044,5.938697318007663
17350,330455705210405,202,280,212,187,178,118,48,29,1177,77,1254,6.140350877192983
17351,330455705210406,127,140,172,185,149,97,84,47,870,131,1001,13.086913086913087
17352,330455705210407,81,122,133,124,74,66,39,19,600,58,658,8.814589665653495
17353,330455705210408,73,85,98,119,104,68,38,14,547,52,599,8.681135225375627
17354,330455705210409,58,90,86,105,102,82,39,22,523,61,584,10.445205479452055
17355,330455705210410,44,53,63,82,63,61,38,22,366,60,426,14.084507042253522
17356,330455705210411,63,84,99,105,118,61,31,22,530,53,583,9.090909090909092
17357,330455705210412,44,50,34,50,61,38,19,4,277,23,300,7.666666666666667
17358,330455705210413,47,69,63,78,89,56,21,12,402,33,435,7.586206896551724
17359,330455705210414,52,67,62,74,75,45,25,10,375,35,410,8.536585365853659
17360,330455705210415,61,71,116,130,114,69,50,42,561,92,653,14.088820826952526
17361,330455705210417,226,254,331,439,331,257,146,123,1838,269,2107,12.766967252017086
17362,330455705210418,94,142,156,137,156,167,87,81,852,168,1020,16.470588235294116
17363,330455705210419,73,88,93,90,104,81,31,42,529,73,602,12.12624584717608
17364,330455705210420,67,103,111,106,138,103,99,81,628,180,808,22.277227722772277
17365,330455705210421,102,146,164,160,154,150,127,75,876,202,1078,18.738404452690165
17366,330455705210422,46,65,90,97,93,98,90,82,489,172,661,26.021180030257185
17367,330455705210423,96,135,122,169,160,174,92,82,856,174,1030,16.893203883495147
17368,330455705210424,112,128,155,160,152,159,68,57,866,125,991,12.613521695257315
17369,330455705210425,116,157,138,169,191,103,76,54,874,130,1004,12.94820717131474
17370,330455705210426,55,121,150,103,147,138,77,56,714,133,847,15.702479338842975
17371,330455705210427,56,85,106,115,111,116,91,86,589,177,766,23.10704960835509
17372,330455705210428,40,69,114,82,72,140,120,49,517,169,686,24.635568513119534
17373,330455705210429,65,131,165,98,150,159,86,41,768,127,895,14.189944134078212
17374,330455705210430,65,115,151,121,146,147,103,96,745,199,944,21.08050847457627
17375,330455705210431,54,110,92,89,113,101,53,77,559,130,689,18.867924528301888
17376,330455705210432,176,207,198,192,132,94,34,23,999,57,1056,5.3977272727272725
17377,330455705210433,106,139,146,102,104,56,44,26,653,70,723,9.681881051175656
17378,330455705210434,59,84,87,85,98,75,73,56,488,129,617,20.907617504051863
17379,330455705210435,64,84,108,118,95,83,52,52,552,104,656,15.853658536585366
17380,330455705210436,115,130,138,134,127,129,64,77,773,141,914,15.426695842450766
17381,330455705210437,105,157,198,185,175,174,109,88,994,197,1191,16.540722082283796
17382,330455705210438,14,16,70,74,41,40,36,20,255,56,311,18.006430868167204
17383,330455705210439,158,202,221,185,230,191,105,104,1187,209,1396,14.97134670487106
17384,330455705210441,106,124,207,185,147,136,105,79,905,184,1089,16.89623507805326
17385,330455705210442,33,59,62,110,164,52,29,10,480,39,519,7.514450867052023
17386,330455705210443,37,57,80,87,53,58,33,18,372,51,423,12.056737588652481
17387,330455705210444,1,2,0,2,1,3,1,0,9,1,10,10.0
17388,330455705210445,567,420,669,935,451,187,97,62,3229,159,3388,4.693034238488784
17389,330455705210446,105,120,137,92,78,56,23,18,588,41,629,6.518282988871224
17390,330455705210447,153,172,157,118,119,77,32,19,796,51,847,6.02125147579693
17391,330455705210448,104,115,132,122,56,30,20,7,559,27,586,4.607508532423208
17392,330455705210449,180,167,212,192,92,35,24,11,878,35,913,3.833515881708653
17393,330455705210450,162,155,287,231,136,77,35,27,1048,62,1110,5.585585585585585
17394,330455705210451,184,193,298,217,145,102,48,25,1139,73,1212,6.023102310231023
17395,330455705210452,142,176,173,190,128,108,68,53,917,121,1038,11.657032755298651
17396,330455705210453,133,129,239,189,116,98,39,35,904,74,978,7.566462167689162
17397,330455705210454,83,115,142,122,106,84,38,32,652,70,722,9.695290858725762
17398,330455705210455,126,152,182,159,156,131,85,82,906,167,1073,15.563839701770736
17399,330455705210456,109,139,189,173,115,104,34,42,829,76,905,8.397790055248619
17400,330455705210457,165,222,250,216,174,137,69,52,1164,121,1285,9.416342412451362
17401,330455705210458,60,64,100,91,64,45,28,16,424,44,468,9.401709401709402
17402,330455705210459,101,152,116,119,107,46,21,9,641,30,671,4.470938897168406
17403,330455705210460,187,227,226,195,130,85,35,26,1050,61,1111,5.4905490549054905
17404,330455705210461,86,131,111,116,74,40,19,12,558,31,589,5.2631578947368425
17405,330455705210462,259,265,413,303,245,157,51,21,1642,72,1714,4.200700116686114
17406,330455705210463,108,141,200,160,177,162,94,62,948,156,1104,14.130434782608695
17407,330455705210464,106,139,133,137,135,123,85,58,773,143,916,15.611353711790393
17408,330455705210465,88,112,149,152,138,110,81,75,749,156,905,17.23756906077348
17409,330455705210466,102,152,143,123,153,99,59,51,772,110,882,12.471655328798185
17410,330455705210467,202,194,193,133,126,89,35,17,937,52,989,5.25783619817998
17411,330455705210468,99,125,130,88,98,71,25,15,611,40,651,6.1443932411674345
17412,330455705210469,117,149,150,161,135,125,77,56,837,133,970,13.711340206185566
17413,330455705210470,117,144,157,144,112,107,77,49,781,126,907,13.891951488423373
17414,330455705210471,129,176,178,156,153,119,84,69,911,153,1064,14.3796992481203
17415,330455705210472,226,267,251,258,220,143,61,34,1365,95,1460,6.506849315068493
17416,330455705210473,184,216,275,286,214,193,101,93,1368,194,1562,12.419974391805377
17417,330455705210474,141,163,201,197,198,136,85,81,1036,166,1202,13.810316139767055
17418,330455705210475,76,108,125,137,107,89,57,66,642,123,765,16.07843137254902
17419,330455705210476,64,102,95,84,109,74,50,57,528,107,635,16.8503937007874
17420,330455705210477,154,172,199,201,206,154,99,73,1086,172,1258,13.672496025437201
17421,330455705210478,112,162,166,162,154,140,90,81,896,171,1067,16.026241799437674
17422,330455705210479,83,129,167,133,166,152,89,106,830,195,1025,19.024390243902438
17423,330455705210480,74,86,82,97,119,105,64,57,563,121,684,17.690058479532162
17424,330455705210481,64,80,118,99,96,88,52,54,545,106,651,16.282642089093702
17425,330455705210482,145,146,156,130,154,127,54,93,858,147,1005,14.626865671641792
17426,330455705210483,93,166,182,161,178,182,88,81,962,169,1131,14.942528735632184
17427,330455705210484,7,14,13,18,9,5,3,0,66,3,69,4.3478260869565215
17428,330455705210485,67,95,81,71,64,27,26,14,405,40,445,8.98876404494382
17429,330455705210486,97,135,134,109,96,69,41,25,640,66,706,9.34844192634561
17430,330455705210487,138,141,175,121,86,86,44,29,747,73,820,8.902439024390244
17431,330455705210488,94,154,127,120,140,101,53,51,736,104,840,12.380952380952381
17432,330455705210489,259,344,334,365,359,215,113,82,1876,195,2071,9.415741187831966
17433,330455705210490,144,200,223,189,239,150,98,66,1145,164,1309,12.52864782276547
17434,330455705210491,138,175,168,172,165,140,75,75,958,150,1108,13.537906137184116
17435,330455705210492,113,150,164,152,179,136,76,95,894,171,1065,16.056338028169016
17437,330455705210494,169,177,196,175,127,58,30,17,902,47,949,4.952581664910432
17438,330455705210495,76,97,78,78,64,42,24,5,435,29,464,6.25
17439,330455705210496,184,221,172,166,151,98,50,35,992,85,1077,7.892293407613742
17440,330455705210497,89,141,124,104,103,92,43,36,653,79,732,10.792349726775956
17441,330455705210498,272,336,279,266,226,122,91,59,1501,150,1651,9.085402786190187
17442,330455705210499,125,133,135,117,138,90,55,44,738,99,837,11.827956989247312
17443,330455705210500,106,104,95,110,60,56,38,66,531,104,635,16.37795275590551
17444,330455705210501,121,161,193,187,157,133,63,42,952,105,1057,9.933774834437086
17445,330455705210502,62,81,92,85,77,51,29,17,448,46,494,9.31174089068826
17446,330455705210503,109,160,146,140,197,139,65,44,891,109,1000,10.9
17447,330455705210504,53,74,103,82,102,107,59,139,521,198,719,27.538247566063976
17448,330455705210505,106,132,116,116,98,92,67,63,660,130,790,16.455696202531644
17449,330455705210506,61,92,73,57,71,53,19,13,407,32,439,7.289293849658314
17450,330455705210507,27,24,29,21,28,23,11,9,152,20,172,11.627906976744185
17451,330455705210508,68,72,60,82,38,38,23,15,358,38,396,9.595959595959595
17452,330455705210509,74,86,90,69,57,40,15,15,416,30,446,6.726457399103139
17453,330455705210510,177,172,138,107,82,66,27,14,742,41,783,5.236270753512133
17454,330455705210511,87,95,99,105,85,90,36,28,561,64,625,10.24
17455,330455705210512,150,191,245,210,222,173,103,61,1191,164,1355,12.103321033210332
17456,330455705210513,188,196,249,246,281,180,102,69,1340,171,1511,11.317008603573791
17457,330455705210514,94,101,97,102,88,84,52,76,566,128,694,18.443804034582133
17458,330455705210515,70,84,87,85,83,90,115,207,499,322,821,39.220462850182706
17459,330455705210516,119,114,144,149,120,96,29,29,742,58,800,7.25
17460,330455705210517,248,234,303,237,149,104,33,18,1275,51,1326,3.8461538461538463
17461,330455705210518,32,48,46,40,37,21,19,8,224,27,251,10.756972111553784
17462,330455705210519,286,310,323,259,180,119,62,31,1477,93,1570,5.923566878980892
17463,330455705210520,76,88,122,132,130,95,44,26,643,70,713,9.817671809256662
17464,330455705210521,40,83,129,110,90,74,32,30,526,62,588,10.54421768707483
17465,330455705210522,121,158,174,118,187,111,58,55,869,113,982,11.507128309572302
17466,330455705210523,61,126,162,122,158,143,59,41,772,100,872,11.46788990825688
17467,330455705210524,34,63,64,58,67,49,13,23,335,36,371,9.703504043126685
17468,330455705210525,27,58,106,60,82,109,45,43,442,88,530,16.60377358490566
17469,330455705210526,41,85,128,85,96,88,48,35,523,83,606,13.696369636963697
17470,330455705210527,45,36,101,56,55,85,29,19,378,48,426,11.267605633802816
17471,330455705210528,62,101,104,100,84,95,47,32,546,79,625,12.64
17472,330455705210529,54,55,118,94,55,107,78,43,483,121,604,20.033112582781456
17473,330455705210530,31,59,57,65,61,82,47,21,355,68,423,16.07565011820331
17474,330455705210531,90,129,172,155,128,138,78,64,812,142,954,14.884696016771489
17475,330455705210532,81,117,147,156,115,108,57,42,724,99,823,12.029161603888214
17476,330455705210533,41,74,62,68,85,62,16,16,392,32,424,7.547169811320755
17477,330455705210534,55,59,81,86,87,81,20,21,449,41,490,8.36734693877551
17478,330455705210535,77,88,136,121,90,64,24,25,576,49,625,7.84
17479,330455705210536,62,63,128,107,74,115,43,45,549,88,637,13.814756671899529
17480,330455705210537,52,66,103,103,77,83,44,20,484,64,548,11.678832116788321
17481,330455705210538,98,93,111,110,67,43,23,11,522,34,556,6.115107913669065
17482,330455705210539,54,73,108,99,109,65,22,19,508,41,549,7.468123861566484
17483,330455705210540,51,52,73,81,73,61,16,11,391,27,418,6.45933014354067
17484,330455705210541,18,15,15,19,13,15,12,13,95,25,120,20.833333333333332
17485,330455705210542,100,122,192,128,106,72,25,13,720,38,758,5.013192612137203
17486,330455705210543,35,59,65,42,63,34,13,7,298,20,318,6.289308176100629
17487,330455705210544,123,166,200,171,150,88,30,29,898,59,957,6.165099268547545
17488,330455705210545,93,96,131,213,109,79,49,19,721,68,789,8.61850443599493
17489,330455705210546,413,450,493,398,330,201,85,57,2285,142,2427,5.8508446641944785
17490,330455705210547,11,18,20,18,23,17,6,8,107,14,121,11.570247933884298
17491,330455705210548,13,11,13,13,8,5,5,1,63,6,69,8.695652173913043
17492,330455705210549,276,289,351,299,230,142,74,37,1587,111,1698,6.5371024734982335
17493,330455705210550,86,95,139,112,109,108,79,62,649,141,790,17.848101265822784
17494,330455705210551,114,111,110,164,95,99,76,61,693,137,830,16.50602409638554
17495,330455705210552,62,92,116,109,110,88,56,66,577,122,699,17.453505007153076
17496,330455705210553,202,229,196,188,170,106,58,37,1091,95,1186,8.010118043844857
17497,330455705210554,122,153,121,126,97,52,27,21,671,48,719,6.675938803894297
17498,330455705210555,92,81,81,51,48,29,10,3,382,13,395,3.2911392405063293
17499,330455705210556,245,230,246,247,154,132,88,55,1254,143,1397,10.236220472440944
17500,330455705210557,21,22,39,30,36,31,32,20,179,52,231,22.51082251082251
17501,330455705210558,563,440,393,365,217,126,52,24,2104,76,2180,3.4862385321100917
17502,330455705210559,164,171,174,177,126,82,22,12,894,34,928,3.663793103448276
17503,330455705210560,220,259,210,155,119,80,33,6,1043,39,1082,3.6044362292051755
17504,330455705210561,108,155,105,87,101,33,17,7,589,24,613,3.9151712887438825
17505,330455705210562,160,215,205,170,99,68,43,23,917,66,983,6.714140386571719
17507,330455705210565,152,158,202,158,106,57,16,8,833,24,857,2.8004667444574096
17508,330455705210566,128,101,172,124,70,41,13,7,636,20,656,3.048780487804878
17509,330455705210567,55,64,98,45,48,16,7,4,326,11,337,3.264094955489614
17510,330455705210568,126,132,205,157,83,45,16,8,748,24,772,3.1088082901554404
17511,330455705210569,146,139,242,144,91,34,9,3,796,12,808,1.4851485148514851
17512,330455705210570,126,154,235,161,64,33,10,6,773,16,789,2.0278833967046896
17513,330455705210571,151,191,285,164,84,30,7,7,905,14,919,1.5233949945593035
17514,330455705210572,199,201,330,214,93,31,8,4,1068,12,1080,1.1111111111111112
17515,330455705210573,134,114,271,132,77,49,12,1,777,13,790,1.6455696202531647
17516,330455705210574,123,142,288,209,98,51,7,1,911,8,919,0.8705114254624592
17517,330455705210575,62,77,105,88,55,26,8,4,413,12,425,2.823529411764706
17518,330455705210576,83,69,120,108,51,12,10,2,443,12,455,2.6373626373626373
17519,330455705210577,150,181,223,232,101,48,28,6,935,34,969,3.508771929824561
17520,330455705210578,102,139,147,165,91,25,30,2,669,32,701,4.56490727532097
17521,330455705210579,872,875,1423,1119,555,291,122,58,5135,180,5315,3.3866415804327374
17522,330455705210580,348,348,539,434,191,79,29,13,1939,42,1981,2.1201413427561837
17523,330455705210581,117,106,200,145,79,20,5,4,667,9,676,1.331360946745562
17524,330455705210582,45,57,122,98,57,24,7,1,403,8,411,1.9464720194647203
17525,330455705210583,278,285,393,343,234,145,72,24,1678,96,1774,5.411499436302142
17526,330455705210584,72,136,165,129,65,46,23,6,613,29,642,4.517133956386293
17527,330455705210585,42,69,60,51,40,22,7,1,284,8,292,2.73972602739726
17528,330455705210586,30,33,63,44,23,14,4,0,207,4,211,1.8957345971563981
17529,330455705210587,121,119,164,161,100,55,22,11,720,33,753,4.382470119521912
17530,330455705210588,230,232,415,268,181,89,25,13,1415,38,1453,2.615278733654508
17531,330455705210589,116,91,189,136,70,37,17,9,639,26,665,3.9097744360902253
17532,330455705210590,106,142,194,152,93,55,45,14,742,59,801,7.365792759051186
17533,330455705210591,97,97,187,107,77,44,34,10,609,44,653,6.738131699846861
17534,330455705210592,110,126,175,155,85,47,17,9,698,26,724,3.591160220994475
17535,330455705210593,86,100,189,150,79,42,29,10,646,39,685,5.693430656934306
17536,330455705210594,108,106,163,133,84,48,22,6,642,28,670,4.17910447761194
17537,330455705210595,62,97,152,108,103,58,25,15,580,40,620,6.451612903225806
17538,330455705210596,198,192,330,232,147,108,42,32,1207,74,1281,5.776736924277908
17539,330455705210597,162,208,290,219,136,118,49,32,1133,81,1214,6.672158154859967
17540,330455705210598,133,122,215,188,123,71,28,25,852,53,905,5.856353591160221
17541,330455705210599,116,109,140,138,76,76,31,17,655,48,703,6.827880512091038
17542,330455705210600,71,65,108,84,51,38,13,13,417,26,443,5.8690744920993225
17543,330455705210601,20,45,66,46,81,79,54,32,337,86,423,20.33096926713948
17544,330455705210602,38,48,44,51,53,44,14,17,278,31,309,10.032362459546926
17545,330455705210603,128,123,141,136,132,105,52,30,765,82,847,9.681227863046045
17546,330455705210604,115,168,214,154,192,235,101,66,1078,167,1245,13.413654618473895
17547,330455705210605,83,96,95,106,116,125,43,33,621,76,697,10.9038737446198
17548,330455705210606,174,184,161,144,93,51,18,14,807,32,839,3.8140643623361146
17549,330455705210607,82,126,158,95,117,156,106,65,734,171,905,18.895027624309392
17550,330455705210608,73,107,108,96,122,81,56,42,587,98,685,14.306569343065693
17551,330455705210609,63,69,72,99,64,64,54,19,431,73,504,14.484126984126984
17552,330455705210610,95,70,99,195,87,45,29,11,591,40,631,6.3391442155309035
17553,330455705210611,42,71,100,66,66,102,39,24,447,63,510,12.352941176470589
17554,330455705210612,42,62,71,65,71,52,39,44,363,83,446,18.609865470852018
17555,330455705210613,55,75,83,91,91,88,51,75,483,126,609,20.689655172413794
17556,330455705210614,109,77,127,226,104,55,34,16,698,50,748,6.684491978609626
17557,330455705210615,72,93,134,134,118,118,66,59,669,125,794,15.743073047858942
17558,330455705210616,79,108,106,126,82,102,49,50,603,99,702,14.102564102564102
17559,330455705210618,113,65,151,273,91,52,47,19,745,66,811,8.13810110974106
17560,330455705210619,31,44,72,52,69,72,25,19,340,44,384,11.458333333333334
17561,330455705210620,129,124,113,199,161,100,40,23,826,63,889,7.086614173228346
17562,330455705210621,39,65,56,64,76,50,24,42,350,66,416,15.865384615384615
17563,330455705210622,83,105,71,105,151,82,56,54,597,110,707,15.558698727015559
17564,330455705210623,81,99,90,126,135,103,72,66,634,138,772,17.875647668393782
17565,330455705210624,57,81,68,86,79,52,41,33,423,74,497,14.88933601609658
17566,330455705210625,113,145,134,148,170,135,67,60,845,127,972,13.065843621399177
17567,330455705210626,74,126,103,114,125,99,48,32,641,80,721,11.095700416088766
17568,330455705210627,75,87,93,139,126,121,60,64,641,124,765,16.209150326797385
17569,330455705210628,52,70,72,90,63,87,49,40,434,89,523,17.017208413001914
17570,330455705210629,141,89,91,197,133,87,40,28,738,68,806,8.436724565756824
17571,330455705210630,82,70,94,149,125,94,61,73,614,134,748,17.914438502673796
17572,330455705210631,37,48,49,70,70,56,45,62,330,107,437,24.48512585812357
17573,330455705210632,52,58,64,82,82,77,44,36,415,80,495,16.161616161616163
17574,330455705210633,18,20,72,62,24,28,14,9,224,23,247,9.31174089068826
17575,330455705210634,17,15,45,32,17,8,4,0,134,4,138,2.898550724637681
17576,330455705210635,21,14,33,54,24,16,10,4,162,14,176,7.954545454545454
17577,330455705210636,15,13,58,28,20,22,9,10,156,19,175,10.857142857142858
17578,330455705210637,41,41,48,62,42,56,19,7,290,26,316,8.227848101265822
17579,330455705210638,102,64,167,235,98,67,52,23,733,75,808,9.282178217821782
17580,330455705210639,49,47,101,118,74,39,35,24,428,59,487,12.114989733059549
17581,330455705210640,75,71,138,236,83,52,56,16,655,72,727,9.903713892709765
17582,330455705210641,95,52,154,210,87,67,30,22,665,52,717,7.252440725244073
17583,330455705210648,103,119,81,158,132,68,39,24,661,63,724,8.701657458563536
17584,330455705210649,45,25,108,115,49,26,22,10,368,32,400,8.0
17585,330455705210650,81,49,82,148,58,51,15,18,469,33,502,6.573705179282869
17586,330455705210651,20,66,69,93,75,43,36,15,366,51,417,12.23021582733813
17587,330455705210652,27,52,34,60,36,19,9,4,228,13,241,5.394190871369295
17588,330455705210653,72,57,107,136,102,73,27,24,547,51,598,8.528428093645484
17589,330455705210656,16,32,20,16,18,13,4,4,115,8,123,6.504065040650406
17590,330455705210657,13,28,31,32,16,13,8,3,133,11,144,7.638888888888889
17591,330455705210659,162,200,174,194,160,121,49,35,1011,84,1095,7.671232876712328
17592,330455705210660,38,52,58,52,45,23,18,5,268,23,291,7.903780068728523
17593,330455705210661,244,288,309,253,205,132,57,25,1431,82,1513,5.419695968274951
17594,330455705210662,156,186,248,212,129,95,28,22,1026,50,1076,4.646840148698884
17595,330455705210663,14,15,15,11,10,12,7,5,77,12,89,13.48314606741573
17596,330455705210664,19,26,17,21,19,13,8,6,115,14,129,10.852713178294573
17597,330455705210665,48,55,89,70,38,11,7,3,311,10,321,3.115264797507788
17598,330455705210666,15,16,18,21,20,8,10,4,98,14,112,12.5
17599,330455705210667,15,21,35,15,16,11,4,2,113,6,119,5.042016806722689
17600,330455705210668,399,402,416,438,270,174,77,50,2099,127,2226,5.705300988319856
17601,330455705210669,3,1,5,3,5,4,3,4,21,7,28,25.0
17602,330455705210670,75,82,114,66,50,39,12,4,426,16,442,3.6199095022624435
17603,330455705210671,161,164,195,181,148,98,35,26,947,61,1008,6.051587301587301
17604,330455705210672,22,16,19,22,16,12,5,7,107,12,119,10.084033613445378
17605,330455705210673,99,119,103,73,61,59,29,19,514,48,562,8.540925266903914
17606,330455705210675,37,40,30,25,28,21,15,11,181,26,207,12.560386473429952
17607,330455705210676,49,60,49,47,26,27,14,6,258,20,278,7.194244604316546
17608,330455705210677,15,17,13,10,11,10,1,0,76,1,77,1.2987012987012987
17609,330455705210678,43,51,56,40,36,40,16,8,266,24,290,8.275862068965518
17610,330455705210679,68,56,49,30,26,10,8,1,239,9,248,3.629032258064516
17611,330455705210680,16,15,17,15,14,4,4,4,81,8,89,8.98876404494382
17612,330455705210681,35,47,32,24,28,18,5,2,184,7,191,3.6649214659685865
17613,330455705210682,15,25,24,24,12,24,15,4,124,19,143,13.286713286713287
17614,330455705210683,234,196,127,108,87,50,20,14,802,34,836,4.0669856459330145
17615,330455705210684,14,16,6,12,5,7,3,0,60,3,63,4.761904761904762
17616,330455705210685,194,195,193,215,115,58,41,27,970,68,1038,6.551059730250482
17617,330455705210686,23,20,36,28,19,8,6,5,134,11,145,7.586206896551724
17618,330455705210687,45,62,53,43,35,17,11,5,255,16,271,5.904059040590406
17619,330455705210688,9,7,12,12,10,11,3,6,61,9,70,12.857142857142858
17620,330455705210689,20,33,27,24,41,19,17,18,164,35,199,17.587939698492463
17621,330455705210690,9,9,10,9,8,10,5,9,55,14,69,20.28985507246377
17622,330455705210691,55,75,74,75,62,32,19,12,373,31,404,7.673267326732673
17623,330455705210692,11,8,18,10,10,10,2,0,67,2,69,2.898550724637681
17624,330455705210693,108,112,87,112,53,48,11,7,520,18,538,3.345724907063197
17625,330455705210694,74,92,54,63,38,31,15,3,352,18,370,4.864864864864865
17626,330455705210695,47,57,40,37,36,18,12,1,235,13,248,5.241935483870968
17627,330455705210696,26,33,17,29,14,7,6,0,126,6,132,4.545454545454546
17628,330455705210697,54,72,70,63,51,54,19,15,364,34,398,8.542713567839195
17629,330455705210698,58,82,63,55,42,41,27,10,341,37,378,9.788359788359788
17630,330455705210699,26,18,24,12,13,11,4,2,104,6,110,5.454545454545454
17631,330455705210700,16,15,26,14,6,8,3,3,85,6,91,6.593406593406593
17632,330455705210701,29,31,26,23,26,14,8,9,149,17,166,10.240963855421686
17633,330455705210702,12,12,11,14,10,10,5,2,69,7,76,9.210526315789474
17634,330455705210703,10,8,13,10,13,9,4,7,63,11,74,14.864864864864865
17635,330455705210704,39,42,41,41,34,37,13,13,234,26,260,10.0
17636,330455705210705,30,12,20,10,6,5,2,2,83,4,87,4.597701149425287
17637,330455705210706,102,87,94,55,34,14,8,4,386,12,398,3.0150753768844223
17638,330455705210707,53,62,46,43,45,17,6,6,266,12,278,4.316546762589928
17639,330455705210708,101,113,91,64,50,34,16,17,453,33,486,6.790123456790123
17640,330455705210709,62,59,52,61,46,23,13,13,303,26,329,7.90273556231003
17641,330455705210710,113,113,130,115,90,49,29,22,610,51,661,7.7155824508320725
17642,330455705210711,23,22,21,37,17,10,3,4,130,7,137,5.109489051094891
17643,330455705210712,100,107,135,115,85,51,21,21,593,42,635,6.6141732283464565
17644,330455705210714,19,36,23,19,34,16,9,7,147,16,163,9.815950920245399
17645,330455705210715,1,5,2,4,7,2,3,0,21,3,24,12.5
17646,330455705210716,20,20,24,9,30,15,10,8,118,18,136,13.235294117647058
17647,330455705210717,34,42,31,34,33,18,4,5,192,9,201,4.477611940298507
17648,330455705210718,27,31,58,39,36,17,3,4,208,7,215,3.255813953488372
17649,330455705210719,74,92,128,95,60,39,15,8,488,23,511,4.500978473581213
17650,330455705210720,44,56,57,44,34,17,7,1,252,8,260,3.076923076923077
17651,330455705210721,68,82,78,51,66,34,17,5,379,22,401,5.486284289276808
17652,330455705210722,18,15,24,22,15,19,17,10,113,27,140,19.285714285714285
17653,330455705210723,99,132,62,151,89,48,30,7,581,37,618,5.9870550161812295
17654,330455705210724,140,154,215,158,117,82,47,25,866,72,938,7.67590618336887
17655,330455705210725,36,35,43,44,24,28,11,6,210,17,227,7.488986784140969
17656,330455705210726,162,219,162,144,125,99,35,29,911,64,975,6.564102564102564
17657,330455705210727,116,141,97,115,111,64,47,37,644,84,728,11.538461538461538
17658,330455705210728,43,83,120,120,91,53,5,2,510,7,517,1.3539651837524178
17659,330455705210729,132,137,259,187,95,39,29,6,849,35,884,3.9592760180995477
17660,330455705210730,148,142,235,157,80,42,12,5,804,17,821,2.0706455542021924
17661,330455705210731,182,160,215,160,82,39,14,5,838,19,857,2.2170361726954493
17662,330455705210732,118,101,135,115,60,27,4,4,556,8,564,1.4184397163120568
17663,330455705210733,82,92,123,83,57,12,8,2,449,10,459,2.178649237472767
17664,330455705210734,97,77,103,90,39,14,2,0,420,2,422,0.47393364928909953
17665,330455705210735,62,69,91,72,46,15,12,1,355,13,368,3.532608695652174
17666,330455705210736,183,146,280,176,86,26,8,4,897,12,909,1.3201320132013201
17667,330455705210737,77,97,153,78,54,27,9,1,486,10,496,2.0161290322580645
17668,330455705210738,111,142,228,140,90,39,14,6,750,20,770,2.5974025974025974
17669,330455705210739,176,148,261,202,84,22,9,4,893,13,906,1.434878587196468
17670,330455705210740,146,116,148,120,52,20,9,3,602,12,614,1.9543973941368078
17671,330455705210741,72,80,67,76,30,13,8,0,338,8,346,2.3121387283236996
17672,330455705210742,17,19,10,12,7,6,1,1,71,2,73,2.73972602739726
17673,330455705210743,14,17,25,16,16,8,1,1,96,2,98,2.0408163265306123
17674,330455705210744,39,34,97,76,26,6,0,1,278,1,279,0.35842293906810035
17675,330455705210745,63,72,87,78,62,38,17,9,400,26,426,6.103286384976526
17676,330455705210746,45,54,86,42,56,22,10,7,305,17,322,5.279503105590062
17677,330455705210747,32,35,46,37,29,24,5,8,203,13,216,6.018518518518518
17678,330455705210748,200,202,267,166,119,76,21,10,1030,31,1061,2.9217719132893496
17679,330455705210749,152,158,230,168,68,33,10,3,809,13,822,1.5815085158150852
17680,330455705210750,211,168,260,199,96,31,11,3,965,14,979,1.4300306435137895
17681,330455705210751,282,267,311,286,139,68,12,8,1353,20,1373,1.4566642388929352
17682,330455705210752,96,121,130,91,67,24,8,5,529,13,542,2.3985239852398523
17683,330455705210753,110,103,189,152,70,29,14,7,653,21,674,3.115727002967359
17684,330455705210754,72,62,131,106,41,20,7,2,432,9,441,2.0408163265306123
17685,330455705210755,173,155,244,251,146,37,13,1,1006,14,1020,1.3725490196078431
17686,330455705210756,251,215,410,351,154,50,12,2,1431,14,1445,0.9688581314878892
17687,330455705210757,52,28,57,43,22,14,5,4,216,9,225,4.0
17688,330455705210758,94,109,163,98,75,43,11,5,582,16,598,2.6755852842809364
17689,330455705210759,172,194,238,185,106,54,26,13,949,39,988,3.9473684210526314
17690,330455705210760,85,130,121,111,89,73,23,22,609,45,654,6.8807339449541285
17691,330455705210761,43,51,47,45,36,31,9,8,253,17,270,6.296296296296297
17692,330455705210762,82,113,88,82,67,46,12,16,478,28,506,5.533596837944664
17693,330455705210763,93,117,116,99,83,49,23,11,557,34,591,5.752961082910321
17694,330455705210764,121,173,124,131,123,77,42,16,749,58,807,7.1871127633209415
17695,330455705210765,19,23,31,18,9,10,4,2,110,6,116,5.172413793103448
17696,330455705210766,25,42,39,30,28,27,18,9,191,27,218,12.385321100917432
17697,330455705210767,17,23,19,20,18,12,17,10,109,27,136,19.852941176470587
17698,330455705210768,117,173,118,97,125,98,20,26,728,46,774,5.943152454780361
17699,330455705210769,158,218,203,131,154,148,47,32,1012,79,1091,7.241063244729606
17700,330455705210770,93,115,95,90,114,50,18,15,557,33,590,5.593220338983051
17701,330455705210771,22,32,36,36,41,41,20,33,208,53,261,20.306513409961685
17702,330455705210772,160,169,176,168,123,62,26,9,858,35,893,3.9193729003359463
17703,330455705210773,162,174,146,144,80,52,22,12,758,34,792,4.292929292929293
17704,330455705210774,92,150,153,156,153,101,42,21,805,63,868,7.258064516129032
17705,330455705210775,7,9,7,5,2,3,0,0,33,0,33,0.0
17706,330455705210776,72,91,118,103,87,79,36,8,550,44,594,7.407407407407407
17707,330455705210777,55,82,105,87,93,74,32,21,496,53,549,9.65391621129326
17708,330455705210778,89,79,87,72,64,35,16,2,426,18,444,4.054054054054054
17709,330455705210779,140,175,192,158,125,59,34,12,849,46,895,5.139664804469274
17710,330455705210780,64,58,76,70,43,20,9,5,331,14,345,4.057971014492754
17711,330455705210781,18,52,38,32,20,8,6,2,168,8,176,4.545454545454546
17712,330455705210782,110,110,120,107,114,61,28,26,622,54,676,7.988165680473373
17713,330455705210783,56,85,74,46,55,33,19,7,349,26,375,6.933333333333334
17714,330455705210784,67,78,97,70,70,37,20,11,419,31,450,6.888888888888889
17715,330455705210785,205,206,213,161,92,50,25,16,927,41,968,4.235537190082645
17716,330455705210786,68,92,66,62,57,37,17,13,382,30,412,7.281553398058253
17717,330455705210787,68,97,105,85,57,34,8,11,446,19,465,4.086021505376344
17718,330455705210788,97,106,108,105,69,45,18,7,530,25,555,4.504504504504505
17719,330455705210789,140,136,248,137,78,37,13,14,776,27,803,3.3623910336239105
17720,330455705210790,171,180,392,244,112,78,31,12,1177,43,1220,3.5245901639344264
17721,330455705210791,87,91,91,137,112,55,36,29,573,65,638,10.18808777429467
17722,330455705210792,142,149,170,194,158,105,89,56,918,145,1063,13.640639698965193
17723,330455705210793,111,129,164,178,121,94,51,36,797,87,884,9.841628959276019
17724,330455705210794,250,279,229,242,165,75,48,17,1240,65,1305,4.980842911877395
17725,330455705210795,31,46,69,57,37,73,44,32,313,76,389,19.53727506426735
17726,330455705210796,31,49,33,47,49,22,14,4,231,18,249,7.228915662650603
17727,330455705210797,114,156,96,96,88,64,21,8,614,29,643,4.510108864696734
17728,330455705210798,151,153,97,90,79,40,15,6,610,21,631,3.3280507131537242
17729,330455705210799,17,27,35,23,27,42,8,12,171,20,191,10.471204188481675
17730,330455705210800,6,13,13,15,11,8,6,6,66,12,78,15.384615384615385
17731,330455705210801,11,10,15,15,12,14,7,3,77,10,87,11.494252873563218
17732,330455705210802,22,30,34,42,30,38,41,24,196,65,261,24.904214559386972
17733,330455705210803,73,104,114,126,112,140,106,103,669,209,878,23.804100227790432
17734,330455705210804,43,43,66,38,53,27,18,9,270,27,297,9.090909090909092
17735,330455705210806,18,16,30,17,28,35,19,7,144,26,170,15.294117647058824
17736,330455705210807,142,158,137,125,126,95,22,23,783,45,828,5.434782608695652
17737,330455705210808,12,13,14,10,8,6,4,1,63,5,68,7.352941176470588
17738,330455705210809,20,22,15,21,6,5,2,3,89,5,94,5.319148936170213
17739,330455705210810,87,126,139,108,117,90,81,78,667,159,826,19.249394673123486
17740,330455705210811,35,51,63,59,87,53,22,19,348,41,389,10.539845758354756
17741,330455705210819,112,103,93,99,56,36,13,3,499,16,515,3.1067961165048543
17742,330455705210830,108,93,190,172,93,32,11,1,688,12,700,1.7142857142857142
17743,330455705210831,101,116,206,167,53,21,8,0,664,8,672,1.1904761904761905
17744,330455705210832,43,47,71,127,53,16,1,2,357,3,360,0.8333333333333334
17745,330455705210833,110,102,183,139,39,20,6,2,593,8,601,1.3311148086522462
17746,330455705210834,45,56,120,90,43,18,5,2,372,7,379,1.8469656992084433
17747,330455705210835,45,52,134,80,57,16,6,1,384,7,391,1.7902813299232736
17748,330455705210836,114,92,129,121,63,29,10,4,548,14,562,2.491103202846975
17749,330455705210837,76,74,138,119,68,25,8,2,500,10,510,1.9607843137254901
17750,330455705220001,36,49,65,52,37,39,31,13,278,44,322,13.664596273291925
17751,330455705220002,59,82,70,92,60,50,47,31,413,78,491,15.885947046843178
17752,330455705220003,92,90,115,105,96,69,46,34,567,80,647,12.364760432766616
17753,330455705220004,39,70,60,67,52,44,51,17,332,68,400,17.0
17754,330455705220005,97,122,136,120,114,120,53,62,709,115,824,13.95631067961165
17755,330455705220006,57,74,71,85,67,79,46,43,433,89,522,17.049808429118773
17756,330455705220007,81,91,72,129,78,44,24,9,495,33,528,6.25
17757,330455705220008,93,128,125,97,126,104,75,72,673,147,820,17.926829268292682
17758,330455705220009,71,99,84,94,88,100,79,50,536,129,665,19.398496240601503
17759,330455705220010,135,150,164,130,122,123,50,51,824,101,925,10.91891891891892
17760,330455705220011,61,83,115,84,94,138,91,95,575,186,761,24.441524310118265
17761,330455705220012,72,94,98,88,104,97,65,44,553,109,662,16.46525679758308
17762,330455705220013,78,104,120,97,128,97,67,95,624,162,786,20.610687022900763
17763,330455705220014,78,116,98,119,104,93,86,52,608,138,746,18.498659517426272
17764,330455705220015,76,96,99,127,87,95,97,64,580,161,741,21.727395411605936
17765,330455705220016,82,120,100,91,91,85,55,60,569,115,684,16.81286549707602
17766,330455705220017,138,153,149,169,108,121,100,58,838,158,996,15.863453815261044
17767,330455705220018,111,116,145,79,86,84,40,35,621,75,696,10.775862068965518
17768,330455705220019,138,129,123,98,84,91,57,32,663,89,752,11.835106382978724
17769,330455705220020,140,175,151,111,117,78,43,35,772,78,850,9.176470588235293
17770,330455705220021,96,121,107,92,74,78,33,31,568,64,632,10.126582278481013
17771,330455705220022,126,158,150,130,136,100,70,55,800,125,925,13.513513513513514
17772,330455705220023,142,174,145,135,151,101,71,36,848,107,955,11.204188481675393
17773,330455705220024,111,105,135,98,98,85,51,40,632,91,723,12.586445366528354
17774,330455705220025,145,174,158,135,124,98,34,36,834,70,904,7.743362831858407
17775,330455705220026,100,120,145,101,128,95,51,29,689,80,769,10.403120936280883
17776,330455705220027,134,152,161,116,129,93,49,36,785,85,870,9.770114942528735
17777,330455705220028,60,98,116,90,67,85,62,55,516,117,633,18.48341232227488
17778,330455705220029,104,130,135,110,104,104,69,45,687,114,801,14.232209737827715
17779,330455705220030,46,64,64,63,59,84,54,34,380,88,468,18.803418803418804
17780,330455705220031,51,72,81,81,85,88,62,47,458,109,567,19.223985890652557
17781,330455705220032,49,77,98,71,76,122,72,72,493,144,637,22.60596546310832
17782,330455705220033,56,72,93,97,89,116,61,58,523,119,642,18.53582554517134
17783,330455705220034,65,96,103,84,101,118,93,80,567,173,740,23.37837837837838
17784,330455705220035,99,107,149,110,113,155,88,103,733,191,924,20.67099567099567
17785,330455705220036,56,116,91,150,164,121,86,102,698,188,886,21.218961625282166
17786,330455705220037,116,108,147,114,95,115,73,76,695,149,844,17.654028436018958
17787,330455705220038,67,74,78,70,100,69,44,60,458,104,562,18.505338078291814
17788,330455705220039,100,114,144,147,123,153,95,58,781,153,934,16.38115631691649
17789,330455705220040,41,73,94,68,87,99,54,59,462,113,575,19.652173913043477
17790,330455705220041,65,90,113,112,88,102,73,75,570,148,718,20.61281337047354
17791,330455705220042,58,99,126,97,105,106,72,48,591,120,711,16.877637130801688
17792,330455705220043,53,58,84,78,74,77,42,31,424,73,497,14.688128772635816
17793,330455705220044,55,72,93,79,65,99,52,55,463,107,570,18.771929824561404
17794,330455705220045,123,127,143,146,126,120,74,80,785,154,939,16.40042598509052
17795,330455705220046,78,127,108,118,109,86,74,60,626,134,760,17.63157894736842
17796,330455705220047,63,92,86,87,91,59,38,19,478,57,535,10.654205607476635
17797,330455705220048,94,88,67,94,92,37,33,17,472,50,522,9.578544061302683
17798,330455705220049,134,145,146,186,137,125,87,48,873,135,1008,13.392857142857142
17799,330455705220050,107,149,147,124,123,120,77,67,770,144,914,15.75492341356674
17800,330455705220051,119,134,151,128,120,76,36,39,728,75,803,9.339975093399751
17801,330455705220052,96,112,125,91,93,89,44,45,606,89,695,12.805755395683454
17802,330455705220053,59,81,79,113,81,67,47,27,480,74,554,13.35740072202166
17803,330455705220054,93,111,104,105,106,96,49,59,615,108,723,14.937759336099585
17804,330455705220055,63,77,120,99,106,119,49,55,584,104,688,15.116279069767442
17805,330455705220056,97,83,112,96,92,108,57,40,588,97,685,14.16058394160584
17806,330455705220057,95,113,131,135,127,118,74,59,719,133,852,15.610328638497652
17807,330455705220058,107,127,119,118,117,97,74,50,685,124,809,15.327564894932015
17808,330455705220059,110,134,167,118,126,150,61,69,805,130,935,13.903743315508022
17809,330455705220060,144,205,171,160,194,129,58,75,1003,133,1136,11.70774647887324
17810,330455705220061,54,54,65,53,47,47,25,22,320,47,367,12.806539509536785
17811,330455705220062,123,132,150,127,130,138,77,63,800,140,940,14.893617021276595
17812,330455705220063,81,94,130,105,117,126,43,44,653,87,740,11.756756756756756
17813,330455705220064,124,158,185,136,128,135,85,60,866,145,1011,14.342235410484669
17814,330455705220065,93,98,88,73,62,33,27,12,447,39,486,8.024691358024691
17815,330455705220066,215,283,249,227,205,149,73,58,1328,131,1459,8.978752570253599
17816,330455705220067,262,320,257,272,224,132,76,61,1467,137,1604,8.541147132169575
17817,330455705220068,78,86,81,110,78,99,77,26,532,103,635,16.22047244094488
17818,330455705220069,116,158,113,91,69,51,34,12,598,46,644,7.142857142857143
17819,330455705220070,140,164,118,141,105,70,43,24,738,67,805,8.322981366459627
17820,330455705220071,138,147,199,145,163,155,70,71,947,141,1088,12.959558823529411
17821,330455705220072,128,122,149,116,101,95,54,31,711,85,796,10.678391959798995
17822,330455705220073,111,128,144,104,106,83,49,52,676,101,777,12.998712998712998
17823,330455705220074,244,245,227,232,175,159,81,47,1282,128,1410,9.078014184397164
17824,330455705220075,79,99,106,107,126,97,39,25,614,64,678,9.43952802359882
17825,330455705220076,74,107,164,149,135,174,125,47,803,172,975,17.641025641025642
17826,330455705220077,94,112,152,161,117,174,135,65,810,200,1010,19.801980198019802
17827,330455705220078,82,104,124,121,114,94,90,67,639,157,796,19.723618090452263
17828,330455705220079,89,122,109,112,97,116,67,55,645,122,767,15.90612777053455
17829,330455705220080,54,97,113,73,116,124,73,95,577,168,745,22.550335570469798
17830,330455705220081,45,58,104,55,64,100,56,68,426,124,550,22.545454545454547
17831,330455705220082,36,36,72,60,71,81,61,75,356,136,492,27.642276422764226
17832,330455705220083,61,104,111,99,94,97,81,56,566,137,703,19.48790896159317
17833,330455705220084,76,94,89,96,90,88,70,55,533,125,658,18.996960486322187
17834,330455705220085,50,77,80,84,84,96,62,77,471,139,610,22.78688524590164
17835,330455705220086,58,75,62,47,47,44,15,12,333,27,360,7.5
17836,330455705220087,60,74,111,96,82,87,57,68,510,125,635,19.68503937007874
17837,330455705220088,0,10,21,12,6,1,0,0,50,0,50,0.0
17838,330455705220089,50,90,106,74,122,93,73,84,535,157,692,22.6878612716763
17839,330455705220090,60,82,92,100,97,97,69,89,528,158,686,23.03206997084548
17840,330455705220091,35,49,61,48,49,59,49,62,301,111,412,26.941747572815533
17841,330455705220092,21,32,46,39,42,55,47,60,235,107,342,31.28654970760234
17842,330455705220093,10,19,22,16,26,19,18,19,112,37,149,24.83221476510067
17843,330455705220094,22,4,0,0,0,0,0,0,26,0,26,0.0
17844,330455705220096,20,31,34,35,41,54,27,34,215,61,276,22.10144927536232
17845,330455705220097,55,61,104,90,87,96,71,89,493,160,653,24.502297090352222
17846,330455705220098,40,58,80,84,58,77,52,64,397,116,513,22.612085769980506
17847,330455705220099,52,82,101,103,106,91,81,60,535,141,676,20.857988165680474
17848,330455705220100,84,142,127,121,96,135,76,70,705,146,851,17.156286721504113
17849,330455705220101,101,155,168,155,160,131,85,49,870,134,1004,13.346613545816734
17850,330455705220102,67,100,92,75,113,84,34,38,531,72,603,11.940298507462687
17851,330455705220103,96,123,137,139,156,116,50,46,767,96,863,11.123986095017381
17852,330455705220104,102,155,128,140,123,128,48,55,776,103,879,11.717861205915813
17853,330455705220105,92,131,115,132,120,81,53,53,671,106,777,13.642213642213642
17854,330455705220106,79,85,110,85,92,92,46,36,543,82,625,13.12
17855,330455705220107,200,234,202,155,144,105,59,33,1040,92,1132,8.12720848056537
17856,330455705220108,69,60,64,60,42,24,15,12,319,27,346,7.803468208092486
17857,330455705220109,49,59,72,66,73,74,41,37,393,78,471,16.56050955414013
17858,330455705220110,85,108,121,138,103,117,52,55,672,107,779,13.735558408215661
17859,330455705220111,82,84,117,92,91,117,54,55,583,109,692,15.751445086705202
17860,330455705220112,92,104,133,101,132,96,59,49,658,108,766,14.099216710182768
17861,330455705220113,124,147,166,141,153,153,78,90,884,168,1052,15.96958174904943
17862,330455705220114,75,115,128,124,130,111,79,81,683,160,843,18.979833926453143
17863,330455705220115,91,138,169,126,146,145,108,75,815,183,998,18.336673346693388
17864,330455705220116,61,94,65,82,82,71,52,43,455,95,550,17.272727272727273
17865,330455705220117,103,134,151,139,96,115,67,52,738,119,857,13.885647607934656
17866,330455705220118,87,107,127,109,114,128,67,63,672,130,802,16.209476309226932
17867,330455705220119,84,108,119,102,118,108,65,70,639,135,774,17.441860465116278
17868,330455705220120,69,91,87,84,80,73,45,32,484,77,561,13.72549019607843
17869,330455705220121,70,90,115,95,94,114,62,62,578,124,702,17.663817663817664
17870,330455705220122,68,63,70,99,62,71,59,48,433,107,540,19.814814814814813
17871,330455705220123,75,100,161,85,104,132,86,54,657,140,797,17.565872020075282
17872,330455705220124,43,61,56,60,49,72,34,44,341,78,419,18.615751789976134
17873,330455705220125,75,115,138,113,132,124,79,100,697,179,876,20.4337899543379
17874,330455705220126,99,113,119,109,129,122,96,75,691,171,862,19.837587006960558
17875,330455705220127,66,106,105,81,89,79,58,63,526,121,647,18.701700154559507
17876,330455705220128,69,104,83,98,92,84,56,51,530,107,637,16.797488226059656
17877,330455705220129,77,112,104,100,117,79,64,49,589,113,702,16.096866096866098
17878,330455705220130,98,105,135,100,90,102,73,53,630,126,756,16.666666666666668
17879,330455705220131,86,107,105,101,109,110,60,61,618,121,739,16.373477672530445
17880,330455705220132,80,92,135,101,105,124,69,64,637,133,770,17.272727272727273
17881,330455705220133,60,82,73,81,88,78,47,66,462,113,575,19.652173913043477
17882,330455705220134,95,78,109,117,107,97,87,69,603,156,759,20.553359683794465
17883,330455705220135,288,311,297,222,236,156,72,59,1510,131,1641,7.982937233394272
17884,330455705220136,65,101,95,93,130,98,63,94,582,157,739,21.24492557510149
17885,330455705220137,55,94,104,79,99,89,52,70,520,122,642,19.003115264797508
17886,330455705220138,84,86,133,115,99,93,76,49,610,125,735,17.006802721088434
17887,330455705220139,107,136,147,120,135,125,77,64,770,141,911,15.477497255762898
17888,330455705220140,66,95,109,98,67,86,56,48,521,104,625,16.64
17889,330455705220141,57,64,75,81,80,70,60,45,427,105,532,19.736842105263158
17890,330455705220142,72,79,126,88,93,111,51,48,569,99,668,14.820359281437126
17891,330455705220143,92,115,132,118,117,110,76,62,684,138,822,16.78832116788321
17892,330455705220144,58,110,141,112,111,96,62,79,628,141,769,18.33550065019506
17893,330455705220145,53,105,100,86,108,100,54,59,552,113,665,16.992481203007518
17894,330455705220146,79,119,111,151,136,85,92,73,681,165,846,19.50354609929078
17895,330455705220147,48,63,86,66,68,91,40,41,422,81,503,16.10337972166998
17896,330455705220148,126,159,145,116,110,79,53,34,735,87,822,10.583941605839415
17897,330455705220149,101,119,116,128,81,65,38,22,610,60,670,8.955223880597014
17898,330455705220150,99,152,134,140,135,82,61,46,742,107,849,12.603062426383982
17899,330455705220151,130,162,134,119,126,92,46,41,763,87,850,10.235294117647058
17900,330455705220152,71,96,75,59,69,37,46,38,407,84,491,17.10794297352342
17901,330455705220153,143,183,171,147,161,116,55,75,921,130,1051,12.369172216936251
17902,330455705220154,102,118,110,81,83,69,43,31,563,74,637,11.616954474097332
17903,330455705220155,112,153,126,116,116,65,63,62,688,125,813,15.375153751537516
17904,330455705220156,70,134,99,107,90,79,35,51,579,86,665,12.93233082706767
17905,330455705220157,70,82,86,58,78,65,21,31,439,52,491,10.590631364562118
17906,330455705220158,137,191,140,120,146,115,71,51,849,122,971,12.564366632337796
17907,330455705220159,120,139,156,91,101,85,37,42,692,79,771,10.246433203631646
17908,330455705220160,127,165,145,140,109,107,45,51,793,96,889,10.798650168728908
17909,330455705220161,133,197,145,144,165,111,66,61,895,127,1022,12.426614481409002
17910,330455705220162,109,136,135,114,93,104,55,37,691,92,783,11.749680715197957
17911,330455705220163,121,86,68,57,39,31,20,6,402,26,428,6.074766355140187
17912,330455705220164,62,88,104,61,86,69,48,59,470,107,577,18.54419410745234
17913,330455705220165,227,201,224,154,137,121,58,48,1064,106,1170,9.05982905982906
17914,330455705220166,156,184,145,112,114,83,59,34,794,93,887,10.4847801578354
17915,330455705220167,91,101,109,59,42,55,38,15,457,53,510,10.392156862745098
17916,330455705220168,145,168,101,102,77,59,34,22,652,56,708,7.909604519774011
17917,330455705220169,149,151,185,148,88,57,39,30,778,69,847,8.146399055489965
17918,330455705220170,92,93,80,89,76,71,25,31,501,56,557,10.053859964093357
17919,330455705220171,64,71,80,59,66,56,30,29,396,59,455,12.967032967032967
17920,330455705220172,221,233,220,147,133,100,58,29,1054,87,1141,7.6248904469763366
17921,330455705220173,90,78,52,60,33,40,21,14,353,35,388,9.02061855670103
17922,330455705220174,245,274,228,209,161,116,64,32,1233,96,1329,7.223476297968397
17923,330455705220175,128,206,163,105,136,97,40,26,835,66,901,7.32519422863485
17924,330455705220176,45,60,56,41,51,33,16,12,286,28,314,8.9171974522293
17925,330455705220177,149,178,178,135,137,103,61,42,880,103,983,10.478128179043743
17926,330455705220178,84,110,137,68,44,52,25,18,495,43,538,7.992565055762082
17927,330455705220179,298,299,273,210,185,130,75,42,1395,117,1512,7.738095238095238
17928,330455705220180,74,97,91,75,94,67,53,42,498,95,593,16.020236087689714
17929,330455705220181,33,35,39,39,23,30,9,4,199,13,212,6.132075471698113
17930,330455705220182,98,144,137,100,93,92,36,34,664,70,734,9.536784741144414
17931,330455705220183,77,73,104,75,72,89,46,50,490,96,586,16.38225255972696
17932,330455705220184,57,84,120,90,80,109,84,75,540,159,699,22.746781115879827
17933,330455705220185,61,74,124,103,85,98,77,89,545,166,711,23.347398030942333
17934,330455705220186,88,123,136,101,85,107,55,39,640,94,734,12.806539509536785
17935,330455705220187,59,80,76,84,73,79,58,65,451,123,574,21.428571428571427
17936,330455705220188,47,93,101,101,77,96,72,63,515,135,650,20.76923076923077
17937,330455705220189,49,78,95,98,86,99,72,97,505,169,674,25.07418397626113
17938,330455705220190,52,81,100,114,101,120,98,90,568,188,756,24.867724867724867
17939,330455705220191,45,104,120,92,132,117,72,77,610,149,759,19.631093544137023
17940,330455705220192,105,121,141,145,123,183,104,95,818,199,1017,19.567354965585054
17941,330455705220193,102,144,169,128,141,158,106,87,842,193,1035,18.647342995169083
17942,330455705220194,98,147,161,125,156,169,95,102,856,197,1053,18.708452041785375
17943,330455705220195,76,111,150,117,106,174,83,97,734,180,914,19.693654266958426
17944,330455705220196,74,107,100,106,92,79,58,48,558,106,664,15.963855421686747
17945,330455705220197,66,79,80,107,75,77,78,50,484,128,612,20.915032679738562
17946,330455705220198,91,133,111,150,98,110,72,51,693,123,816,15.073529411764707
17947,330455705220199,100,123,111,127,113,84,56,41,658,97,755,12.847682119205299
17948,330455705220200,113,131,100,126,109,68,31,36,647,67,714,9.38375350140056
17949,330455705220201,157,148,133,169,117,124,91,50,848,141,989,14.256825075834175
17950,330455705220202,94,83,100,103,130,80,57,58,590,115,705,16.31205673758865
17951,330455705220203,68,90,98,83,92,70,60,39,501,99,600,16.5
17952,330455705220204,77,105,88,93,90,84,51,51,537,102,639,15.96244131455399
17953,330455705220205,68,115,95,99,115,85,60,57,577,117,694,16.85878962536023
17954,330455705220206,83,108,91,115,86,92,57,39,575,96,671,14.307004470938898
17955,330455705220207,73,80,94,81,69,73,56,39,470,95,565,16.8141592920354
17956,330455705220208,133,133,154,159,110,104,81,70,793,151,944,15.995762711864407
17957,330455705220209,119,159,164,128,166,111,81,75,847,156,1003,15.553339980059821
17958,330455705220210,96,115,139,121,107,104,70,63,682,133,815,16.319018404907975
17959,330455705220211,54,99,81,66,70,75,49,40,445,89,534,16.666666666666668
17960,330455705220212,82,78,91,100,73,70,38,31,494,69,563,12.255772646536412
17961,330455705220213,95,139,123,109,110,133,93,75,709,168,877,19.156214367160775
17962,330455705220214,72,78,78,99,96,59,53,34,482,87,569,15.289982425307556
17963,330455705220215,77,96,84,86,73,60,56,33,476,89,565,15.752212389380531
17964,330455705220216,68,108,90,100,90,78,74,37,534,111,645,17.209302325581394
17965,330455705220217,96,113,117,99,88,69,58,39,582,97,679,14.285714285714286
17966,330455705220218,59,69,75,91,67,49,44,36,410,80,490,16.3265306122449
17967,330455705220219,75,69,84,85,63,57,30,40,433,70,503,13.916500994035784
17968,330455705220220,95,134,107,109,115,93,54,47,653,101,754,13.39522546419098
17969,330455705220221,66,101,88,97,84,83,70,50,519,120,639,18.779342723004696
17970,330455705220222,69,97,112,112,99,87,86,75,576,161,737,21.845318860244234
17971,330455705220223,120,143,151,131,143,98,79,65,786,144,930,15.483870967741936
17972,330455705220224,45,58,60,71,61,47,45,39,342,84,426,19.718309859154928
17973,330455705220225,144,213,183,212,187,169,144,68,1108,212,1320,16.060606060606062
17974,330455705220226,123,152,147,134,121,102,69,57,779,126,905,13.922651933701658
17975,330455705220227,107,127,143,127,116,116,60,65,736,125,861,14.518002322880372
17976,330455705220228,118,117,153,102,132,105,64,50,727,114,841,13.555291319857313
17977,330455705220229,69,101,95,76,81,60,41,31,482,72,554,12.99638989169675
17978,330455705220230,148,185,191,203,162,134,84,53,1023,137,1160,11.810344827586206
17979,330455705220231,146,178,154,126,99,79,30,19,782,49,831,5.896510228640192
17980,330455705220232,114,132,151,103,128,114,59,55,742,114,856,13.317757009345794
17981,330455705220233,45,46,60,57,54,62,38,41,324,79,403,19.602977667493796
17982,330455705220234,66,89,110,83,84,114,59,67,546,126,672,18.75
17983,330455705220235,63,93,122,100,81,82,46,56,541,102,643,15.863141524105755
17984,330455705220236,85,100,139,104,103,111,51,67,642,118,760,15.526315789473685
17985,330455705220237,65,119,88,99,148,67,25,24,586,49,635,7.716535433070866
17986,330455705220238,136,149,169,195,123,97,131,50,869,181,1050,17.238095238095237
17987,330455705220239,165,227,230,175,205,167,73,71,1169,144,1313,10.967250571210966
17988,330455705220240,57,72,72,46,42,47,13,9,336,22,358,6.145251396648045
17989,330455705220241,55,92,115,76,103,109,54,39,550,93,643,14.463452566096423
17990,330455705220242,279,316,355,283,274,184,73,63,1691,136,1827,7.443897099069513
17991,330455705220243,24,34,35,32,26,22,13,8,173,21,194,10.824742268041238
17992,330455705220244,77,113,172,127,212,125,63,51,826,114,940,12.127659574468085
17993,330455705220245,59,75,85,85,87,47,15,6,438,21,459,4.57516339869281
17994,330455705220246,134,118,133,158,118,51,14,12,712,26,738,3.5230352303523036
17995,330455705220247,104,120,108,115,113,38,14,6,598,20,618,3.236245954692557
17996,330455705220248,122,132,188,125,106,81,55,35,754,90,844,10.663507109004739
17997,330455705220249,113,154,136,89,106,76,26,21,674,47,721,6.51872399445215
17998,330455705220250,168,186,162,102,126,75,40,16,819,56,875,6.4
17999,330455705220251,124,163,214,161,123,165,101,63,950,164,1114,14.721723518850988
18000,330455705220252,149,175,214,178,147,202,122,59,1065,181,1246,14.526484751203853
18001,330455705220253,143,168,201,164,97,164,68,38,937,106,1043,10.162991371045063
18002,330455705220254,106,149,175,135,117,121,80,57,803,137,940,14.574468085106384
18003,330455705220255,108,153,183,129,131,155,71,75,859,146,1005,14.527363184079602
18004,330455705220256,66,86,105,84,77,120,35,26,538,61,599,10.18363939899833
18005,330455705220257,163,177,125,141,127,57,25,13,790,38,828,4.5893719806763285
18006,330455705220258,62,93,67,82,102,61,22,63,467,85,552,15.398550724637682
18007,330455705220259,123,145,119,146,133,51,62,49,717,111,828,13.405797101449275
18008,330455705220260,148,200,150,143,161,97,55,56,899,111,1010,10.990099009900991
18009,330455705220261,127,174,121,128,120,85,66,60,755,126,881,14.301929625425652
18010,330455705220262,143,126,134,150,108,64,46,38,725,84,809,10.3831891223733
18011,330455705220263,95,147,138,113,128,78,52,45,699,97,796,12.185929648241206
18012,330455705220264,149,166,143,136,114,87,60,44,795,104,899,11.568409343715238
18013,330455705220265,88,106,108,82,100,77,48,45,561,93,654,14.220183486238533
18014,330455705220266,142,180,167,147,156,120,80,88,912,168,1080,15.555555555555555
18015,330455705220267,146,162,147,114,144,97,59,53,810,112,922,12.147505422993492
18016,330455705220268,96,107,105,86,92,91,35,53,577,88,665,13.233082706766917
18017,330455705220269,131,172,140,124,141,83,52,59,791,111,902,12.3059866962306
18018,330455705220270,79,117,99,121,108,75,52,50,599,102,701,14.550641940085592
18019,330455705220271,120,157,161,130,122,78,61,45,768,106,874,12.128146453089245
18020,330455705220272,132,175,146,118,166,101,60,75,838,135,973,13.874614594039054
18021,330455705220273,55,61,58,45,53,21,10,5,293,15,308,4.87012987012987
18022,330455705220274,130,145,164,121,124,97,42,35,781,77,858,8.974358974358974
18023,330455705220275,122,134,122,91,109,59,40,16,637,56,693,8.080808080808081
18024,330455705220276,125,154,151,116,99,91,50,18,736,68,804,8.457711442786069
18025,330455705220277,83,106,121,107,71,75,50,15,563,65,628,10.35031847133758
18026,330455705220278,331,335,301,313,288,179,84,52,1747,136,1883,7.222517259691981
18027,330455705220279,1,2,4,1,2,1,0,0,11,0,11,0.0
18028,330455705220280,84,104,76,89,69,59,28,13,481,41,522,7.854406130268199
18029,330455705220281,136,137,132,111,71,48,34,16,635,50,685,7.299270072992701
18030,330455705220282,160,181,135,86,101,54,25,13,717,38,755,5.033112582781457
18031,330455705220283,124,133,108,108,91,44,38,10,608,48,656,7.317073170731708
18032,330455705220284,71,96,69,74,75,48,39,32,433,71,504,14.087301587301587
18033,330455705220285,67,63,56,77,52,35,28,31,350,59,409,14.425427872860636
18034,330455705220286,156,187,159,153,136,100,60,60,891,120,1011,11.869436201780415
18035,330455705220287,116,144,141,108,111,111,55,65,731,120,851,14.101057579318448
18036,330455705220288,55,68,78,68,69,57,36,43,395,79,474,16.666666666666668
18037,330455705220289,133,192,143,118,149,102,65,50,837,115,952,12.079831932773109
18038,330455705220290,146,174,164,115,162,99,67,69,860,136,996,13.654618473895582
18039,330455705220291,144,191,190,117,168,120,48,58,930,106,1036,10.231660231660232
18040,330455705220292,156,178,201,134,160,135,67,92,964,159,1123,14.158504007123776
18041,330455705220293,123,166,152,126,133,122,45,64,822,109,931,11.707841031149302
18042,330455705220294,111,128,100,112,126,86,42,29,663,71,734,9.673024523160763
18043,330455705220295,39,54,57,49,53,49,24,17,301,41,342,11.988304093567251
18044,330455705220296,73,77,68,64,52,39,26,12,373,38,411,9.245742092457421
18045,330455705220297,103,110,118,114,84,63,47,31,592,78,670,11.64179104477612
18046,330455705220298,130,185,159,184,150,124,77,46,932,123,1055,11.658767772511847
18047,330455705220299,136,251,232,170,123,164,84,39,1076,123,1199,10.258548790658882
18048,330455705220300,92,97,122,119,57,117,86,20,604,106,710,14.929577464788732
18049,330455705220301,135,159,192,166,94,166,94,47,912,141,1053,13.39031339031339
18050,330455705220302,146,199,200,193,148,160,117,54,1046,171,1217,14.050944946589976
18051,330455705220303,114,138,134,137,128,123,87,43,774,130,904,14.380530973451327
18052,330455705220304,33,54,66,47,42,69,24,25,311,49,360,13.61111111111111
18053,330455705220305,87,78,105,73,51,26,7,6,420,13,433,3.0023094688221708
18054,330455705220306,0,99,1036,332,73,14,2,0,1554,2,1556,0.12853470437017994
18055,330455705220307,0,5,53,24,4,6,1,0,92,1,93,1.075268817204301
18056,330455705220308,0,2,114,123,58,27,5,0,324,5,329,1.5197568389057752
18057,330455705220310,0,1,21,15,12,9,5,5,58,10,68,14.705882352941176
18058,330455705220311,0,0,29,28,11,9,0,0,77,0,77,0.0
18059,330455705220312,0,41,666,409,159,38,2,1,1313,3,1316,0.22796352583586627
18060,330455705220313,0,8,407,421,208,67,31,5,1111,36,1147,3.1386224934612033
18061,330455705220314,0,59,1331,289,50,13,0,0,1742,0,1742,0.0
18062,330455705220315,0,1,88,45,18,5,2,0,157,2,159,1.2578616352201257
18063,330455705220316,0,7,276,212,41,10,2,0,546,2,548,0.36496350364963503
18064,330455705220317,0,0,6,31,6,2,0,0,45,0,45,0.0
18065,330455705220318,9,17,8,10,10,12,9,1,66,10,76,13.157894736842104
18066,330455705220319,89,99,86,79,68,50,21,23,471,44,515,8.54368932038835
18067,330455705220320,96,121,92,90,62,49,33,16,510,49,559,8.765652951699463
18068,330455705220321,141,126,119,74,92,54,29,15,606,44,650,6.769230769230769
18069,330455705220322,172,172,169,140,123,79,45,36,855,81,936,8.653846153846153
18070,330455705220323,128,120,118,128,99,71,39,33,664,72,736,9.782608695652174
18071,330455705220324,86,101,91,96,95,79,63,39,548,102,650,15.692307692307692
18072,330455705220325,99,80,103,89,67,45,26,29,483,55,538,10.223048327137546
18073,330455705220326,127,164,152,169,188,105,38,24,905,62,967,6.411582213029989
18074,330455705220327,110,147,97,136,145,83,50,26,718,76,794,9.571788413098236
18075,330455705220328,46,53,54,61,51,40,33,27,305,60,365,16.438356164383563
18076,330455705220329,96,145,122,112,118,97,52,27,690,79,769,10.273081924577372
18077,330455705220330,108,142,203,165,151,134,85,52,903,137,1040,13.173076923076923
18078,330455705220331,157,188,217,233,186,176,100,64,1157,164,1321,12.414837244511734
18079,330455705220332,112,189,178,172,155,161,77,43,967,120,1087,11.039558417663294
18080,330455705220333,80,116,135,97,113,128,49,40,669,89,758,11.741424802110817
18081,330455705220334,88,172,172,123,153,162,65,41,870,106,976,10.860655737704919
18082,330455705220335,132,141,158,169,119,127,75,51,846,126,972,12.962962962962964
18083,330455705220336,141,117,164,171,122,113,62,31,828,93,921,10.09771986970684
18084,330455705220337,82,111,135,125,122,81,61,37,656,98,754,12.9973474801061
18085,330455705220338,124,141,131,126,123,101,68,64,746,132,878,15.034168564920273
18086,330455705220339,46,39,50,48,30,10,13,1,223,14,237,5.9071729957805905
18087,330455705220340,37,87,43,65,68,40,13,16,340,29,369,7.8590785907859075
18088,330455705220341,149,233,182,189,194,120,41,46,1067,87,1154,7.538994800693241
18089,330455705220342,71,112,104,92,111,76,33,28,566,61,627,9.728867623604465
18090,330455705220343,105,172,137,115,134,103,57,25,766,82,848,9.669811320754716
18091,330455705220344,79,127,108,74,98,76,20,13,562,33,595,5.546218487394958
18092,330455705220345,140,220,171,149,170,145,87,32,995,119,1114,10.682226211849192
18093,330455705220346,50,102,75,84,78,77,26,26,466,52,518,10.038610038610038
18094,330455705220347,112,134,136,106,111,90,52,21,689,73,762,9.58005249343832
18095,330455705220348,92,151,105,110,118,100,47,27,676,74,750,9.866666666666667
18096,330455705220349,93,185,133,130,158,125,47,23,824,70,894,7.829977628635347
18097,330455705220350,91,157,128,91,128,98,39,41,693,80,773,10.349288486416558
18098,330455705220351,111,97,133,110,89,109,82,36,649,118,767,15.384615384615385
18099,330455705220352,116,119,124,89,85,105,67,46,638,113,751,15.046604527296937
18100,330455705220353,72,95,92,81,94,86,63,55,520,118,638,18.495297805642632
18101,330455705220354,280,296,315,267,216,163,96,76,1537,172,1709,10.064365125804564
18102,330455705220355,87,81,78,72,63,33,11,6,414,17,431,3.9443155452436196
18103,330455705220356,107,144,111,115,115,110,36,19,702,55,757,7.265521796565389
18104,330455705220357,111,105,115,94,59,61,36,10,545,46,591,7.783417935702199
18105,330455705220358,198,205,220,161,146,98,41,22,1028,63,1091,5.774518790100825
18106,330455705220359,141,139,120,118,96,47,22,11,661,33,694,4.755043227665706
18107,330455705220360,65,78,88,82,53,42,49,29,408,78,486,16.049382716049383
18108,330455705220361,195,187,211,169,126,98,77,38,986,115,1101,10.44504995458674
18109,330455705220362,108,146,133,134,91,72,56,36,684,92,776,11.855670103092784
18110,330455705220363,102,122,114,87,99,78,47,35,602,82,684,11.988304093567251
18111,330455705220364,12,14,27,24,17,20,9,6,114,15,129,11.627906976744185
18112,330455705220365,107,129,114,109,92,82,45,37,633,82,715,11.468531468531468
18113,330455705220366,102,125,107,85,85,86,38,30,590,68,658,10.33434650455927
18114,330455705220367,50,55,55,28,48,25,20,12,261,32,293,10.921501706484642
18115,330455705220368,117,131,121,109,82,66,50,39,626,89,715,12.447552447552448
18116,330455705220369,111,123,129,87,108,72,36,42,630,78,708,11.016949152542374
18117,330455705220370,82,114,104,90,77,58,37,30,525,67,592,11.317567567567568
18118,330455705220371,92,108,106,110,72,65,44,28,553,72,625,11.52
18119,330455705220372,80,77,91,76,65,60,24,27,449,51,500,10.2
18120,330455705220373,118,131,134,105,120,85,55,42,693,97,790,12.278481012658228
18121,330455705220374,94,107,124,95,85,86,47,24,591,71,662,10.725075528700906
18122,330455705220375,83,110,104,77,90,62,38,41,526,79,605,13.057851239669422
18123,330455705220376,62,117,110,161,83,72,41,42,605,83,688,12.063953488372093
18124,330455705220377,118,130,136,112,113,100,57,49,709,106,815,13.006134969325153
18125,330455705220378,100,125,104,107,105,84,50,65,625,115,740,15.54054054054054
18126,330455705220379,47,70,73,63,75,54,37,30,382,67,449,14.922048997772828
18127,330455705220380,85,134,145,128,112,109,62,59,713,121,834,14.508393285371703
18128,330455705220381,103,113,111,116,92,81,48,34,616,82,698,11.74785100286533
18129,330455705220382,116,106,130,107,64,74,60,27,597,87,684,12.719298245614034
18130,330455705220383,162,201,228,211,175,167,103,91,1144,194,1338,14.499252615844544
18131,330455705220384,62,89,141,114,90,124,79,59,620,138,758,18.20580474934037
18132,330455705220385,52,62,86,61,68,81,49,49,410,98,508,19.291338582677167
18133,330455705220386,56,87,86,76,111,70,76,55,486,131,617,21.231766612641817
18134,330455705220387,49,61,95,57,90,89,58,65,441,123,564,21.80851063829787
18135,330455705220388,97,146,155,140,176,147,101,103,861,204,1065,19.154929577464788
18136,330455705220389,46,44,61,45,35,30,25,14,261,39,300,13.0
18137,330455705220390,42,69,83,47,46,33,18,20,320,38,358,10.614525139664805
18138,330455705220391,96,133,155,118,82,86,40,39,670,79,749,10.54739652870494
18139,330455705220392,111,136,135,125,96,77,45,31,680,76,756,10.052910052910052
18140,330455705220393,115,120,116,95,92,60,31,18,598,49,647,7.5734157650695515
18141,330455705220394,81,69,78,81,48,61,28,25,418,53,471,11.252653927813164
18142,330455705220395,107,140,101,80,88,63,33,16,579,49,628,7.802547770700637
18143,330455705220396,75,78,139,115,88,97,79,47,592,126,718,17.54874651810585
18144,330455705220397,66,81,106,114,90,93,72,73,550,145,695,20.863309352517987
18145,330455705220398,68,57,97,90,72,66,44,45,450,89,539,16.512059369202227
18146,330455705220399,72,77,89,109,98,73,76,90,518,166,684,24.269005847953217
18147,330455705220400,70,122,148,153,119,99,101,77,711,178,889,20.022497187851517
18148,330455705220401,84,126,145,131,142,144,92,78,772,170,942,18.046709129511676
18149,330455705220402,103,143,131,133,135,125,80,90,770,170,940,18.085106382978722
18150,330455705220403,175,189,179,106,126,96,48,29,871,77,948,8.122362869198312
18151,330455705220404,190,186,166,122,86,56,34,25,806,59,865,6.820809248554913
18152,330455705220405,184,201,187,137,118,82,56,36,909,92,1001,9.19080919080919
18153,330455705220406,206,181,196,129,101,42,34,25,855,59,914,6.455142231947484
18154,330455705220407,95,137,112,71,72,41,15,25,528,40,568,7.042253521126761
18155,330455705220408,88,101,104,66,70,43,30,13,472,43,515,8.349514563106796
18156,330455705220409,81,99,98,80,101,47,35,37,506,72,578,12.456747404844291
18157,330455705220410,181,177,174,122,107,80,49,19,841,68,909,7.48074807480748
18158,330455705220411,86,100,80,73,75,60,36,16,474,52,526,9.885931558935361
18159,330455705220412,50,69,84,57,57,36,39,18,353,57,410,13.902439024390244
18160,330455705220413,90,111,104,93,58,65,34,30,521,64,585,10.94017094017094
18161,330455705220414,116,132,147,108,83,64,28,21,650,49,699,7.010014306151645
18162,330455705220415,98,127,120,91,93,85,43,47,614,90,704,12.784090909090908
18163,330455705220416,90,103,129,97,72,67,32,35,558,67,625,10.72
18164,330455705220417,60,91,76,66,64,44,24,17,401,41,442,9.276018099547512
18165,330455705220418,82,102,99,82,63,52,35,33,480,68,548,12.408759124087592
18166,330455705220419,80,103,86,88,83,53,30,16,493,46,539,8.534322820037106
18167,330455705220420,61,72,88,66,71,28,25,23,386,48,434,11.059907834101383
18168,330455705220421,70,126,210,147,128,142,120,37,823,157,980,16.020408163265305
18169,330455705220422,106,111,100,111,97,80,49,44,605,93,698,13.32378223495702
18170,330455705220423,86,123,169,126,119,123,79,52,746,131,877,14.937286202964652
18171,330455705220424,44,64,90,54,83,52,35,25,387,60,447,13.422818791946309
18172,330455705220425,95,134,162,130,135,93,62,38,749,100,849,11.778563015312132
18173,330455705220426,96,119,110,136,118,107,105,86,686,191,877,21.7787913340935
18174,330455705220427,49,67,42,57,77,28,15,15,320,30,350,8.571428571428571
18175,330455705220428,220,109,156,161,68,53,18,6,767,24,791,3.034134007585335
18176,330455705220429,202,210,151,134,97,92,43,15,886,58,944,6.1440677966101696
18177,330455705220430,117,136,134,114,125,72,39,52,698,91,789,11.533586818757922
18178,330455705220431,165,181,154,143,130,99,56,46,872,102,974,10.472279260780287
18179,330455705220432,67,114,106,103,82,100,45,41,572,86,658,13.069908814589665
18180,330455705220433,116,116,109,108,70,49,25,22,568,47,615,7.642276422764228
18181,330455705220434,133,136,157,156,130,89,80,46,801,126,927,13.592233009708737
18182,330455705220435,115,144,160,135,106,97,70,55,757,125,882,14.17233560090703
18183,330455705220436,95,126,128,117,105,109,76,68,680,144,824,17.475728155339805
18184,330455705220437,89,112,118,109,105,110,63,55,643,118,761,15.505913272010513
18185,330455705220438,83,94,73,101,74,78,52,35,503,87,590,14.745762711864407
18186,330455705220439,61,91,72,75,79,66,19,34,444,53,497,10.663983903420522
18187,330455705220440,35,41,32,33,19,23,15,9,183,24,207,11.594202898550725
18188,330455705220441,90,101,134,110,111,119,40,77,665,117,782,14.961636828644501
18189,330455705220442,56,130,203,78,177,79,67,39,723,106,829,12.78648974668275
18190,330455705220443,69,92,104,103,104,89,46,49,561,95,656,14.481707317073171
18191,330455705220444,108,160,175,127,155,153,75,66,878,141,1019,13.837095191364082
18192,330455705220445,34,42,45,37,37,27,13,14,222,27,249,10.843373493975903
18193,330455705220446,91,115,148,110,135,122,63,80,721,143,864,16.550925925925927
18194,330455705220447,88,106,123,97,115,73,59,44,602,103,705,14.609929078014185
18195,330455705220448,64,83,117,87,85,108,36,60,544,96,640,15.0
18196,330455705220449,76,117,122,106,117,98,44,47,636,91,727,12.5171939477304
18197,330455705220450,70,116,143,80,117,97,62,59,623,121,744,16.263440860215052
18198,330455705220451,118,152,152,150,151,112,46,67,835,113,948,11.919831223628693
18199,330455705220452,101,120,123,108,112,78,62,49,642,111,753,14.741035856573705
18200,330455705220453,138,155,203,140,121,121,46,27,878,73,951,7.676130389064143
18201,330455705220454,128,165,147,162,133,96,54,61,831,115,946,12.156448202959831
18202,330455705220455,102,128,129,113,88,79,77,39,639,116,755,15.364238410596027
18203,330455705220456,123,160,164,150,104,90,73,44,791,117,908,12.885462555066079
18204,330455705220457,52,88,64,80,70,63,31,17,417,48,465,10.32258064516129
18205,330455705220458,93,89,112,98,90,62,50,23,544,73,617,11.831442463533225
18206,330455705220459,168,209,177,197,156,130,91,52,1037,143,1180,12.11864406779661
18207,330455705220460,174,189,181,180,138,121,59,46,983,105,1088,9.650735294117647
18208,330455705220461,180,230,230,185,176,164,71,26,1165,97,1262,7.68621236133122
18209,330455705220462,141,188,155,166,132,88,45,38,870,83,953,8.709338929695697
18210,330455705220463,100,154,148,125,122,116,80,50,765,130,895,14.525139664804469
18211,330455705220464,34,48,48,52,33,42,12,8,257,20,277,7.2202166064981945
18212,330455705220465,223,295,207,190,172,116,65,27,1203,92,1295,7.104247104247104
18213,330455705220466,0,45,543,255,54,16,0,0,913,0,913,0.0
18214,330455705220467,118,112,102,81,50,51,24,12,514,36,550,6.545454545454546
18215,330455705220468,179,223,121,120,90,56,30,11,789,41,830,4.9397590361445785
18216,330455705220469,143,117,145,182,146,66,32,17,799,49,848,5.778301886792453
18217,330455705220470,101,119,86,135,109,60,17,11,610,28,638,4.38871473354232
18218,330455705220471,60,57,64,79,64,48,40,41,372,81,453,17.880794701986755
18219,330455705220472,110,100,120,115,103,53,26,19,601,45,646,6.96594427244582
18220,330455705220473,142,215,170,180,189,108,65,24,1004,89,1093,8.142726440988106
18221,330455705220474,95,128,102,97,100,92,42,11,614,53,667,7.946026986506746
18222,330455705220475,186,253,135,172,154,69,32,12,969,44,1013,4.343534057255677
18223,330455705220476,138,148,95,122,92,31,16,9,626,25,651,3.8402457757296466
18224,330455705220477,89,103,96,103,64,43,26,9,498,35,533,6.566604127579738
18225,330455705220478,100,100,79,101,63,24,4,6,467,10,477,2.0964360587002098
18226,330455705220479,78,123,140,89,117,96,43,19,643,62,705,8.794326241134751
18227,330455705220480,66,95,126,116,117,116,45,33,636,78,714,10.92436974789916
18228,330455705220481,112,196,133,123,186,107,50,43,857,93,950,9.789473684210526
18229,330455705220482,94,77,79,63,53,28,17,4,394,21,415,5.0602409638554215
18230,330455705220483,73,100,112,95,91,114,33,32,585,65,650,10.0
18231,330455705220484,107,183,130,160,155,101,85,60,836,145,981,14.780835881753314
18232,330455705220485,105,137,138,134,158,102,54,29,774,83,857,9.684947491248542
18233,330455705220486,132,164,119,187,169,91,33,29,862,62,924,6.70995670995671
18234,330455705220487,41,48,54,74,56,45,11,7,318,18,336,5.357142857142857
18235,330455705220488,91,128,83,158,132,88,39,9,680,48,728,6.593406593406593
18236,330455705220489,79,81,66,101,81,55,13,11,463,24,487,4.9281314168377826
18237,330455705220490,43,49,44,77,61,37,12,4,311,16,327,4.892966360856269
18238,330455705220491,52,50,58,55,43,33,20,11,291,31,322,9.627329192546584
18239,330455705220492,86,107,108,134,98,92,39,47,625,86,711,12.09563994374121
18240,330455705220493,176,203,212,239,150,107,58,37,1087,95,1182,8.037225042301184
18241,330455705220494,27,56,67,47,64,57,46,45,318,91,409,22.249388753056234
18242,330455705220495,37,51,55,50,48,48,36,28,289,64,353,18.13031161473088
18243,330455705220496,48,66,69,54,61,78,62,55,376,117,493,23.732251521298174
18244,330455705220497,65,93,81,74,59,55,43,18,427,61,488,12.5
18245,330455705220498,90,165,128,97,141,92,36,35,713,71,784,9.056122448979592
18246,330455705220499,33,61,71,53,69,66,32,29,353,61,414,14.734299516908212
18247,330455705220500,143,131,149,117,99,90,55,28,729,83,812,10.22167487684729
18248,330455705220501,74,52,75,112,78,43,19,11,434,30,464,6.4655172413793105
18249,330455705220502,60,83,105,113,89,136,80,34,586,114,700,16.285714285714285
18250,330455705220503,69,94,88,68,74,56,30,31,449,61,510,11.96078431372549
18251,330455705220504,101,138,119,102,107,89,64,40,656,104,760,13.68421052631579
18252,330455705220505,62,105,71,60,68,55,31,24,421,55,476,11.554621848739496
18253,330455705220506,97,103,91,89,65,65,47,32,510,79,589,13.412563667232597
18254,330455705220507,81,81,108,74,99,86,44,36,529,80,609,13.136288998357964
18255,330455705220508,83,128,91,173,134,70,51,43,679,94,773,12.160413971539457
18256,330455705220509,53,78,88,86,94,52,35,41,451,76,527,14.421252371916509
18257,330455705220510,69,89,94,96,100,91,48,32,539,80,619,12.924071082390952
18258,330455705220511,51,103,80,60,96,54,30,10,444,40,484,8.264462809917354
18259,330455705220512,83,134,121,71,124,80,41,27,613,68,681,9.985315712187958
18260,330455705220513,62,82,100,98,100,59,39,26,501,65,566,11.484098939929329
18261,330455705220514,94,109,113,103,122,95,42,55,636,97,733,13.233287858117325
18262,330455705220515,35,73,63,40,69,62,47,34,342,81,423,19.148936170212767
18263,330455705220516,95,133,111,101,83,71,44,25,594,69,663,10.407239819004525
18264,330455705220517,57,90,63,78,92,56,26,42,436,68,504,13.492063492063492
18265,330455705220518,61,102,81,70,76,43,35,28,433,63,496,12.701612903225806
18266,330455705220519,90,116,103,85,87,67,41,44,548,85,633,13.428120063191153
18267,330455705220520,76,86,100,68,90,84,41,29,504,70,574,12.195121951219512
18268,330455705220521,109,143,122,105,97,69,29,17,645,46,691,6.657018813314037
18269,330455705220522,100,120,116,137,99,60,21,15,632,36,668,5.389221556886228
18270,330455705220523,120,128,142,164,125,102,53,34,781,87,868,10.023041474654377
18271,330455705220524,69,87,119,69,75,78,31,17,497,48,545,8.807339449541285
18272,330455705220525,121,143,153,137,128,93,45,37,775,82,857,9.56826137689615
18273,330455705220526,87,101,102,101,99,74,40,43,564,83,647,12.828438948995363
18274,330455705220527,79,94,56,64,60,41,21,23,394,44,438,10.045662100456621
18275,330455705220528,40,41,49,57,69,54,55,51,310,106,416,25.48076923076923
18276,330455705220529,73,55,91,58,53,48,21,14,378,35,413,8.474576271186441
18277,330455705220530,62,95,100,85,90,78,43,38,510,81,591,13.705583756345177
18278,330455705220531,96,96,102,92,81,82,39,28,549,67,616,10.876623376623376
18279,330455705220532,80,93,77,107,71,44,13,15,472,28,500,5.6
18280,330455705220533,109,118,90,121,74,57,25,8,569,33,602,5.48172757475083
18281,330455705220534,83,101,104,98,105,70,58,50,561,108,669,16.143497757847534
18282,330455705220535,34,92,38,65,95,43,29,6,367,35,402,8.706467661691542
18283,330455705220536,116,119,113,102,105,74,45,32,629,77,706,10.906515580736544
18284,330455705220537,27,24,56,54,21,20,8,8,202,16,218,7.339449541284404
18285,330455705220538,124,153,185,140,123,95,45,36,820,81,901,8.990011098779135
18286,330455705220539,69,96,100,113,75,90,71,33,543,104,647,16.0741885625966
18287,330455705220540,33,52,81,45,44,49,14,7,304,21,325,6.461538461538462
18288,330455705220541,85,134,161,136,136,127,98,52,779,150,929,16.146393972012916
18289,330455705220542,86,124,109,87,78,56,26,17,540,43,583,7.375643224699829
18290,330455705220543,174,201,153,148,139,71,45,21,886,66,952,6.932773109243698
18291,330455705220544,231,232,177,151,109,70,39,11,970,50,1020,4.901960784313726
18292,330455705220545,145,216,153,115,105,70,29,8,804,37,841,4.399524375743163
18293,330455705220546,164,110,99,106,64,26,10,5,569,15,584,2.5684931506849313
18294,330455705220547,59,100,113,93,67,87,47,28,519,75,594,12.626262626262626
18295,330455705220548,212,247,207,237,186,105,63,31,1194,94,1288,7.298136645962733
18296,330455705220549,21,24,20,18,16,9,21,10,108,31,139,22.302158273381295
18297,330455705220550,27,30,32,42,22,10,4,6,163,10,173,5.780346820809249
18298,330455705220551,135,126,113,165,122,83,45,21,744,66,810,8.148148148148149
18299,330455705220552,56,55,83,64,43,40,13,7,341,20,361,5.54016620498615
18300,330455705220553,131,146,136,127,121,68,50,26,729,76,805,9.440993788819876
18301,330455705220554,124,160,161,95,103,77,36,11,720,47,767,6.127770534550195
18302,330455705220555,206,232,208,180,172,125,69,43,1123,112,1235,9.068825910931174
18303,330455705220556,70,55,79,46,45,42,19,14,337,33,370,8.91891891891892
18304,330455705220557,78,97,85,63,77,62,28,7,462,35,497,7.042253521126761
18305,330455705220558,34,21,49,28,22,23,14,1,177,15,192,7.8125
18306,330455705220559,242,299,333,282,237,166,82,34,1559,116,1675,6.925373134328358
18307,330455705220560,113,131,122,123,87,73,38,22,649,60,709,8.46262341325811
18308,330455705220561,24,14,16,6,11,8,2,3,79,5,84,5.9523809523809526
18309,330455705220562,7,5,3,4,10,4,3,1,33,4,37,10.81081081081081
18310,330455705220563,15,14,4,5,9,5,2,2,52,4,56,7.142857142857143
18311,330455705220564,20,28,10,12,15,3,3,1,88,4,92,4.3478260869565215
18312,330455705220565,43,54,34,36,24,25,9,6,216,15,231,6.4935064935064934
18313,330455705220566,27,27,32,34,24,25,8,11,169,19,188,10.106382978723405
18314,330455705220567,19,22,27,29,20,26,10,4,143,14,157,8.9171974522293
18315,330455705220568,85,109,114,106,80,80,45,27,574,72,646,11.145510835913313
18316,330455705220569,23,17,16,11,4,10,0,2,81,2,83,2.4096385542168677
18317,330455705220570,42,34,40,30,35,16,10,6,197,16,213,7.511737089201878
18318,330455705220571,48,56,34,42,28,34,12,7,242,19,261,7.2796934865900385
18319,330455705220572,84,75,46,40,52,9,8,3,306,11,317,3.470031545741325
18320,330455705220573,104,128,86,73,72,36,24,5,499,29,528,5.492424242424242
18321,330455705220574,17,27,30,15,17,15,3,0,121,3,124,2.4193548387096775
18322,330455705220575,17,30,16,16,16,14,8,1,109,9,118,7.627118644067797
18323,330455705220576,31,33,31,25,17,13,4,4,150,8,158,5.063291139240507
18324,330455705220577,39,34,30,33,24,21,9,3,181,12,193,6.217616580310881
18325,330455705220579,68,75,55,55,51,55,23,12,359,35,394,8.883248730964468
18326,330455705220580,18,22,16,28,22,17,12,8,123,20,143,13.986013986013987
18327,330455705220581,46,54,49,52,34,33,10,11,268,21,289,7.26643598615917
18328,330455705220582,19,13,22,11,12,17,6,8,94,14,108,12.962962962962964
18329,330455705220583,71,69,65,49,37,32,29,15,323,44,367,11.989100817438691
18330,330455705220584,80,65,69,51,33,21,6,2,319,8,327,2.4464831804281344
18331,330455705220585,85,81,96,56,47,45,17,14,410,31,441,7.029478458049887
18332,330455705220586,5,11,9,9,13,8,2,5,55,7,62,11.290322580645162
18333,330455705220587,53,56,42,43,28,30,8,8,252,16,268,5.970149253731344
18334,330455705220588,48,40,60,32,32,45,21,9,257,30,287,10.452961672473867
18335,330455705220589,67,47,46,35,17,17,11,7,229,18,247,7.287449392712551
18336,330455705220590,84,108,95,75,61,38,15,9,461,24,485,4.948453608247423
18337,330455705220591,33,35,37,29,27,24,15,8,185,23,208,11.057692307692308
18338,330455705220592,25,40,34,29,29,29,10,4,186,14,200,7.0
18339,330455705220593,38,54,56,51,40,36,23,20,275,43,318,13.522012578616351
18340,330455705220594,68,98,63,66,43,40,13,11,378,24,402,5.970149253731344
18341,330455705220595,90,93,87,82,70,71,27,21,493,48,541,8.872458410351202
18342,330455705220596,50,66,52,43,41,26,13,14,278,27,305,8.852459016393443
18343,330455705220597,95,111,111,71,99,62,32,23,549,55,604,9.105960264900663
18344,330455705220598,148,188,124,153,124,53,32,11,790,43,833,5.162064825930372
18345,330455705220599,99,101,109,58,72,52,21,17,491,38,529,7.183364839319471
18346,330455705220600,127,109,107,79,60,57,33,9,539,42,581,7.228915662650603
18347,330455705220601,135,152,139,123,82,87,58,24,718,82,800,10.25
18348,330455705220602,47,87,56,52,67,51,16,16,360,32,392,8.16326530612245
18349,330455705220603,157,145,141,104,80,59,23,14,686,37,723,5.117565698478561
18350,330455705220604,100,135,88,99,67,56,26,17,545,43,588,7.312925170068027
18351,330455705220605,0,27,131,65,47,18,2,1,288,3,291,1.0309278350515463
18352,330455705220606,0,0,186,245,124,45,5,0,600,5,605,0.8264462809917356
18353,330455705220607,0,7,190,168,47,10,1,0,422,1,423,0.2364066193853428
18354,330455705220608,0,0,4,14,17,14,11,0,49,11,60,18.333333333333332
18355,330455705220609,0,20,198,145,90,22,5,0,475,5,480,1.0416666666666667
18356,330455705220610,0,19,304,276,109,44,5,2,752,7,759,0.922266139657444
18357,330455705220611,0,48,573,167,31,11,1,0,830,1,831,0.12033694344163658
18358,330455705220612,0,100,478,146,39,11,0,0,774,0,774,0.0
18359,330455705220613,0,106,487,160,47,6,1,0,806,1,807,0.12391573729863693
18360,330455705220614,0,60,371,233,93,21,4,2,778,6,784,0.7653061224489796
18361,330455705220616,0,3,13,10,0,0,0,0,26,0,26,0.0
18362,330455705220617,28,24,26,33,25,27,22,30,163,52,215,24.186046511627907
18363,330455705220618,24,19,33,27,12,29,17,8,144,25,169,14.792899408284024
18364,330455705220627,128,183,142,134,114,77,36,28,778,64,842,7.600950118764845
18365,330455705220628,156,158,155,121,91,50,12,18,731,30,761,3.942181340341656
18366,330455705230001,139,147,150,181,141,74,49,21,832,70,902,7.760532150776053
18367,330455705230002,94,93,88,89,80,57,23,21,501,44,545,8.073394495412844
18368,330455705230003,116,214,212,192,180,124,75,57,1038,132,1170,11.282051282051283
18369,330455705230004,54,91,74,85,73,86,61,52,463,113,576,19.618055555555557
18370,330455705230005,93,131,118,108,99,95,58,28,644,86,730,11.780821917808218
18371,330455705230006,46,48,37,52,44,46,25,13,273,38,311,12.218649517684888
18372,330455705230007,97,114,98,121,97,72,44,34,599,78,677,11.521418020679468
18373,330455705230008,159,236,186,205,164,106,50,40,1056,90,1146,7.853403141361256
18374,330455705230009,176,192,173,257,178,98,52,41,1074,93,1167,7.969151670951157
18375,330455705230010,129,141,149,181,120,81,51,45,801,96,897,10.702341137123746
18376,330455705230011,117,148,161,174,141,92,68,51,833,119,952,12.5
18377,330455705230012,83,112,118,134,103,122,56,31,672,87,759,11.462450592885375
18378,330455705230013,64,74,82,66,66,60,28,18,412,46,458,10.043668122270743
18379,330455705230014,90,93,101,88,81,43,16,17,496,33,529,6.238185255198488
18380,330455705230015,112,145,120,108,83,52,35,21,620,56,676,8.284023668639053
18381,330455705230016,106,139,127,121,145,96,70,66,734,136,870,15.632183908045977
18382,330455705230017,159,163,125,154,107,65,54,14,773,68,841,8.085612366230677
18383,330455705230018,178,232,217,223,211,148,76,53,1209,129,1338,9.641255605381167
18384,330455705230019,112,136,135,142,107,101,67,32,733,99,832,11.899038461538462
18385,330455705230020,177,226,162,174,157,90,51,26,986,77,1063,7.243650047036689
18386,330455705230021,114,136,162,138,123,116,75,53,789,128,917,13.95856052344602
18387,330455705230022,65,124,99,99,93,67,40,37,547,77,624,12.33974358974359
18388,330455705230023,71,77,96,83,85,84,34,59,496,93,589,15.789473684210526
18389,330455705230024,74,103,100,87,87,92,49,62,543,111,654,16.972477064220183
18390,330455705230025,47,90,93,67,99,78,29,20,474,49,523,9.369024856596559
18391,330455705230026,115,159,163,143,149,152,68,40,881,108,989,10.920121334681497
18392,330455705230027,161,221,215,217,190,160,58,34,1164,92,1256,7.32484076433121
18393,330455705230028,136,180,119,159,129,67,54,25,790,79,869,9.090909090909092
18394,330455705230029,94,111,119,127,93,84,71,68,628,139,767,18.122555410691003
18395,330455705230030,79,106,114,105,118,88,52,61,610,113,723,15.629322268326417
18396,330455705230031,47,63,83,57,64,54,35,29,368,64,432,14.814814814814815
18397,330455705230032,48,77,79,122,83,101,56,42,510,98,608,16.11842105263158
18398,330455705230033,63,78,70,73,74,52,17,21,410,38,448,8.482142857142858
18399,330455705230034,96,107,139,131,132,126,59,53,731,112,843,13.2858837485172
18400,330455705230035,55,83,120,85,92,76,27,21,511,48,559,8.586762075134168
18401,330455705230036,35,38,42,53,44,38,20,13,250,33,283,11.66077738515901
18402,330455705230037,101,125,120,116,102,81,50,44,645,94,739,12.719891745602165
18403,330455705230038,191,201,150,143,107,88,40,28,880,68,948,7.172995780590718
18404,330455705230039,119,122,130,107,93,75,27,17,646,44,690,6.3768115942028984
18405,330455705230040,72,78,88,72,70,54,18,23,434,41,475,8.631578947368421
18406,330455705230041,88,126,68,75,75,41,27,11,473,38,511,7.436399217221135
18407,330455705230042,223,264,177,200,137,90,56,29,1091,85,1176,7.227891156462585
18408,330455705230043,201,193,161,154,101,94,54,36,904,90,994,9.054325955734406
18409,330455705230044,162,166,133,132,106,83,58,25,782,83,865,9.595375722543352
18410,330455705230045,192,307,149,179,139,95,54,34,1061,88,1149,7.658833768494343
18411,330455705230046,137,159,123,132,75,74,31,24,700,55,755,7.28476821192053
18412,330455705230047,177,187,140,111,107,60,25,17,782,42,824,5.097087378640777
18413,330455705230048,97,129,96,126,147,71,40,15,666,55,721,7.6282940360610265
18414,330455705230049,106,122,138,129,107,95,65,41,697,106,803,13.20049813200498
18415,330455705230050,71,76,77,74,50,33,26,14,381,40,421,9.501187648456057
18416,330455705230051,134,155,198,138,191,115,83,87,931,170,1101,15.440508628519527
18417,330455705230052,77,80,109,80,52,76,45,25,474,70,544,12.867647058823529
18418,330455705230053,65,77,86,79,91,53,40,18,451,58,509,11.394891944990176
18419,330455705230054,118,132,133,133,124,115,67,48,755,115,870,13.218390804597702
18420,330455705230055,33,28,32,37,28,14,12,13,172,25,197,12.690355329949238
18421,330455705230056,157,171,145,186,160,101,56,30,920,86,1006,8.548707753479125
18422,330455705230057,136,171,144,195,152,83,42,19,881,61,942,6.475583864118896
18423,330455705230058,93,109,112,127,93,71,42,24,605,66,671,9.836065573770492
18424,330455705230059,108,76,142,191,102,59,17,8,678,25,703,3.5561877667140824
18425,330455705230060,111,148,168,198,171,113,80,57,909,137,1046,13.097514340344167
18426,330455705230061,110,144,197,169,127,198,95,61,945,156,1101,14.168937329700272
18427,330455705230062,68,102,121,98,117,157,71,33,663,104,767,13.559322033898304
18428,330455705230063,91,187,193,175,179,189,120,62,1014,182,1196,15.217391304347826
18429,330455705230064,71,105,194,131,115,187,136,65,803,201,1004,20.0199203187251
18430,330455705230065,44,75,71,72,67,48,32,12,377,44,421,10.451306413301662
18431,330455705230066,72,90,93,93,84,86,53,40,518,93,611,15.220949263502455
18432,330455705230067,98,171,144,130,135,129,79,49,807,128,935,13.689839572192513
18433,330455705230068,92,151,149,146,162,113,23,14,813,37,850,4.352941176470588
18434,330455705230069,97,139,163,135,180,98,36,24,812,60,872,6.8807339449541285
18435,330455705230070,78,110,125,113,105,81,60,67,612,127,739,17.185385656292286
18436,330455705230071,54,72,92,75,82,94,67,54,469,121,590,20.508474576271187
18437,330455705230072,48,81,84,82,91,74,75,89,460,164,624,26.28205128205128
18438,330455705230073,55,71,98,93,90,111,101,108,518,209,727,28.74828060522696
18439,330455705230074,50,69,92,96,88,90,51,71,485,122,607,20.098846787479406
18440,330455705230075,47,51,79,75,52,77,69,29,381,98,479,20.45929018789144
18441,330455705230076,57,88,136,105,108,136,77,88,630,165,795,20.754716981132077
18442,330455705230077,51,90,86,106,84,89,60,48,506,108,614,17.58957654723127
18443,330455705230078,76,95,146,112,85,123,89,61,637,150,787,19.05972045743329
18444,330455705230079,40,74,75,76,94,73,59,63,432,122,554,22.021660649819495
18445,330455705230080,79,94,139,111,124,110,63,75,657,138,795,17.358490566037737
18446,330455705230081,84,90,112,97,107,128,46,32,618,78,696,11.206896551724139
18447,330455705230082,47,90,127,92,109,133,95,89,598,184,782,23.529411764705884
18448,330455705230083,88,133,133,117,120,121,80,83,712,163,875,18.62857142857143
18449,330455705230084,28,52,57,56,54,58,44,25,305,69,374,18.449197860962567
18450,330455705230085,82,90,126,110,108,88,55,39,604,94,698,13.46704871060172
18451,330455705230086,56,103,120,96,103,111,72,47,589,119,708,16.807909604519775
18452,330455705230087,117,181,192,194,155,182,139,81,1021,220,1241,17.7276390008058
18453,330455705230088,137,156,202,182,160,134,67,46,971,113,1084,10.424354243542435
18454,330455705230089,57,104,97,104,124,118,77,69,604,146,750,19.466666666666665
18455,330455705230090,66,107,97,93,104,79,60,62,546,122,668,18.263473053892216
18456,330455705230091,79,139,167,121,144,124,85,42,774,127,901,14.095449500554938
18457,330455705230092,97,152,174,126,186,142,81,42,877,123,1000,12.3
18458,330455705230093,159,192,160,227,201,185,79,43,1124,122,1246,9.791332263242376
18459,330455705230094,148,191,224,179,147,162,71,48,1051,119,1170,10.17094017094017
18460,330455705230095,102,97,112,105,129,95,59,60,640,119,759,15.678524374176549
18461,330455705230096,112,126,142,122,111,105,59,48,718,107,825,12.969696969696969
18462,330455705230097,190,224,140,245,166,72,37,34,1037,71,1108,6.407942238267148
18463,330455705230098,131,151,143,160,137,115,67,47,837,114,951,11.987381703470032
18464,330455705230099,94,110,114,121,100,81,47,30,620,77,697,11.047345767575322
18465,330455705230100,143,193,184,195,164,157,105,54,1036,159,1195,13.305439330543933
18466,330455705230101,82,105,127,115,126,94,43,25,649,68,717,9.483960948396096
18467,330455705230102,71,96,113,80,110,83,70,56,553,126,679,18.556701030927837
18468,330455705230103,54,67,49,49,44,23,14,14,286,28,314,8.9171974522293
18469,330455705230104,100,135,124,128,120,64,28,10,671,38,709,5.359661495063469
18470,330455705230105,90,101,106,116,116,96,63,59,625,122,747,16.331994645247658
18471,330455705230106,110,126,172,155,118,172,91,69,853,160,1013,15.79466929911155
18472,330455705230107,75,93,110,118,85,97,62,32,578,94,672,13.988095238095237
18473,330455705230108,131,182,153,151,201,141,56,21,959,77,1036,7.4324324324324325
18474,330455705230109,109,150,170,187,141,172,84,70,929,154,1083,14.219759926131117
18475,330455705230110,101,108,162,114,120,112,67,33,717,100,817,12.239902080783354
18476,330455705230111,92,127,166,135,149,159,86,61,828,147,975,15.076923076923077
18477,330455705230112,78,107,120,103,98,110,63,53,616,116,732,15.846994535519126
18478,330455705230113,65,120,135,96,110,129,83,74,655,157,812,19.334975369458128
18479,330455705230114,96,113,165,149,120,150,114,91,793,205,998,20.541082164328657
18480,330455705230115,46,71,65,68,72,60,41,36,382,77,459,16.775599128540303
18481,330455705230116,97,121,186,127,156,154,110,118,841,228,1069,21.328344246959777
18482,330455705230117,77,93,114,100,93,123,67,62,600,129,729,17.695473251028808
18483,330455705230118,75,100,114,96,125,123,66,94,633,160,793,20.1765447667087
18484,330455705230119,57,78,102,95,88,84,62,47,504,109,613,17.781402936378466
18485,330455705230120,59,85,126,118,103,135,64,41,626,105,731,14.36388508891929
18486,330455705230121,68,132,130,132,155,149,107,89,766,196,962,20.374220374220375
18487,330455705230122,71,124,141,111,113,106,82,71,666,153,819,18.681318681318682
18488,330455705230123,75,86,112,108,103,87,53,37,571,90,661,13.61573373676248
18489,330455705230124,63,114,103,83,108,97,61,72,568,133,701,18.97289586305278
18490,330455705230125,138,203,177,191,192,190,129,102,1091,231,1322,17.473524962178516
18491,330455705230126,65,111,122,98,134,104,76,60,634,136,770,17.662337662337663
18492,330455705230127,88,119,152,173,138,153,157,86,823,243,1066,22.795497185741088
18493,330455705230128,58,78,100,104,72,100,68,47,512,115,627,18.341307814992025
18494,330455705230129,73,87,118,91,89,112,69,45,570,114,684,16.666666666666668
18495,330455705230130,95,128,137,134,153,139,82,106,786,188,974,19.301848049281315
18496,330455705230131,61,123,69,74,94,76,42,43,497,85,582,14.604810996563574
18497,330455705230132,59,101,146,101,94,121,63,77,622,140,762,18.37270341207349
18498,330455705230133,84,99,100,101,111,88,47,50,583,97,680,14.264705882352942
18499,330455705230134,81,101,93,115,96,88,51,55,574,106,680,15.588235294117647
18500,330455705230135,89,95,141,121,133,115,88,86,694,174,868,20.046082949308754
18501,330455705230136,127,172,179,160,172,140,99,75,950,174,1124,15.480427046263346
18502,330455705230137,105,127,175,160,159,155,89,48,881,137,1018,13.457760314341847
18503,330455705230138,70,110,125,134,98,107,58,45,644,103,747,13.788487282463185
18504,330455705230139,106,127,152,121,128,99,66,33,733,99,832,11.899038461538462
18505,330455705230140,119,177,179,148,178,166,82,82,967,164,1131,14.500442086648983
18506,330455705230141,149,196,178,159,154,138,55,50,974,105,1079,9.731232622798888
18507,330455705230142,119,182,166,166,146,134,71,42,913,113,1026,11.01364522417154
18508,330455705230143,90,116,124,108,94,96,54,56,628,110,738,14.905149051490515
18509,330455705230144,82,133,145,121,136,107,56,49,724,105,829,12.665862484921592
18510,330455705230145,81,156,150,123,164,131,52,35,805,87,892,9.753363228699552
18511,330455705230146,98,143,132,106,130,101,44,32,710,76,786,9.669211195928753
18512,330455705230147,50,264,237,120,357,68,38,25,1096,63,1159,5.43572044866264
18513,330455705230148,44,55,51,84,60,49,32,15,343,47,390,12.051282051282051
18514,330455705230149,114,124,104,121,77,66,40,22,606,62,668,9.281437125748504
18515,330455705230150,189,244,166,190,164,127,33,27,1080,60,1140,5.2631578947368425
18516,330455705230151,71,107,80,94,69,47,25,12,468,37,505,7.326732673267327
18517,330455705230152,122,132,130,176,151,77,24,17,788,41,829,4.945717732207479
18518,330455705230153,142,159,166,192,180,96,58,20,935,78,1013,7.699901283316881
18519,330455705230154,58,92,87,69,94,90,34,31,490,65,555,11.711711711711711
18520,330455705230155,79,103,99,96,79,81,66,40,537,106,643,16.485225505443236
18521,330455705230156,118,136,110,106,84,46,29,9,600,38,638,5.956112852664577
18522,330455705230157,247,289,196,196,146,92,42,24,1166,66,1232,5.357142857142857
18523,330455705230158,62,107,111,75,96,83,48,44,534,92,626,14.696485623003195
18524,330455705230159,85,129,154,125,134,152,61,36,779,97,876,11.073059360730594
18525,330455705230160,111,147,186,147,135,162,95,50,888,145,1033,14.036786060019361
18526,330455705230161,137,179,178,166,188,135,35,26,983,61,1044,5.842911877394636
18527,330455705230162,104,145,146,143,143,127,45,29,808,74,882,8.390022675736962
18528,330455705230163,134,146,204,155,153,142,91,67,934,158,1092,14.468864468864469
18529,330455705230164,85,123,101,134,101,75,60,47,619,107,726,14.738292011019285
18530,330455705230165,127,148,190,179,128,135,106,51,907,157,1064,14.75563909774436
18531,330455705230166,122,155,167,149,117,133,71,39,843,110,953,11.54249737670514
18532,330455705230167,51,78,81,76,102,84,47,49,472,96,568,16.901408450704224
18533,330455705230168,125,160,158,138,136,132,72,56,849,128,977,13.101330603889458
18534,330455705230169,98,128,145,135,137,143,64,94,786,158,944,16.73728813559322
18535,330455705230170,76,99,127,138,106,107,113,71,653,184,837,21.983273596176822
18536,330455705230171,168,212,219,193,178,178,102,66,1148,168,1316,12.76595744680851
18537,330455705230172,89,104,135,135,113,125,91,63,701,154,855,18.01169590643275
18538,330455705230173,57,75,81,73,102,73,64,70,461,134,595,22.521008403361346
18539,330455705230174,107,114,116,111,150,102,61,65,700,126,826,15.254237288135593
18540,330455705230175,91,73,116,178,110,71,53,31,639,84,723,11.618257261410788
18541,330455705230176,93,92,120,102,85,68,27,15,560,42,602,6.976744186046512
18542,330455705230177,60,93,110,93,64,71,24,11,491,35,526,6.653992395437262
18543,330455705230178,70,93,102,104,75,86,76,28,530,104,634,16.40378548895899
18544,330455705230179,84,116,107,124,126,43,31,13,600,44,644,6.832298136645963
18545,330455705230180,76,102,153,121,108,75,27,23,635,50,685,7.299270072992701
18546,330455705230181,59,71,63,48,47,37,20,11,325,31,356,8.707865168539326
18547,330455705230182,73,88,65,59,42,26,23,19,353,42,395,10.632911392405063
18548,330455705230183,112,135,128,118,93,84,55,46,670,101,771,13.099870298313878
18549,330455705230184,153,166,96,154,71,48,34,22,688,56,744,7.526881720430108
18550,330455705230185,126,161,133,121,99,81,48,25,721,73,794,9.193954659949622
18551,330455705230186,95,135,144,99,121,126,63,48,720,111,831,13.35740072202166
18552,330455705230187,72,114,81,90,101,68,24,25,526,49,575,8.521739130434783
18553,330455705230188,261,253,304,333,217,149,101,44,1517,145,1662,8.724428399518652
18554,330455705230189,148,178,202,161,155,118,73,57,962,130,1092,11.904761904761905
18555,330455705230190,78,64,70,46,41,30,17,7,329,24,353,6.798866855524079
18556,330455705230191,72,98,86,87,80,68,51,45,491,96,587,16.35434412265758
18557,330455705230192,243,260,249,249,176,177,99,60,1354,159,1513,10.508922670191673
18558,330455705230193,139,138,160,156,120,101,103,57,814,160,974,16.427104722792606
18559,330455705230194,116,106,109,123,78,61,89,42,593,131,724,18.093922651933703
18560,330455705230195,142,206,158,179,132,86,40,38,903,78,981,7.951070336391437
18561,330455705230196,120,143,157,135,123,98,76,54,776,130,906,14.34878587196468
18562,330455705230197,96,136,115,102,91,69,76,44,609,120,729,16.46090534979424
18563,330455705230198,184,232,140,171,158,81,48,17,966,65,1031,6.304558680892337
18564,330455705230199,88,121,77,87,82,37,12,17,492,29,521,5.566218809980806
18565,330455705230200,74,98,135,100,93,134,41,21,634,62,696,8.908045977011493
18566,330455705230201,175,225,206,206,164,160,99,62,1136,161,1297,12.41326137239784
18567,330455705230202,30,45,44,59,33,38,20,12,249,32,281,11.387900355871887
18568,330455705230203,113,144,135,143,116,95,54,43,746,97,843,11.506524317912218
18569,330455705230204,148,195,158,169,137,121,40,37,928,77,1005,7.661691542288557
18570,330455705230205,137,158,135,140,116,82,44,29,768,73,841,8.680142687277051
18571,330455705230206,88,125,120,109,103,90,54,35,635,89,724,12.292817679558011
18572,330455705230207,142,172,166,166,111,89,48,30,846,78,924,8.441558441558442
18573,330455705230208,59,107,94,106,76,65,39,33,507,72,579,12.435233160621761
18574,330455705230209,98,110,115,122,107,88,51,50,640,101,741,13.630229419703104
18575,330455705230210,65,86,82,69,80,63,50,33,445,83,528,15.719696969696969
18576,330455705230211,78,102,74,89,80,69,44,26,492,70,562,12.455516014234876
18577,330455705230212,95,165,154,133,191,173,80,69,911,149,1060,14.056603773584905
18578,330455705230213,118,132,147,107,132,94,47,24,730,71,801,8.863920099875156
18579,330455705230214,92,137,105,107,118,116,59,50,675,109,784,13.903061224489797
18580,330455705230215,109,114,155,129,122,139,61,68,768,129,897,14.381270903010034
18581,330455705230216,46,58,75,58,71,70,27,21,378,48,426,11.267605633802816
18582,330455705230217,42,42,60,88,44,84,70,43,360,113,473,23.890063424947147
18583,330455705230218,55,70,74,80,94,88,47,51,461,98,559,17.531305903398927
18584,330455705230219,75,100,106,100,80,87,74,61,548,135,683,19.765739385065885
18585,330455705230220,85,106,125,127,116,115,104,61,674,165,839,19.66626936829559
18586,330455705230221,82,93,111,95,116,121,65,63,618,128,746,17.158176943699733
18587,330455705230222,84,85,90,89,51,42,35,13,441,48,489,9.815950920245399
18588,330455705230223,71,85,98,98,112,97,60,80,561,140,701,19.971469329529246
18589,330455705230224,66,88,111,136,80,102,65,70,583,135,718,18.802228412256266
18590,330455705230225,45,66,79,69,48,48,23,19,355,42,397,10.57934508816121
18591,330455705230226,59,76,121,89,66,96,65,60,507,125,632,19.77848101265823
18592,330455705230227,43,61,87,55,67,71,49,59,384,108,492,21.951219512195124
18593,330455705230228,35,47,54,55,36,34,31,35,261,66,327,20.18348623853211
18594,330455705230229,50,58,76,76,70,60,44,66,390,110,500,22.0
18595,330455705230230,11,9,15,23,15,18,16,13,91,29,120,24.166666666666668
18596,330455705230231,93,122,143,112,136,111,73,71,717,144,861,16.72473867595819
18597,330455705230232,72,93,125,105,103,91,52,42,589,94,683,13.762811127379209
18598,330455705230233,73,95,121,93,134,91,61,66,607,127,734,17.302452316076295
18599,330455705230234,140,167,163,193,155,165,95,106,983,201,1184,16.97635135135135
18600,330455705230235,109,125,114,114,107,72,42,24,641,66,707,9.335219236209335
18601,330455705230236,50,64,66,86,77,75,55,34,418,89,507,17.554240631163708
18602,330455705230237,58,76,128,78,91,102,44,19,533,63,596,10.570469798657719
18603,330455705230238,128,130,175,172,156,135,85,70,896,155,1051,14.747859181731684
18604,330455705230239,108,139,137,103,121,99,71,44,707,115,822,13.990267639902676
18605,330455705230240,33,45,43,34,47,36,17,12,238,29,267,10.861423220973784
18606,330455705230241,111,145,110,99,110,63,33,21,638,54,692,7.803468208092486
18607,330455705230242,143,177,143,118,109,78,41,18,768,59,827,7.134220072551391
18608,330455705230243,76,120,99,91,93,50,28,12,529,40,569,7.0298769771529
18609,330455705230244,115,177,161,146,176,174,59,51,949,110,1059,10.387157695939566
18610,330455705230245,23,31,27,32,28,20,13,10,161,23,184,12.5
18611,330455705230246,175,251,194,251,245,162,75,40,1278,115,1393,8.255563531945441
18612,330455705230247,174,252,198,259,242,139,103,65,1264,168,1432,11.731843575418994
18613,330455705230248,167,225,212,219,206,159,81,66,1188,147,1335,11.01123595505618
18614,330455705230249,41,78,73,70,81,76,41,72,419,113,532,21.2406015037594
18615,330455705230250,157,152,150,169,119,92,46,21,839,67,906,7.39514348785872
18616,330455705230251,67,105,87,98,77,77,39,34,511,73,584,12.5
18617,330455705230252,118,123,168,111,91,91,43,54,702,97,799,12.14017521902378
18618,330455705230253,104,108,114,110,95,72,55,52,603,107,710,15.070422535211268
18619,330455705230254,107,111,131,109,110,79,39,35,647,74,721,10.263522884882109
18620,330455705230255,11,7,14,10,9,9,3,3,60,6,66,9.090909090909092
18621,330455705230256,96,141,146,144,134,129,70,43,790,113,903,12.513842746400886
18622,330455705230257,87,129,86,98,57,49,37,15,506,52,558,9.31899641577061
18623,330455705230258,76,79,119,68,98,98,46,34,538,80,618,12.944983818770227
18624,330455705230259,76,127,161,108,159,145,74,54,776,128,904,14.15929203539823
18625,330455705230260,77,111,121,93,108,109,35,31,619,66,685,9.635036496350365
18626,330455705230261,59,86,78,75,81,49,30,27,428,57,485,11.75257731958763
18627,330455705230262,175,205,211,245,192,159,87,58,1187,145,1332,10.885885885885886
18628,330455705230263,72,113,106,116,99,86,67,36,592,103,695,14.820143884892087
18629,330455705230264,181,227,196,215,167,126,73,34,1112,107,1219,8.777686628383922
18630,330455705230265,92,140,132,97,127,83,50,28,671,78,749,10.413885180240321
18631,330455705230266,67,84,125,90,76,113,35,33,555,68,623,10.914927768860354
18632,330455705230267,70,74,124,102,79,105,51,20,554,71,625,11.36
18633,330455705230268,99,115,145,151,96,156,78,37,762,115,877,13.112884834663626
18634,330455705230269,115,145,131,172,170,143,83,50,876,133,1009,13.181367690782954
18635,330455705230270,66,61,69,50,51,32,23,12,329,35,364,9.615384615384615
18636,330455705230271,99,107,116,97,69,52,23,18,540,41,581,7.056798623063683
18637,330455705230272,54,115,111,82,85,98,48,39,545,87,632,13.765822784810126
18638,330455705230273,63,65,83,82,69,78,62,38,440,100,540,18.51851851851852
18639,330455705230274,85,109,111,102,103,107,85,74,617,159,776,20.489690721649485
18640,330455705230275,95,130,133,113,117,112,91,94,700,185,885,20.903954802259886
18641,330455705230276,109,145,157,138,134,143,108,90,826,198,1024,19.3359375
18642,330455705230277,52,66,86,63,57,79,42,33,403,75,478,15.690376569037657
18643,330455705230278,77,98,112,107,83,89,64,40,566,104,670,15.522388059701493
18644,330455705230279,28,0,0,0,0,0,0,0,28,0,28,0.0
18645,330455705230280,128,149,195,162,162,173,94,60,969,154,1123,13.713268032056991
18646,330455705230281,83,96,117,116,91,78,54,45,581,99,680,14.558823529411764
18647,330455705230282,51,88,74,55,61,71,48,31,400,79,479,16.49269311064718
18648,330455705230283,70,115,83,85,87,61,31,15,501,46,547,8.409506398537477
18649,330455705230284,315,318,335,368,270,168,85,56,1774,141,1915,7.362924281984334
18650,330455705230285,10,3,0,0,0,0,1,35,13,36,49,73.46938775510205
18651,330455705230286,131,127,137,157,103,99,35,20,754,55,809,6.798516687268233
18652,330455705230287,207,203,198,211,180,145,74,43,1144,117,1261,9.278350515463918
18653,330455705230288,142,162,170,184,159,172,96,118,989,214,1203,17.788861180382376
18654,330455705230289,67,58,47,67,70,29,15,11,338,26,364,7.142857142857143
18655,330455705230290,171,251,180,175,150,144,78,66,1071,144,1215,11.851851851851851
18656,330455705230291,137,178,201,179,188,150,84,59,1033,143,1176,12.15986394557823
18657,330455705230292,143,155,124,136,127,71,38,18,756,56,812,6.896551724137931
18658,330455705230293,115,163,113,99,89,72,43,15,651,58,709,8.180535966149506
18659,330455705230294,143,175,158,138,120,121,59,36,855,95,950,10.0
18660,330455705230295,99,137,105,85,70,73,25,20,569,45,614,7.328990228013029
18661,330455705230296,65,96,109,76,82,81,48,40,509,88,597,14.74036850921273
18662,330455705230297,117,148,151,131,170,115,70,68,832,138,970,14.22680412371134
18663,330455705230298,55,103,102,84,80,70,70,63,494,133,627,21.21212121212121
18664,330455705230299,70,108,80,88,90,74,70,43,510,113,623,18.13804173354735
18665,330455705230300,95,126,120,128,127,109,69,66,705,135,840,16.071428571428573
18666,330455705230301,171,220,228,197,170,163,76,68,1149,144,1293,11.136890951276103
18667,330455705230302,199,231,216,165,203,137,59,41,1151,100,1251,7.9936051159072745
18668,330455705230303,118,169,141,137,127,89,78,47,781,125,906,13.79690949227373
18669,330455705230304,80,107,92,99,101,62,54,41,541,95,636,14.937106918238994
18670,330455705230305,75,91,106,73,96,79,52,54,520,106,626,16.93290734824281
18671,330455705230306,46,50,60,59,47,47,33,37,309,70,379,18.46965699208443
18672,330455705230307,65,106,133,104,105,134,67,73,647,140,787,17.78907242693774
18673,330455705230308,134,165,155,142,176,134,81,112,906,193,1099,17.561419472247497
18674,330455705230309,88,118,113,105,91,95,64,50,610,114,724,15.74585635359116
18675,330455705230310,70,91,95,89,74,74,46,37,493,83,576,14.409722222222221
18676,330455705230311,64,107,85,76,83,82,27,39,497,66,563,11.72291296625222
18677,330455705230312,186,242,243,234,198,189,105,66,1292,171,1463,11.688311688311689
18678,330455705230313,126,153,189,149,136,164,84,55,917,139,1056,13.162878787878787
18679,330455705230314,69,94,109,95,69,79,43,36,515,79,594,13.2996632996633
18680,330455705230315,82,117,127,109,109,93,66,41,637,107,744,14.381720430107526
18681,330455705230316,114,168,145,148,163,129,100,70,867,170,1037,16.39344262295082
18682,330455705230317,66,96,109,96,102,82,71,45,551,116,667,17.391304347826086
18683,330455705230318,114,141,134,128,137,125,76,68,779,144,923,15.601300108342361
18684,330455705230319,53,29,61,51,38,56,44,40,288,84,372,22.580645161290324
18685,330455705230320,55,82,100,95,81,87,61,52,500,113,613,18.43393148450245
18686,330455705230321,39,57,80,64,71,57,60,51,368,111,479,23.173277661795407
18687,330455705230322,88,124,137,135,192,104,42,42,780,84,864,9.722222222222221
18688,330455705230323,57,78,91,79,78,78,55,64,461,119,580,20.517241379310345
18689,330455705230324,50,50,97,111,82,104,92,73,494,165,659,25.03793626707132
18690,330455705230325,15,25,47,29,45,38,32,54,199,86,285,30.17543859649123
18691,330455705230326,22,35,74,55,49,66,34,44,301,78,379,20.58047493403694
18692,330455705230327,15,29,35,34,30,33,33,49,176,82,258,31.782945736434108
18693,330455705230328,94,141,157,113,97,186,113,73,788,186,974,19.096509240246405
18694,330455705230329,60,67,111,80,73,91,33,28,482,61,543,11.233885819521179
18695,330455705230330,99,195,171,171,189,122,127,88,947,215,1162,18.502581755593805
18696,330455705230331,119,153,143,185,135,112,76,30,847,106,953,11.12277019937041
18697,330455705230332,104,138,150,143,161,125,71,58,821,129,950,13.578947368421053
18698,330455705230333,88,114,122,147,110,108,69,52,689,121,810,14.938271604938272
18699,330455705230334,112,129,149,138,120,127,74,48,775,122,897,13.600891861761427
18700,330455705230335,133,127,138,136,94,124,73,57,752,130,882,14.739229024943311
18701,330455705230336,78,102,104,124,83,77,69,25,568,94,662,14.19939577039275
18702,330455705230337,144,193,180,203,148,147,63,42,1015,105,1120,9.375
18703,330455705230338,88,96,111,85,78,70,47,26,528,73,601,12.146422628951747
18704,330455705230339,19,36,19,12,22,10,5,1,118,6,124,4.838709677419355
18705,330455705230340,36,46,56,63,46,39,28,34,286,62,348,17.816091954022987
18706,330455705230341,55,76,104,59,65,40,44,32,399,76,475,16.0
18707,330455705230342,100,146,153,84,127,133,43,32,743,75,818,9.168704156479217
18708,330455705230343,110,133,144,130,123,74,60,46,714,106,820,12.926829268292684
18709,330455705230344,105,123,91,128,113,61,58,29,621,87,708,12.288135593220339
18710,330455705230345,66,125,79,84,73,67,28,12,494,40,534,7.49063670411985
18711,330455705230346,107,138,147,102,164,91,67,49,749,116,865,13.410404624277456
18712,330455705230347,102,126,98,91,81,42,20,4,540,24,564,4.25531914893617
18713,330455705230348,91,109,137,129,85,93,58,32,644,90,734,12.26158038147139
18714,330455705230349,94,149,146,137,144,123,81,69,793,150,943,15.906680805938494
18715,330455705230350,85,104,121,102,97,87,75,48,596,123,719,17.10709318497914
18716,330455705230351,58,64,76,75,60,55,35,27,388,62,450,13.777777777777779
18717,330455705230352,59,89,98,98,88,71,37,26,503,63,566,11.130742049469964
18718,330455705230353,60,82,65,57,53,46,23,16,363,39,402,9.701492537313433
18719,330455705230354,88,96,76,89,55,39,22,9,443,31,474,6.540084388185654
18720,330455705230355,115,161,110,125,134,94,68,58,739,126,865,14.566473988439306
18721,330455705230356,117,171,133,106,120,109,52,49,756,101,857,11.785297549591599
18722,330455705230357,98,164,167,145,159,146,85,81,879,166,1045,15.885167464114833
18723,330455705230358,130,161,171,166,127,130,84,60,885,144,1029,13.994169096209912
18724,330455705230359,65,96,106,84,123,89,40,63,563,103,666,15.465465465465465
18725,330455705230360,74,110,104,108,127,91,55,69,614,124,738,16.802168021680217
18726,330455705230361,128,172,186,197,143,146,73,75,972,148,1120,13.214285714285714
18728,330455705230363,214,171,168,170,114,71,47,36,908,83,991,8.375378405650858
18729,330455705230364,145,167,169,205,122,113,73,45,921,118,1039,11.357074109720886
18730,330455705230365,120,156,150,128,120,91,61,43,765,104,869,11.967779056386652
18731,330455705230366,141,167,144,139,113,83,56,61,787,117,904,12.942477876106194
18732,330455705230367,134,158,138,132,132,98,45,47,792,92,884,10.407239819004525
18733,330455705230368,98,162,138,105,98,75,43,36,676,79,755,10.463576158940397
18734,330455705230369,119,127,115,111,80,62,53,34,614,87,701,12.410841654778887
18735,330455705230370,142,200,146,185,145,77,53,37,895,90,985,9.137055837563452
18736,330455705230371,141,189,129,108,112,75,35,21,754,56,810,6.91358024691358
18737,330455705230372,92,139,127,112,96,81,29,21,647,50,697,7.173601147776184
18738,330455705230373,78,167,85,111,104,68,30,22,613,52,665,7.819548872180451
18739,330455705230374,109,114,105,109,74,52,26,21,563,47,610,7.704918032786885
18740,330455705230375,81,131,118,86,98,64,53,37,578,90,668,13.47305389221557
18741,330455705230376,81,107,118,88,77,70,47,25,541,72,613,11.745513866231647
18742,330455705230377,66,88,109,93,78,58,44,18,492,62,554,11.191335740072201
18743,330455705230378,37,42,45,46,36,44,29,26,250,55,305,18.0327868852459
18744,330455705230379,103,162,133,128,126,86,45,30,738,75,813,9.22509225092251
18745,330455705230380,72,99,69,109,85,75,33,21,509,54,563,9.591474245115453
18746,330455705230381,146,186,114,127,122,57,40,21,752,61,813,7.503075030750307
18747,330455705230382,52,91,71,52,77,43,34,19,386,53,439,12.072892938496583
18748,330455705230383,46,84,49,55,76,35,34,28,345,62,407,15.233415233415233
18749,330455705230384,85,109,103,90,102,93,67,35,582,102,684,14.912280701754385
18750,330455705230385,89,112,148,108,111,100,56,36,668,92,760,12.105263157894736
18751,330455705230386,32,41,40,27,25,17,16,4,182,20,202,9.900990099009901
18752,330455705230389,197,225,218,265,170,90,44,26,1165,70,1235,5.668016194331984
18753,330455705230390,100,123,95,99,80,28,20,13,525,33,558,5.913978494623656
18754,330455705230391,81,115,81,76,61,33,12,8,447,20,467,4.282655246252677
18755,330455705230392,55,74,61,31,37,33,10,5,291,15,306,4.901960784313726
18757,330455705230394,77,88,78,55,37,35,22,9,370,31,401,7.73067331670823
18758,330455705230395,33,60,37,50,42,26,6,5,248,11,259,4.2471042471042475
18759,330455705230396,80,73,60,41,39,32,11,7,325,18,343,5.247813411078718
18760,330455705230397,83,91,59,62,49,35,20,14,379,34,413,8.232445520581114
18761,330455705230398,142,174,128,115,76,64,27,12,699,39,738,5.284552845528455
18762,330455705230399,115,110,135,82,55,45,15,15,542,30,572,5.244755244755245
18763,330455705230400,89,67,62,54,35,29,17,7,336,24,360,6.666666666666667
18764,330455705230401,91,122,94,85,70,45,20,10,507,30,537,5.58659217877095
18765,330455705230402,64,70,62,63,55,36,17,13,350,30,380,7.894736842105263
18766,330455705230403,81,79,86,60,64,53,29,18,423,47,470,10.0
18767,330455705230404,39,55,59,37,33,32,14,11,255,25,280,8.928571428571429
18768,330455705230405,80,91,82,79,67,54,25,19,453,44,497,8.853118712273641
18769,330455705230406,63,92,65,88,52,57,32,24,417,56,473,11.839323467230445
18770,330455705230407,85,123,112,105,123,67,46,37,615,83,698,11.89111747851003
18771,330455705230408,38,65,62,72,67,50,31,35,354,66,420,15.714285714285714
18772,330455705230409,137,201,166,159,175,91,70,68,929,138,1067,12.933458294283037
18773,330455705230410,40,80,67,53,66,42,27,8,348,35,383,9.138381201044387
18774,330455705230411,90,86,106,88,69,64,35,27,503,62,565,10.973451327433628
18775,330455705230412,101,172,142,107,141,109,56,28,772,84,856,9.813084112149532
18776,330455705230413,114,155,143,159,118,101,74,47,790,121,911,13.282107574094402
18777,330455705230414,133,173,186,147,110,116,64,45,865,109,974,11.190965092402465
18778,330455705230415,75,90,92,78,67,79,41,27,481,68,549,12.386156648451731
18779,330455705230416,84,115,123,117,75,113,64,51,627,115,742,15.498652291105122
18780,330455705230417,87,81,95,71,55,61,37,14,450,51,501,10.179640718562874
18781,330455705230418,72,70,83,79,58,49,38,22,411,60,471,12.738853503184714
18782,330455705230419,146,187,155,171,141,120,44,27,920,71,991,7.164480322906155
18783,330455705230420,128,146,105,119,99,71,35,17,668,52,720,7.222222222222222
18784,330455705230421,89,105,97,115,107,49,26,20,562,46,608,7.565789473684211
18785,330455705230422,38,41,42,40,33,27,19,12,221,31,252,12.301587301587302
18786,330455705230423,48,64,65,58,68,35,33,38,338,71,409,17.359413202933986
18787,330455705230424,100,100,141,129,94,114,71,60,678,131,809,16.19283065512979
18788,330455705230425,72,91,86,112,102,76,64,53,539,117,656,17.835365853658537
18789,330455705230426,183,210,227,240,202,161,96,67,1223,163,1386,11.76046176046176
18790,330455705230427,40,54,48,49,45,26,19,14,262,33,295,11.186440677966102
18791,330455705230428,76,76,89,64,68,64,26,28,437,54,491,10.9979633401222
18792,330455705230429,36,35,45,32,36,30,16,18,214,34,248,13.709677419354838
18793,330455705230430,82,128,124,69,81,67,33,31,551,64,615,10.40650406504065
18794,330455705230431,51,61,71,53,49,46,23,22,331,45,376,11.96808510638298
18795,330455705230432,59,89,89,51,51,39,35,18,378,53,431,12.296983758700696
18796,330455705230433,78,89,106,95,83,73,51,38,524,89,613,14.518760195758565
18797,330455705230434,125,148,131,108,101,98,50,28,711,78,789,9.885931558935361
18798,330455705230435,164,240,169,164,162,92,24,19,991,43,1034,4.158607350096712
18799,330455705230436,39,42,58,39,31,35,13,13,244,26,270,9.62962962962963
18800,330455705230437,102,128,94,91,92,67,26,13,574,39,613,6.362153344208809
18801,330455705230438,162,206,160,204,124,90,42,35,946,77,1023,7.526881720430108
18802,330455705230439,87,93,89,128,81,51,22,12,529,34,563,6.039076376554174
18803,330455705230440,135,220,174,157,152,93,57,46,931,103,1034,9.961315280464216
18804,330455705230441,181,233,223,244,217,137,36,41,1235,77,1312,5.8689024390243905
18805,330455705230442,153,171,136,143,123,99,55,57,825,112,937,11.953041622198507
18806,330455705230443,123,154,144,124,129,101,64,69,775,133,908,14.647577092511014
18807,330455705230444,113,137,119,114,112,67,42,51,662,93,755,12.317880794701987
18808,330455705230445,78,83,92,86,82,60,36,29,481,65,546,11.904761904761905
18809,330455705230446,149,176,158,135,156,134,50,62,908,112,1020,10.980392156862745
18810,330455705230447,115,172,153,122,168,95,60,51,825,111,936,11.85897435897436
18811,330455705230448,152,198,171,163,136,133,54,69,953,123,1076,11.431226765799256
18812,330455705230449,117,130,135,116,97,83,51,47,678,98,776,12.628865979381443
18813,330455705230450,129,172,172,127,151,84,34,36,835,70,905,7.734806629834254
18814,330455705230451,164,202,196,164,162,141,70,65,1029,135,1164,11.597938144329897
18815,330455705230452,76,139,135,105,112,99,63,57,666,120,786,15.267175572519085
18816,330455705230453,88,174,128,113,121,82,46,58,706,104,810,12.839506172839506
18817,330455705230454,128,183,182,155,163,135,87,62,946,149,1095,13.60730593607306
18818,330455705230455,87,91,72,91,69,67,35,32,477,67,544,12.316176470588236
18819,330455705230456,63,93,74,78,99,49,38,34,456,72,528,13.636363636363637
18820,330455705230457,85,122,89,102,94,65,59,36,557,95,652,14.570552147239264
18821,330455705230458,97,141,126,102,119,87,68,55,672,123,795,15.471698113207546
18822,330455705230459,102,91,113,88,91,63,50,41,548,91,639,14.241001564945227
18823,330455705230460,73,106,79,84,112,56,51,39,510,90,600,15.0
18824,330455705230461,54,75,66,51,65,41,18,9,352,27,379,7.124010554089709
18825,330455705230462,261,282,205,213,139,112,44,23,1212,67,1279,5.238467552775606
18826,330455705230463,108,175,119,120,129,80,33,19,731,52,783,6.641123882503193
18827,330455705230464,128,136,150,134,111,95,49,40,754,89,843,10.55753262158956
18828,330455705230465,110,129,110,113,117,59,44,48,638,92,730,12.602739726027398
18829,330455705230466,144,171,146,162,118,87,29,33,828,62,890,6.966292134831461
18830,330455705230467,99,128,129,100,101,80,30,31,637,61,698,8.739255014326648
18831,330455705230468,79,105,87,103,90,65,59,33,529,92,621,14.814814814814815
18832,330455705230469,115,152,172,118,135,121,75,63,813,138,951,14.511041009463723
18833,330455705230470,77,99,96,109,75,79,47,36,535,83,618,13.43042071197411
18834,330455705230471,74,117,121,76,94,61,52,30,543,82,625,13.12
18835,330455705230472,101,111,130,107,110,98,70,53,657,123,780,15.76923076923077
18836,330455705230473,104,129,112,101,130,82,48,37,658,85,743,11.440107671601615
18837,330455705230474,58,59,71,77,58,31,19,10,354,29,383,7.5718015665796345
18838,330455705230475,260,347,273,311,257,148,72,50,1596,122,1718,7.1012805587892895
18839,330455705230476,129,167,152,180,150,133,114,61,911,175,1086,16.114180478821364
18840,330455705230477,92,123,109,97,114,60,19,16,595,35,630,5.555555555555555
18841,330455705230478,97,143,87,125,83,54,39,14,589,53,642,8.255451713395638
18842,330455705230485,110,133,108,150,169,64,28,10,734,38,772,4.922279792746114
18843,330455705230486,190,239,189,225,183,108,64,46,1134,110,1244,8.842443729903536
18844,330455705230487,140,148,127,117,119,94,43,25,745,68,813,8.364083640836409
18845,330455705230488,222,241,191,240,174,103,43,23,1171,66,1237,5.335489086499596
18846,330455705230489,35,52,74,63,52,53,42,20,329,62,391,15.856777493606138
18847,330455705230490,77,109,81,77,94,74,40,44,512,84,596,14.093959731543624
18848,330455705230491,92,118,117,109,93,71,43,38,600,81,681,11.894273127753303
18849,330455705230492,126,126,87,85,73,42,17,10,539,27,566,4.770318021201414
18850,330455705230493,56,77,71,58,74,46,31,29,382,60,442,13.574660633484163
18851,330455705230494,82,96,86,55,75,42,24,18,436,42,478,8.786610878661088
18852,330455705230495,159,143,140,101,91,69,28,13,703,41,744,5.510752688172043
18853,330455705230496,122,131,172,133,112,166,107,47,836,154,990,15.555555555555555
18854,330455705230497,27,35,51,44,49,47,46,36,253,82,335,24.47761194029851
18855,330455705230498,92,104,114,107,87,58,67,28,562,95,657,14.459665144596652
18856,330455705230499,102,154,122,144,169,89,50,30,780,80,860,9.30232558139535
18857,330455705230500,129,178,161,174,177,145,91,49,964,140,1104,12.681159420289855
18858,330455705230501,91,144,125,108,156,132,47,40,756,87,843,10.320284697508896
18859,330455705230502,72,71,148,123,102,112,49,35,628,84,712,11.797752808988765
18860,330455705230503,107,142,198,140,121,154,82,33,862,115,977,11.770726714431934
18861,330455705230504,86,121,102,142,105,98,54,35,654,89,743,11.978465679676985
18862,330455705230505,130,145,140,153,148,115,69,48,831,117,948,12.341772151898734
18863,330455705230506,51,110,75,85,86,77,35,28,484,63,547,11.517367458866545
18864,330455705230507,63,66,87,80,75,89,53,65,460,118,578,20.41522491349481
18865,330455705230508,60,62,97,82,77,95,54,50,473,104,577,18.02426343154246
18866,330455705230509,74,90,94,73,85,90,50,51,506,101,607,16.639209225700164
18867,330455705230510,31,39,55,59,62,49,51,27,295,78,373,20.91152815013405
18868,330455705230511,80,99,120,96,108,86,76,50,589,126,715,17.622377622377623
18869,330455705230512,49,99,102,65,101,87,39,33,503,72,575,12.521739130434783
18870,330455705230513,36,64,77,70,67,65,42,38,379,80,459,17.429193899782135
18871,330455705230514,88,133,134,115,104,96,50,48,670,98,768,12.760416666666666
18872,330455705230515,365,217,183,387,165,53,35,30,1370,65,1435,4.529616724738676
18873,330455705230516,140,168,170,189,154,148,95,50,969,145,1114,13.016157989228008
18874,330455705230517,81,78,110,133,86,101,58,54,589,112,701,15.977175463623395
18875,330455705230518,72,101,97,108,103,54,39,39,535,78,613,12.724306688417618
18876,330455705230519,83,113,112,126,133,133,58,77,700,135,835,16.167664670658684
18877,330455705230520,57,91,85,80,106,66,64,65,485,129,614,21.009771986970684
18878,330455705230521,110,125,100,136,110,89,74,72,670,146,816,17.892156862745097
18879,330455705230522,154,168,174,121,121,87,57,47,825,104,929,11.194833153928956
18880,330455705230523,64,79,80,91,59,48,43,26,421,69,490,14.081632653061224
18881,330455705230524,63,75,125,92,108,101,68,66,564,134,698,19.197707736389685
18882,330455705230525,59,93,107,90,74,87,64,46,510,110,620,17.741935483870968
18883,330455705230526,65,93,125,95,150,134,39,37,662,76,738,10.29810298102981
18884,330455705230527,58,75,95,81,64,85,51,35,458,86,544,15.808823529411764
18885,330455705230528,114,133,180,174,135,138,56,21,874,77,951,8.096740273396424
18886,330455705230529,59,89,122,97,87,120,65,34,574,99,673,14.710252600297176
18887,330455705230530,91,111,146,128,104,120,58,28,700,86,786,10.94147582697201
18888,330455705230531,95,126,125,137,141,137,71,60,761,131,892,14.68609865470852
18889,330455705230532,68,106,118,87,113,105,54,46,597,100,697,14.347202295552368
18890,330455705230533,56,62,94,93,78,80,64,33,463,97,560,17.321428571428573
18891,330455705230534,162,160,129,210,151,86,61,67,898,128,1026,12.475633528265107
18892,330455705230535,98,91,117,151,89,64,30,16,610,46,656,7.012195121951219
18893,330455705230536,91,132,111,75,93,71,28,21,573,49,622,7.877813504823151
18894,330455705230537,92,82,52,123,80,43,30,17,472,47,519,9.05587668593449
18895,330455705230538,94,133,133,133,135,89,61,31,717,92,809,11.372064276885043
18896,330455705230539,101,143,125,124,99,79,45,42,671,87,758,11.477572559366754
18897,330455705230540,39,71,69,56,67,55,39,47,357,86,443,19.41309255079007
18898,330455705230541,55,86,89,88,77,87,37,50,482,87,569,15.289982425307556
18899,330455705230542,88,102,111,90,95,92,51,44,578,95,673,14.115898959881129
18900,330455705230543,61,69,118,89,73,89,75,46,499,121,620,19.516129032258064
18901,330455705230544,31,52,72,63,78,81,62,79,377,141,518,27.22007722007722
18902,330455705230545,41,59,54,64,53,55,29,17,326,46,372,12.365591397849462
18903,330455705230546,97,130,149,124,131,103,83,27,734,110,844,13.033175355450236
18904,330455705230547,103,134,123,153,103,110,64,56,726,120,846,14.184397163120567
18905,330455705230548,128,168,156,141,144,127,54,43,864,97,961,10.093652445369408
18906,330455705230549,90,157,116,115,166,99,61,71,743,132,875,15.085714285714285
18907,330455705230550,109,160,124,103,121,77,28,14,694,42,736,5.706521739130435
18908,330455705230551,57,72,80,78,48,74,30,25,409,55,464,11.85344827586207
18909,330455705230552,44,62,56,41,57,52,32,17,312,49,361,13.573407202216066
18910,330455705230553,73,82,71,82,86,53,33,33,447,66,513,12.865497076023392
18911,330455705230554,78,103,102,125,98,75,35,14,581,49,630,7.777777777777778
18912,330455705230555,153,172,150,184,116,137,55,51,912,106,1018,10.412573673870334
18913,330455705230556,71,86,91,82,92,72,29,17,494,46,540,8.518518518518519
18914,330455705230557,139,141,127,110,99,72,34,17,688,51,739,6.901217861975643
18915,330455705230558,77,79,87,79,82,60,29,14,464,43,507,8.481262327416173
18916,330455705230559,63,79,81,81,73,59,40,25,436,65,501,12.974051896207586
18917,330455705230560,133,162,170,173,146,118,91,44,902,135,1037,13.018322082931533
18918,330455705230561,101,123,86,117,84,69,32,21,580,53,633,8.372827804107425
18919,330455705230562,5,2,2,4,0,1,5,1,14,6,20,30.0
18920,330455705230563,235,243,177,275,280,113,62,29,1323,91,1414,6.435643564356436
18921,330455705230564,67,84,76,75,80,44,29,39,426,68,494,13.765182186234817
18922,330455705230565,119,219,133,139,129,83,33,23,822,56,878,6.378132118451025
18923,330455705230566,134,170,137,142,197,90,45,25,870,70,940,7.446808510638298
18924,330455705230567,122,154,165,128,110,111,46,39,790,85,875,9.714285714285714
18925,330455705230568,73,108,71,79,97,48,42,33,476,75,551,13.611615245009075
18926,330455705230569,139,165,160,137,140,98,66,60,839,126,965,13.05699481865285
18927,330455705230570,84,123,94,94,97,62,52,58,554,110,664,16.566265060240966
18928,330455705230571,78,129,102,93,110,65,50,47,577,97,674,14.391691394658753
18929,330455705230572,137,154,147,100,140,97,43,56,775,99,874,11.327231121281464
18930,330455705230573,66,71,74,75,51,52,36,36,389,72,461,15.61822125813449
18931,330455705230574,87,94,104,102,60,69,62,36,516,98,614,15.960912052117264
18932,330455705230575,46,50,86,83,47,26,4,3,338,7,345,2.028985507246377
18933,330455705230576,66,50,118,139,50,36,13,15,459,28,487,5.749486652977413
18934,330455705230577,130,126,95,89,68,33,13,4,541,17,558,3.046594982078853
18935,330455705230578,100,104,61,71,50,30,12,7,416,19,435,4.367816091954023
18936,330455705230579,48,61,85,79,82,75,64,40,430,104,534,19.475655430711612
18937,330455705230580,91,92,79,120,125,46,17,13,553,30,583,5.145797598627787
18938,330455705230581,80,116,110,88,112,75,23,15,581,38,619,6.138933764135703
18939,330455705230582,128,168,165,145,188,99,63,42,893,105,998,10.521042084168336
18940,330455705230583,138,202,155,161,147,94,57,38,897,95,992,9.576612903225806
18942,330455705230586,96,83,109,177,95,43,11,8,603,19,622,3.054662379421222
18943,330455705230587,104,110,131,203,119,67,27,17,734,44,778,5.655526992287918
18944,330455705230588,48,53,100,108,36,28,20,10,373,30,403,7.444168734491315
18945,330455705230589,60,71,65,135,59,35,19,7,425,26,451,5.764966740576496
18946,330455705230590,88,54,138,111,67,43,11,7,501,18,519,3.468208092485549
18947,330455705230591,42,80,64,80,82,60,45,41,408,86,494,17.408906882591094
18948,330455705230592,56,71,68,81,77,65,62,62,418,124,542,22.878228782287824
18949,330455705230593,126,139,112,169,132,77,39,20,755,59,814,7.2481572481572485
18950,330455705230594,60,74,110,75,76,100,49,33,495,82,577,14.211438474870018
18951,330455705230595,97,121,120,155,122,79,43,28,694,71,765,9.281045751633988
18952,330455705230596,118,119,84,177,130,81,35,18,709,53,762,6.955380577427822
18953,330455705230597,90,105,110,116,82,96,67,33,599,100,699,14.30615164520744
18954,330455705230598,79,94,142,148,101,33,25,15,597,40,637,6.279434850863423
18955,330455705230599,90,67,102,146,70,42,34,21,517,55,572,9.615384615384615
18956,330455705230600,67,105,96,81,79,65,48,25,493,73,566,12.897526501766784
18957,330455705230601,168,188,170,212,199,106,61,35,1043,96,1139,8.428446005267778
18958,330455705230602,32,45,67,64,62,67,49,38,337,87,424,20.5188679245283
18959,330455705230603,137,110,124,184,139,69,23,20,763,43,806,5.33498759305211
18960,330455705230604,101,93,119,136,112,84,43,18,645,61,706,8.640226628895185
18961,330455705230605,149,172,215,201,179,156,94,52,1072,146,1218,11.986863711001641
18962,330455705230606,127,135,124,160,74,49,27,15,669,42,711,5.9071729957805905
18963,330455705230607,61,51,52,125,53,29,7,2,371,9,380,2.3684210526315788
18964,330455705230608,51,59,47,97,61,21,21,5,336,26,362,7.18232044198895
18965,330455705230609,87,67,59,111,84,44,9,4,452,13,465,2.795698924731183
18966,330455705230610,88,114,144,122,129,139,82,50,736,132,868,15.2073732718894
18967,330455705230611,140,187,163,132,127,92,41,31,841,72,913,7.886089813800657
18968,330455705230612,224,270,200,224,162,85,48,27,1165,75,1240,6.048387096774194
18969,330455705230613,118,101,92,164,111,60,37,21,646,58,704,8.238636363636363
18970,330455705230614,110,141,112,122,121,82,41,53,688,94,782,12.020460358056265
18971,330455705230615,51,63,64,57,42,34,23,17,311,40,351,11.396011396011396
18972,330455705230616,75,88,90,95,89,72,41,20,509,61,570,10.701754385964913
18973,330455705230617,62,90,90,91,81,52,30,15,466,45,511,8.806262230919765
18974,330455705230618,36,45,58,42,37,70,35,30,288,65,353,18.413597733711047
18975,330455705230619,90,145,159,130,115,101,35,19,740,54,794,6.801007556675063
18976,330455705230620,140,138,114,79,96,69,24,21,636,45,681,6.607929515418502
18977,330455705230621,162,206,187,155,167,57,53,21,934,74,1008,7.341269841269841
18978,330455705230622,94,155,103,148,130,81,31,31,711,62,773,8.020698576972833
18979,330455705230623,66,62,92,53,54,65,34,19,392,53,445,11.910112359550562
18980,330455705230624,85,79,197,157,71,43,24,16,632,40,672,5.9523809523809526
18981,330455705230625,181,182,115,165,102,48,47,24,793,71,864,8.217592592592593
18982,330455705230626,68,121,106,76,66,55,29,29,492,58,550,10.545454545454545
18983,330455705230627,77,70,110,111,74,120,51,44,562,95,657,14.459665144596652
18984,330455705230628,84,143,167,123,117,115,29,49,749,78,827,9.4316807738815
18985,330455705230629,100,105,121,89,85,85,59,36,585,95,680,13.970588235294118
18986,330455705230630,49,73,69,92,81,47,19,10,411,29,440,6.590909090909091
18987,330455705230631,102,131,116,89,99,72,38,43,609,81,690,11.73913043478261
18988,330455705230632,43,55,60,82,66,63,48,68,369,116,485,23.917525773195877
18989,330455705230633,66,92,80,101,90,74,48,31,503,79,582,13.573883161512027
18990,330455705230634,93,112,105,68,66,51,24,10,495,34,529,6.427221172022684
18991,330455705230635,54,72,56,65,77,54,24,11,378,35,413,8.474576271186441
18992,330455705230636,153,140,113,132,103,52,40,15,693,55,748,7.352941176470588
18993,330455705230637,82,81,64,50,56,48,13,5,381,18,399,4.511278195488722
18994,330455705230638,22,19,24,34,11,21,8,4,131,12,143,8.391608391608392
18995,330455705230639,88,94,88,61,70,49,38,12,450,50,500,10.0
18996,330455705230640,64,108,63,88,66,55,34,20,444,54,498,10.843373493975903
18997,330455705230641,43,83,62,37,69,41,23,20,335,43,378,11.375661375661375
18998,330455705230642,68,107,81,80,72,39,31,15,447,46,493,9.330628803245435
18999,330455705230643,23,41,25,26,30,34,16,10,179,26,205,12.682926829268293
19000,330455705230644,74,60,76,45,40,31,11,1,326,12,338,3.5502958579881656
19001,330455705230645,71,103,55,64,50,34,13,11,377,24,401,5.985037406483791
19002,330455705230646,65,87,67,52,50,27,16,8,348,24,372,6.451612903225806
19003,330455705230647,62,64,62,56,62,34,14,7,340,21,361,5.8171745152354575
19004,330455705230648,42,48,46,30,41,31,6,3,238,9,247,3.6437246963562755
19005,330455705230649,43,57,47,44,37,34,16,12,262,28,290,9.655172413793103
19006,330455705230650,13,25,16,18,16,17,6,3,105,9,114,7.894736842105263
19007,330455705230651,83,91,76,51,53,32,18,7,386,25,411,6.082725060827251
19008,330455705230652,76,95,93,47,53,26,21,11,390,32,422,7.5829383886255926
19009,330455705230653,53,75,75,47,53,26,23,15,329,38,367,10.354223433242506
19010,330455705230654,78,98,83,78,64,28,28,20,429,48,477,10.062893081761006
19011,330455705230655,61,58,86,50,72,44,25,22,371,47,418,11.24401913875598
19012,330455705230656,49,54,66,44,39,48,22,20,300,42,342,12.280701754385966
19013,330455705230657,62,65,70,80,70,49,30,22,396,52,448,11.607142857142858
19014,330455705230658,64,80,43,66,33,23,10,5,309,15,324,4.62962962962963
19015,330455705230659,99,100,109,70,81,43,23,7,502,30,532,5.639097744360902
19016,330455705230660,84,85,65,52,47,41,11,3,374,14,388,3.6082474226804124
19017,330455705230661,45,53,44,51,39,36,13,13,268,26,294,8.843537414965986
19018,330455705230662,60,80,63,73,50,47,21,5,373,26,399,6.516290726817043
19019,330455705230663,86,123,82,65,74,39,23,15,469,38,507,7.495069033530572
19020,330455705230664,80,115,85,78,99,50,30,15,507,45,552,8.152173913043478
19021,330455705230665,58,67,62,61,49,34,27,20,331,47,378,12.433862433862434
19022,330455705230669,44,27,48,29,24,27,9,12,199,21,220,9.545454545454545
19023,330455705230670,67,70,55,58,33,30,28,8,313,36,349,10.315186246418339
19024,330455705230671,63,62,97,52,53,60,27,15,387,42,429,9.79020979020979
19025,330455705230672,55,67,81,52,41,61,26,15,357,41,398,10.301507537688442
19026,330455705230673,49,76,71,46,59,52,38,30,353,68,421,16.152019002375297
19027,330455705230674,70,122,121,101,107,88,39,26,609,65,674,9.643916913946587
19028,330455705230675,95,137,141,113,103,87,38,18,676,56,732,7.6502732240437155
19029,330455705230676,33,60,63,55,78,58,42,23,347,65,412,15.776699029126213
19030,330455705230677,59,72,67,51,52,30,22,19,331,41,372,11.021505376344086
19031,330455705230678,44,56,52,42,43,38,20,11,275,31,306,10.130718954248366
19032,330455705230679,88,91,156,219,77,50,22,3,681,25,706,3.5410764872521248
19033,330455705230682,49,70,68,56,75,49,29,27,367,56,423,13.238770685579196
19035,330455705230685,85,132,75,109,85,68,31,24,554,55,609,9.0311986863711
19036,330455705230686,88,131,99,89,77,53,27,13,537,40,577,6.932409012131716
19037,330455705230687,159,163,199,180,138,143,67,57,982,124,1106,11.211573236889693
19038,330455705230688,84,87,127,93,73,61,56,25,525,81,606,13.366336633663366
19039,330455705230689,99,102,122,95,95,78,35,29,591,64,655,9.770992366412214
19040,330455705230690,61,80,101,68,69,62,33,30,441,63,504,12.5
19041,330455705230691,146,134,112,138,82,48,20,8,660,28,688,4.069767441860465
19042,330455705230692,99,109,114,88,81,34,20,9,525,29,554,5.234657039711191
19043,330455705230693,176,166,144,139,90,49,24,13,764,37,801,4.619225967540574
19044,330455705230694,123,133,89,125,75,42,26,14,587,40,627,6.379585326953748
19045,330455705230695,114,133,123,122,108,52,24,17,652,41,693,5.916305916305916
19046,330455705230696,53,78,49,83,84,51,15,13,398,28,426,6.572769953051643
19047,330455705230697,33,59,47,63,62,52,51,51,316,102,418,24.401913875598087
19048,330455705230698,42,59,54,42,40,31,24,8,268,32,300,10.666666666666666
19049,330455705230699,62,77,70,66,38,42,21,10,355,31,386,8.031088082901555
19050,330455705230700,103,115,103,96,84,45,23,18,546,41,587,6.984667802385008
19051,330455705230701,55,87,65,71,66,49,24,15,393,39,432,9.027777777777779
19052,330455705230702,58,111,66,73,92,49,30,11,449,41,490,8.36734693877551
19053,330455705230703,79,92,116,120,92,84,57,37,583,94,677,13.884785819793205
19054,330455705230704,123,135,137,135,117,85,55,87,732,142,874,16.247139588100687
19055,330455705230705,44,65,52,55,61,40,47,20,317,67,384,17.447916666666668
19056,330455705230706,97,141,112,121,86,68,41,24,625,65,690,9.420289855072463
19057,330455705230707,44,69,87,68,72,92,70,52,432,122,554,22.021660649819495
19058,330455705230708,58,85,77,48,62,48,19,17,378,36,414,8.695652173913043
19059,330455705230710,63,84,95,82,81,75,40,21,480,61,541,11.275415896487985
19060,330455705230711,105,160,81,89,88,50,19,12,573,31,604,5.132450331125828
19061,330455705230712,68,101,100,117,116,84,47,50,586,97,683,14.202049780380673
19062,330455705230713,50,70,65,75,70,62,34,30,392,64,456,14.035087719298245
19063,330455705230714,43,58,76,64,62,88,48,19,391,67,458,14.62882096069869
19064,330455705230715,57,78,53,57,53,42,15,10,340,25,365,6.8493150684931505
19065,330455705230719,118,131,123,172,123,65,40,21,732,61,793,7.6923076923076925
19066,330455705230720,56,110,79,74,95,81,61,62,495,123,618,19.902912621359224
19067,330455705230721,196,259,197,211,164,96,57,24,1123,81,1204,6.7275747508305646
19068,330455705230722,90,97,68,113,92,61,25,18,521,43,564,7.624113475177305
19069,330455705230723,40,41,40,58,37,28,17,10,244,27,271,9.96309963099631
19070,330455705230724,67,79,56,63,43,21,10,8,329,18,347,5.187319884726225
19071,330455705230725,40,57,44,38,39,30,20,6,248,26,274,9.489051094890511
19072,330455705230726,94,116,77,94,65,46,31,15,492,46,538,8.550185873605948
19073,330455705230727,85,122,78,86,60,54,27,9,485,36,521,6.90978886756238
19074,330455705230728,51,55,32,46,29,20,9,3,233,12,245,4.8979591836734695
19075,330455705230729,61,81,75,48,64,55,21,10,384,31,415,7.469879518072289
19076,330455705230730,93,94,85,54,67,37,26,16,430,42,472,8.898305084745763
19077,330455705230731,124,171,122,125,116,81,27,19,739,46,785,5.859872611464968
19078,330455705230732,84,87,99,104,74,44,18,18,492,36,528,6.818181818181818
19079,330455705230733,137,171,108,97,91,43,8,6,647,14,661,2.118003025718608
19080,330455705230734,63,89,60,58,68,33,16,11,371,27,398,6.78391959798995
19081,330455705230735,38,47,68,62,52,55,23,29,322,52,374,13.903743315508022
19082,330455705230736,119,144,134,93,112,58,18,15,660,33,693,4.761904761904762
19083,330455705230737,67,81,71,99,66,38,16,8,422,24,446,5.381165919282512
19084,330455705230738,99,121,112,92,82,39,19,4,545,23,568,4.049295774647887
19085,330455705230739,70,99,67,77,63,27,14,6,403,20,423,4.7281323877068555
19086,330455705230740,135,175,145,191,113,92,47,21,851,68,919,7.399347116430903
19087,330455705230741,179,158,124,127,86,64,25,16,738,41,779,5.2631578947368425
19088,330455705230742,125,167,109,112,78,48,25,12,639,37,676,5.4733727810650885
19089,330455705230746,76,91,92,58,68,48,20,14,433,34,467,7.28051391862955
19090,330455705230747,94,84,105,120,80,63,44,19,546,63,609,10.344827586206897
19091,330455705230748,73,128,124,109,122,127,91,89,683,180,863,20.85747392815759
19092,330455705230749,94,120,109,105,102,53,49,46,583,95,678,14.011799410029498
19093,330455705230750,79,118,143,118,110,124,62,74,692,136,828,16.42512077294686
19094,330455705230751,82,122,100,115,100,65,36,32,584,68,652,10.429447852760736
19095,330455705230752,101,109,78,79,70,43,15,6,480,21,501,4.191616766467066
19097,330455705230754,18,27,29,18,27,13,7,5,132,12,144,8.333333333333334
19098,330455705230755,80,77,54,53,42,21,12,7,327,19,346,5.491329479768786
19099,330455705230756,89,85,81,77,54,37,17,6,423,23,446,5.15695067264574
19100,330455705230757,20,27,25,14,19,12,4,4,117,8,125,6.4
19101,330455705230758,61,86,67,50,50,35,23,17,349,40,389,10.282776349614396
19102,330455705230759,115,133,110,118,95,69,31,16,640,47,687,6.841339155749636
19103,330455705230760,29,20,17,20,14,9,8,2,109,10,119,8.403361344537815
19104,330455705230761,64,64,43,50,33,19,10,4,273,14,287,4.878048780487805
19105,330455705230762,85,122,95,77,60,47,16,14,486,30,516,5.813953488372093
19106,330455705230763,48,60,41,36,35,24,12,6,244,18,262,6.870229007633588
19107,330455705230764,39,82,50,45,44,25,11,5,285,16,301,5.3156146179401995
19108,330455705230765,41,58,41,41,26,25,10,4,232,14,246,5.691056910569106
19109,330455705230766,80,74,67,80,48,38,12,9,387,21,408,5.147058823529412
19110,330455705230767,77,128,103,75,94,59,15,11,536,26,562,4.6263345195729535
19111,330455705230768,22,23,22,12,11,7,7,2,97,9,106,8.49056603773585
19112,330455705230769,77,64,65,61,42,41,20,14,350,34,384,8.854166666666666
19113,330455705230770,34,49,39,41,24,23,11,4,210,15,225,6.666666666666667
19114,330455705230771,57,66,61,72,65,42,19,15,363,34,397,8.564231738035264
19115,330455705230772,46,65,57,41,37,18,13,4,264,17,281,6.049822064056939
19116,330455705230773,26,42,33,31,23,28,21,7,183,28,211,13.270142180094787
19117,330455705230774,52,57,41,47,29,30,14,16,256,30,286,10.48951048951049
19118,330455705230775,17,8,8,7,4,1,1,1,45,2,47,4.25531914893617
19119,330455705230776,45,76,39,37,58,24,8,10,279,18,297,6.0606060606060606
19120,330455705230777,63,62,69,54,51,43,15,14,342,29,371,7.816711590296496
19121,330455705230778,8,11,17,8,8,11,3,4,63,7,70,10.0
19122,330455705230779,8,9,7,4,10,9,0,3,47,3,50,6.0
19123,330455705230780,13,13,14,7,10,7,1,4,64,5,69,7.246376811594203
19124,330455705230781,44,45,42,47,39,29,6,9,246,15,261,5.747126436781609
19125,330455705230782,2,6,2,4,3,3,6,0,20,6,26,23.076923076923077
19126,330455705230783,49,49,55,50,21,10,9,1,234,10,244,4.098360655737705
19127,330455705230784,57,48,53,47,22,20,9,9,247,18,265,6.7924528301886795
19128,330455705230785,15,17,17,7,10,4,1,1,70,2,72,2.7777777777777777
19129,330455705230786,27,24,21,21,19,10,4,2,122,6,128,4.6875
19130,330455705230787,24,32,30,16,15,13,6,6,130,12,142,8.450704225352112
19131,330455705230788,3,1,5,3,2,4,2,0,18,2,20,10.0
19132,330455705230789,35,31,36,34,32,26,9,6,194,15,209,7.177033492822966
19133,330455705230790,17,39,25,21,29,16,8,2,147,10,157,6.369426751592357
19134,330455705230791,29,30,22,25,20,18,5,5,144,10,154,6.4935064935064934
19135,330455705230792,159,157,126,110,66,28,8,7,646,15,661,2.26928895612708
19136,330455705230793,14,11,13,12,5,10,4,1,65,5,70,7.142857142857143
19137,330455705230794,52,78,61,50,49,20,11,5,310,16,326,4.9079754601226995
19138,330455705230795,37,20,28,12,5,5,5,0,107,5,112,4.464285714285714
19139,330455705230796,115,140,114,93,90,42,12,6,594,18,612,2.9411764705882355
19140,330455705230797,49,60,58,54,45,34,13,13,300,26,326,7.975460122699387
19141,330455705230798,116,83,80,64,52,30,17,4,425,21,446,4.708520179372197
19142,330455705230799,59,59,41,44,30,19,15,9,252,24,276,8.695652173913043
19143,330455705230800,21,39,31,28,29,13,4,6,161,10,171,5.847953216374269
19144,330455705230801,59,67,54,62,63,34,18,10,339,28,367,7.629427792915531
19145,330455705230802,19,25,7,20,12,5,3,1,88,4,92,4.3478260869565215
19146,330455705230803,57,54,45,60,31,35,29,20,282,49,331,14.803625377643504
19147,330455705230804,18,29,29,19,16,10,2,1,121,3,124,2.4193548387096775
19148,330455705230805,17,12,11,13,2,6,2,4,61,6,67,8.955223880597014
19149,330455705230806,163,198,171,176,163,81,36,20,952,56,1008,5.555555555555555
19150,330455705230807,43,56,41,32,38,21,10,6,231,16,247,6.477732793522267
19151,330455705230808,21,22,26,11,16,12,1,1,108,2,110,1.8181818181818181
19152,330455705230809,27,23,26,14,24,16,9,4,130,13,143,9.090909090909092
19153,330455705230810,41,48,61,44,31,29,23,18,254,41,295,13.898305084745763
19154,330455705230811,55,88,63,55,58,36,19,13,355,32,387,8.268733850129198
19155,330455705230812,214,264,189,204,134,95,58,30,1100,88,1188,7.407407407407407
19156,330455705230813,87,135,107,97,87,59,35,27,572,62,634,9.779179810725552
19157,330455705230814,11,11,10,21,10,12,4,3,75,7,82,8.536585365853659
19158,330455705230815,20,15,20,20,21,15,5,1,111,6,117,5.128205128205129
19159,330455705230816,20,29,20,21,35,8,12,4,133,16,149,10.738255033557047
19160,330455705230817,114,113,91,69,40,38,13,5,465,18,483,3.7267080745341614
19161,330455705230818,19,32,18,15,18,14,7,0,116,7,123,5.691056910569106
19162,330455705230819,68,86,67,48,59,30,11,5,358,16,374,4.278074866310161
19163,330455705230820,65,47,55,39,33,24,15,3,263,18,281,6.405693950177936
19164,330455705230821,82,109,51,98,52,30,25,11,422,36,458,7.860262008733624
19165,330455705230822,12,15,3,7,7,6,3,2,50,5,55,9.090909090909092
19166,330455705230823,21,29,17,28,14,12,8,3,121,11,132,8.333333333333334
19167,330455705230824,15,12,14,9,10,4,3,2,64,5,69,7.246376811594203
19168,330455705230825,38,56,23,33,35,24,7,3,209,10,219,4.566210045662101
19169,330455705230826,61,80,32,46,39,15,7,5,273,12,285,4.2105263157894735
19170,330455705230827,54,53,35,47,30,16,5,7,235,12,247,4.8582995951417
19171,330455705230828,7,11,7,6,8,5,1,1,44,2,46,4.3478260869565215
19173,330455705230848,103,96,85,130,127,50,20,24,591,44,635,6.929133858267717
19174,330455705230849,93,139,98,152,115,74,57,30,671,87,758,11.477572559366754
19175,330455705230850,120,125,127,122,140,77,39,26,711,65,776,8.376288659793815
19176,330455705230851,42,57,68,52,63,60,27,14,342,41,383,10.704960835509139
19177,330455705230852,93,107,84,96,92,56,27,19,528,46,574,8.013937282229966
19178,330455705230853,53,69,47,70,51,25,15,2,315,17,332,5.120481927710843
19179,330455705230854,87,103,108,92,117,78,35,34,585,69,654,10.55045871559633
19180,330455705230855,72,103,55,106,99,55,37,16,490,53,543,9.760589318600369
19181,330455705230856,135,153,121,137,132,79,47,30,757,77,834,9.232613908872901
19182,330455705230857,59,72,91,82,67,53,35,26,424,61,485,12.577319587628866
19183,330455705230858,153,153,146,174,130,70,29,30,826,59,885,6.666666666666667
19184,330455705230859,95,110,108,123,113,71,34,22,620,56,676,8.284023668639053
19185,330455705240001,79,129,107,86,105,79,41,14,585,55,640,8.59375
19186,330455705240002,93,95,104,82,68,92,47,39,534,86,620,13.870967741935484
19187,330455705240003,99,113,107,95,88,105,39,25,607,64,671,9.538002980625931
19188,330455705240004,79,83,109,86,60,82,42,34,499,76,575,13.217391304347826
19189,330455705240005,100,99,108,67,83,102,53,45,559,98,657,14.916286149162861
19190,330455705240006,81,80,104,97,62,73,43,29,497,72,569,12.653778558875219
19191,330455705240007,99,130,124,107,86,82,52,19,628,71,699,10.157367668097281
19192,330455705240008,98,127,111,107,88,110,61,44,641,105,746,14.075067024128685
19193,330455705240009,65,93,106,81,74,54,64,41,473,105,578,18.166089965397923
19194,330455705240010,59,90,97,52,72,76,26,29,446,55,501,10.978043912175648
19195,330455705240011,75,87,108,78,75,94,46,26,517,72,589,12.224108658743633
19196,330455705240012,107,108,138,88,80,87,46,40,608,86,694,12.39193083573487
19197,330455705240013,61,91,114,69,57,94,55,28,486,83,569,14.586994727592268
19198,330455705240014,84,62,101,119,69,42,12,8,477,20,497,4.0241448692152915
19199,330455705240015,108,132,117,135,107,90,50,53,689,103,792,13.005050505050505
19200,330455705240016,32,66,55,53,77,59,32,39,342,71,413,17.19128329297821
19201,330455705240017,79,133,108,89,116,134,69,86,659,155,814,19.04176904176904
19202,330455705240018,40,66,52,73,64,51,36,29,346,65,411,15.815085158150852
19203,330455705240019,146,182,188,162,143,115,61,43,936,104,1040,10.0
19204,330455705240020,74,111,105,95,96,63,32,24,544,56,600,9.333333333333334
19205,330455705240021,77,77,87,94,61,50,32,22,446,54,500,10.8
19206,330455705240022,57,68,72,54,48,44,14,6,343,20,363,5.509641873278237
19207,330455705240023,74,98,103,68,65,54,39,18,462,57,519,10.982658959537572
19208,330455705240024,61,61,71,44,67,34,15,5,338,20,358,5.58659217877095
19209,330455705240025,94,122,98,58,68,42,27,15,482,42,524,8.01526717557252
19210,330455705240026,98,137,101,95,69,47,34,13,547,47,594,7.912457912457913
19211,330455705240027,164,167,143,117,92,61,34,18,744,52,796,6.532663316582915
19212,330455705240028,104,125,144,136,77,109,82,39,695,121,816,14.82843137254902
19213,330455705240029,111,174,144,137,118,102,84,41,786,125,911,13.721185510428102
19214,330455705240030,80,92,96,119,49,84,59,29,520,88,608,14.473684210526315
19215,330455705240031,97,91,102,84,62,72,42,37,508,79,587,13.458262350936968
19216,330455705240032,92,108,96,105,71,65,45,23,537,68,605,11.239669421487603
19217,330455705240033,103,163,132,106,131,86,44,50,721,94,815,11.533742331288343
19218,330455705240034,48,63,59,59,45,60,27,25,334,52,386,13.471502590673575
19219,330455705240035,98,122,170,104,142,120,82,57,756,139,895,15.53072625698324
19220,330455705240036,86,101,109,108,109,86,57,64,599,121,720,16.805555555555557
19221,330455705240037,107,142,120,133,118,89,46,38,709,84,793,10.592686002522068
19222,330455705240038,36,44,39,47,35,43,20,23,244,43,287,14.982578397212544
19223,330455705240039,120,152,161,134,119,126,59,38,812,97,909,10.671067106710671
19224,330455705240040,87,129,150,132,116,121,51,32,735,83,818,10.146699266503667
19225,330455705240041,91,122,118,104,100,64,30,23,599,53,652,8.128834355828221
19226,330455705240042,90,149,112,113,126,95,60,63,685,123,808,15.222772277227723
19227,330455705240043,54,71,61,66,63,69,38,42,384,80,464,17.24137931034483
19228,330455705240044,85,109,122,90,116,84,58,28,606,86,692,12.427745664739884
19229,330455705240045,92,122,128,117,73,98,86,22,630,108,738,14.634146341463415
19230,330455705240046,142,210,152,159,168,108,76,32,939,108,1047,10.315186246418339
19231,330455705240047,164,121,90,116,47,33,20,9,571,29,600,4.833333333333333
19232,330455705240048,48,65,75,62,41,75,48,17,366,65,431,15.081206496519721
19233,330455705240049,45,83,101,53,82,84,50,28,448,78,526,14.828897338403042
19234,330455705240050,69,73,98,79,42,78,21,12,439,33,472,6.991525423728813
19235,330455705240051,134,175,153,132,153,92,61,38,839,99,938,10.554371002132196
19236,330455705240052,112,156,89,77,93,39,21,12,566,33,599,5.509181969949917
19237,330455705240053,138,175,124,128,96,64,28,16,725,44,769,5.721716514954486
19238,330455705240054,33,43,46,38,37,35,17,14,232,31,263,11.787072243346008
19239,330455705240055,102,127,78,75,67,33,13,12,482,25,507,4.930966469428008
19240,330455705240056,116,126,119,88,84,55,23,11,588,34,622,5.466237942122186
19241,330455705240057,100,107,72,84,62,47,23,4,472,27,499,5.410821643286573
19242,330455705240058,138,146,118,96,67,52,22,14,617,36,653,5.51301684532925
19243,330455705240059,144,166,127,106,76,46,22,15,665,37,702,5.27065527065527
19244,330455705240060,116,146,120,98,84,64,23,14,628,37,665,5.56390977443609
19245,330455705240061,159,188,161,136,132,98,50,45,874,95,969,9.803921568627452
19246,330455705240062,72,81,102,84,68,75,34,27,482,61,543,11.233885819521179
19247,330455705240063,54,56,70,49,48,43,30,32,320,62,382,16.230366492146597
19248,330455705240064,88,175,132,123,125,124,76,52,767,128,895,14.30167597765363
19249,330455705240065,64,87,104,60,93,79,33,33,487,66,553,11.934900542495479
19250,330455705240066,130,129,116,119,80,67,28,18,641,46,687,6.695778748180495
19251,330455705240067,56,85,85,91,67,53,41,29,437,70,507,13.806706114398422
19252,330455705240068,60,94,90,78,82,71,48,31,475,79,554,14.259927797833935
19253,330455705240069,54,71,73,64,58,44,31,27,364,58,422,13.744075829383887
19254,330455705240070,81,102,103,98,85,97,39,42,566,81,647,12.519319938176197
19255,330455705240071,64,80,95,85,81,68,33,42,473,75,548,13.686131386861314
19256,330455705240072,68,93,68,84,56,78,44,28,447,72,519,13.872832369942197
19257,330455705240073,94,106,125,109,87,97,58,39,618,97,715,13.566433566433567
19258,330455705240074,46,76,90,63,60,65,28,34,400,62,462,13.41991341991342
19259,330455705240075,167,158,166,189,139,122,110,55,941,165,1106,14.91862567811935
19260,330455705240076,59,96,77,88,71,50,47,37,441,84,525,16.0
19261,330455705240077,47,63,47,49,42,35,22,9,283,31,314,9.872611464968152
19262,330455705240078,66,61,69,65,42,38,22,26,341,48,389,12.339331619537274
19263,330455705240079,101,128,124,86,78,78,56,29,595,85,680,12.5
19264,330455705240080,122,127,73,83,48,54,23,18,507,41,548,7.481751824817518
19265,330455705240081,150,165,137,116,108,53,51,57,729,108,837,12.903225806451612
19266,330455705240082,46,34,58,46,31,27,13,6,242,19,261,7.2796934865900385
19267,330455705240083,45,108,304,159,94,66,59,10,776,69,845,8.165680473372781
19268,330455705240084,70,113,100,94,77,95,61,37,549,98,647,15.146831530139103
19269,330455705240085,104,159,169,137,106,118,82,42,793,124,917,13.522355507088331
19270,330455705240086,176,231,201,161,117,96,48,28,982,76,1058,7.183364839319471
19271,330455705240087,170,205,142,156,118,62,23,30,853,53,906,5.849889624724062
19272,330455705240088,159,150,144,128,85,64,41,29,730,70,800,8.75
19273,330455705240089,109,143,117,112,64,56,38,19,601,57,658,8.662613981762918
19274,330455705240090,77,94,102,88,83,60,23,18,504,41,545,7.522935779816514
19275,330455705240091,66,121,82,84,97,63,34,45,513,79,592,13.344594594594595
19276,330455705240092,85,107,101,106,90,62,37,34,551,71,622,11.414790996784566
19277,330455705240093,170,202,185,185,146,121,78,55,1009,133,1142,11.646234676007005
19278,330455705240094,166,171,176,153,134,113,65,37,913,102,1015,10.049261083743842
19279,330455705240095,62,76,114,64,102,82,35,44,500,79,579,13.644214162348877
19280,330455705240096,80,99,114,77,125,98,57,54,593,111,704,15.767045454545455
19281,330455705240097,31,41,34,28,32,29,19,15,195,34,229,14.847161572052402
19282,330455705240098,141,137,130,136,106,75,66,47,725,113,838,13.484486873508354
19283,330455705240099,27,22,19,25,29,19,12,7,141,19,160,11.875
19284,330455705240100,30,38,39,32,33,32,13,16,204,29,233,12.446351931330472
19285,330455705240101,63,72,72,40,40,40,11,14,327,25,352,7.1022727272727275
19286,330455705240102,103,151,121,126,98,104,80,39,703,119,822,14.476885644768856
19287,330455705240103,65,82,92,100,82,60,36,30,481,66,547,12.06581352833638
19288,330455705240104,61,78,68,56,68,71,47,28,402,75,477,15.723270440251572
19289,330455705240105,16,15,19,18,18,16,12,17,102,29,131,22.137404580152673
19290,330455705240106,30,38,43,29,26,28,20,7,194,27,221,12.217194570135746
19291,330455705240107,62,68,124,74,102,55,36,43,485,79,564,14.00709219858156
19292,330455705240108,124,143,136,116,113,82,33,27,714,60,774,7.751937984496124
19293,330455705240109,37,66,66,57,50,52,36,26,328,62,390,15.897435897435898
19294,330455705240110,48,78,74,51,43,39,28,18,333,46,379,12.137203166226913
19295,330455705240111,154,171,191,138,152,129,70,58,935,128,1063,12.041392285983067
19296,330455705240112,113,147,142,112,93,78,66,37,685,103,788,13.071065989847716
19297,330455705240113,169,215,215,209,147,140,80,41,1095,121,1216,9.950657894736842
19298,330455705240114,53,57,67,80,29,58,31,26,344,57,401,14.214463840399002
19299,330455705240115,95,142,130,132,95,114,48,38,708,86,794,10.831234256926953
19300,330455705240116,124,125,157,109,96,98,53,46,709,99,808,12.252475247524753
19301,330455705240117,134,160,139,123,116,90,56,39,762,95,857,11.085180863477246
19302,330455705240118,142,179,148,153,124,96,45,21,842,66,908,7.2687224669603525
19303,330455705240119,174,262,145,150,114,68,26,14,913,40,953,4.197271773347325
19304,330455705240120,113,150,100,84,71,41,21,12,559,33,592,5.574324324324325
19305,330455705240121,109,133,118,85,79,47,22,12,571,34,605,5.619834710743802
19306,330455705240122,209,287,173,179,139,70,38,11,1057,49,1106,4.430379746835443
19307,330455705240123,75,86,90,59,65,82,42,24,457,66,523,12.619502868068833
19308,330455705240124,127,163,180,126,123,116,64,23,835,87,922,9.436008676789587
19309,330455705240125,137,198,156,148,154,91,59,48,884,107,991,10.797174571140262
19310,330455705240126,79,117,121,114,89,101,61,42,621,103,724,14.226519337016574
19311,330455705240127,103,117,129,112,107,97,61,43,665,104,769,13.524057217165149
19312,330455705240128,93,111,106,85,65,58,25,22,518,47,565,8.31858407079646
19313,330455705240129,134,121,111,100,62,52,23,23,580,46,626,7.348242811501597
19314,330455705240130,103,147,136,134,98,109,66,28,727,94,821,11.449451887941535
19315,330455705240131,97,141,136,104,86,93,49,21,657,70,727,9.628610729023384
19316,330455705240132,57,62,67,48,42,44,24,19,320,43,363,11.845730027548209
19317,330455705240133,105,115,110,78,66,70,36,20,544,56,600,9.333333333333334
19318,330455705240134,125,116,88,86,61,29,22,10,505,32,537,5.95903165735568
19319,330455705240135,140,172,107,118,92,53,22,10,682,32,714,4.481792717086835
19320,330455705240136,102,99,84,64,52,32,20,7,433,27,460,5.869565217391305
19321,330455705240137,165,163,150,140,107,80,21,13,805,34,839,4.052443384982122
19322,330455705240138,118,135,136,111,84,67,69,35,651,104,755,13.774834437086092
19323,330455705240139,125,188,162,138,113,101,54,27,827,81,908,8.920704845814978
19324,330455705240140,81,127,109,77,82,104,39,32,580,71,651,10.906298003072196
19325,330455705240141,42,44,37,29,27,25,7,4,204,11,215,5.116279069767442
19326,330455705240142,2,6,6,1,4,4,0,0,23,0,23,0.0
19327,330455705240143,39,14,25,49,24,2,1,0,153,1,154,0.6493506493506493
19328,330455705240144,104,125,95,112,94,57,40,28,587,68,655,10.381679389312977
19329,330455705240145,199,229,191,234,156,93,51,31,1102,82,1184,6.925675675675675
19330,330455705240146,52,89,79,75,77,59,41,29,431,70,501,13.972055888223553
19331,330455705240147,105,141,128,109,111,98,49,24,692,73,765,9.542483660130719
19332,330455705240148,100,114,125,96,113,108,48,47,656,95,751,12.649800266311585
19333,330455705240149,99,87,72,108,69,30,19,11,465,30,495,6.0606060606060606
19334,330455705240150,77,140,98,90,94,57,39,26,556,65,621,10.466988727858293
19335,330455705240151,241,276,233,213,149,116,79,39,1228,118,1346,8.766716196136702
19336,330455705240152,94,118,111,76,93,95,51,32,587,83,670,12.388059701492537
19337,330455705240153,93,97,127,104,90,68,34,29,579,63,642,9.813084112149532
19338,330455705240154,113,136,128,149,130,118,60,68,774,128,902,14.19068736141907
19339,330455705240155,98,152,114,118,116,111,79,53,709,132,841,15.695600475624257
19340,330455705240156,74,108,125,90,75,95,50,46,567,96,663,14.479638009049774
19341,330455705240157,30,59,44,51,45,52,36,34,281,70,351,19.943019943019944
19342,330455705240158,38,46,38,67,50,46,25,31,285,56,341,16.422287390029325
19343,330455705240159,60,83,72,71,64,55,39,35,405,74,479,15.448851774530272
19344,330455705240160,61,66,75,80,70,63,45,50,415,95,510,18.627450980392158
19345,330455705240161,16,26,22,30,29,32,33,42,155,75,230,32.608695652173914
19346,330455705240162,36,75,48,77,72,66,38,27,374,65,439,14.806378132118452
19347,330455705240163,55,77,92,94,88,88,62,62,494,124,618,20.06472491909385
19348,330455705240164,71,104,114,105,95,96,54,56,585,110,695,15.827338129496402
19349,330455705240165,49,63,78,64,65,56,58,56,375,114,489,23.312883435582823
19350,330455705240166,69,127,139,109,136,100,86,66,680,152,832,18.26923076923077
19351,330455705240167,81,100,100,90,94,92,51,32,557,83,640,12.96875
19352,330455705240168,86,128,109,89,91,66,46,30,569,76,645,11.782945736434108
19353,330455705240169,59,70,65,71,53,43,21,21,361,42,403,10.421836228287841
19354,330455705240170,100,142,116,119,107,82,46,36,666,82,748,10.962566844919786
19355,330455705240171,71,88,73,67,65,46,23,19,410,42,452,9.29203539823009
19356,330455705240172,72,78,71,57,52,47,26,10,377,36,413,8.716707021791768
19357,330455705240173,158,185,137,150,115,76,35,23,821,58,879,6.598407281001138
19358,330455705240174,97,116,82,97,64,30,18,11,486,29,515,5.631067961165049
19359,330455705240175,107,160,175,177,136,123,45,24,878,69,947,7.286166842661035
19360,330455705240176,79,124,167,100,115,72,21,10,657,31,688,4.505813953488372
19361,330455705240177,124,152,144,151,101,94,45,30,766,75,841,8.9179548156956
19362,330455705240178,116,135,147,118,105,127,56,38,748,94,842,11.163895486935868
19363,330455705240179,163,211,183,181,167,122,61,64,1027,125,1152,10.850694444444445
19364,330455705240180,101,145,141,127,133,99,74,62,746,136,882,15.419501133786849
19365,330455705240181,103,147,126,128,108,105,38,42,717,80,797,10.037641154328734
19366,330455705240182,94,137,132,95,132,75,59,39,665,98,763,12.844036697247706
19367,330455705240183,52,53,68,70,64,57,35,28,364,63,427,14.754098360655737
19368,330455705240184,85,136,127,119,104,84,60,39,655,99,754,13.12997347480106
19369,330455705240185,83,88,113,102,101,82,38,32,569,70,639,10.954616588419405
19370,330455705240186,91,102,126,85,92,85,50,47,581,97,678,14.306784660766962
19371,330455705240187,114,117,130,125,80,70,35,34,636,69,705,9.787234042553191
19372,330455705240188,66,70,79,78,68,74,26,26,435,52,487,10.677618069815194
19373,330455705240189,170,159,176,165,142,118,62,22,930,84,1014,8.284023668639053
19374,330455705240190,53,78,103,86,75,70,49,17,465,66,531,12.429378531073446
19375,330455705240191,119,136,130,118,96,61,72,29,660,101,761,13.272010512483574
19376,330455705240192,61,82,78,90,62,59,50,29,432,79,511,15.459882583170254
19377,330455705240193,62,115,100,77,86,59,32,24,499,56,555,10.09009009009009
19378,330455705240194,75,119,120,92,122,104,50,35,632,85,717,11.854951185495118
19379,330455705240195,88,92,139,110,114,100,35,17,643,52,695,7.482014388489208
19380,330455705240196,120,123,120,140,107,88,61,32,698,93,791,11.757269279393173
19381,330455705240197,184,246,285,283,206,176,139,81,1380,220,1600,13.75
19382,330455705240198,46,40,44,53,43,38,29,31,264,60,324,18.51851851851852
19383,330455705240199,181,232,239,241,209,146,94,62,1248,156,1404,11.11111111111111
19384,330455705240200,80,118,96,93,98,67,40,25,552,65,617,10.53484602917342
19385,330455705240201,53,67,112,61,55,68,36,42,416,78,494,15.789473684210526
19386,330455705240202,67,93,82,85,102,81,58,55,510,113,623,18.13804173354735
19387,330455705240203,11,21,33,21,31,33,17,29,150,46,196,23.46938775510204
19388,330455705240204,54,72,90,84,65,79,64,56,444,120,564,21.27659574468085
19389,330455705240205,95,126,82,125,112,66,48,35,606,83,689,12.04644412191582
19390,330455705240206,119,155,160,124,110,88,64,47,756,111,867,12.802768166089965
19391,330455705240207,36,47,50,48,39,19,22,5,239,27,266,10.150375939849624
19392,330455705240208,65,111,52,61,61,36,25,20,386,45,431,10.440835266821345
19393,330455705240209,147,143,117,116,99,75,44,31,697,75,772,9.715025906735752
19394,330455705240210,250,263,194,169,116,93,38,23,1085,61,1146,5.322862129144852
19395,330455705240211,81,102,70,64,42,25,19,13,384,32,416,7.6923076923076925
19396,330455705240212,69,79,64,62,49,33,36,14,356,50,406,12.31527093596059
19397,330455705240213,184,175,145,103,73,48,33,19,728,52,780,6.666666666666667
19398,330455705240214,134,115,125,77,65,35,21,16,551,37,588,6.292517006802721
19399,330455705240215,85,111,95,73,52,37,19,16,453,35,488,7.172131147540983
19400,330455705240216,119,157,129,100,79,65,48,20,649,68,717,9.483960948396096
19401,330455705240217,147,163,136,113,71,59,33,33,689,66,755,8.741721854304636
19402,330455705240218,200,158,161,110,82,59,43,19,770,62,832,7.451923076923077
19403,330455705240219,50,65,42,60,38,17,17,17,272,34,306,11.11111111111111
19404,330455705240220,242,262,176,156,136,88,28,17,1060,45,1105,4.072398190045249
19405,330455705240221,109,95,85,66,78,44,23,17,477,40,517,7.7369439071566735
19406,330455705240222,130,159,126,122,93,61,32,25,691,57,748,7.620320855614973
19407,330455705240223,131,154,102,90,69,48,20,17,594,37,631,5.863708399366086
19408,330455705240224,130,123,122,105,81,73,40,25,634,65,699,9.298998569384835
19409,330455705240225,52,81,87,83,55,49,23,21,407,44,451,9.75609756097561
19410,330455705240226,76,109,87,73,76,61,48,34,482,82,564,14.539007092198581
19411,330455705240227,59,70,63,57,52,63,28,23,364,51,415,12.289156626506024
19412,330455705240228,139,186,145,138,94,81,47,30,783,77,860,8.953488372093023
19413,330455705240229,38,68,74,54,44,34,31,18,312,49,361,13.573407202216066
19414,330455705240230,26,28,31,27,22,25,12,11,159,23,182,12.637362637362637
19415,330455705240231,92,111,116,94,73,68,42,17,554,59,613,9.624796084828711
19416,330455705240232,75,114,101,97,92,48,33,25,527,58,585,9.914529914529915
19417,330455705240233,107,129,100,95,63,48,24,20,542,44,586,7.508532423208191
19418,330455705240234,231,265,237,216,171,90,47,23,1210,70,1280,5.46875
19419,330455705240235,98,114,128,83,81,78,40,20,582,60,642,9.345794392523365
19420,330455705240236,91,117,98,108,74,91,75,45,579,120,699,17.167381974248926
19421,330455705240237,89,154,95,118,96,58,47,28,610,75,685,10.94890510948905
19422,330455705240238,138,170,142,160,152,90,77,66,852,143,995,14.371859296482413
19423,330455705240239,138,154,154,157,106,90,82,41,799,123,922,13.34056399132321
19424,330455705240240,115,136,128,114,80,77,57,29,650,86,736,11.684782608695652
19425,330455705240241,105,152,108,128,85,70,77,36,648,113,761,14.848883048620236
19426,330455705240242,98,136,116,111,76,97,60,38,634,98,732,13.387978142076502
19427,330455705240243,87,94,75,69,64,51,46,22,440,68,508,13.385826771653543
19428,330455705240244,71,80,71,82,46,61,47,26,411,73,484,15.082644628099173
19429,330455705240245,63,95,89,91,54,79,60,28,471,88,559,15.742397137745975
19430,330455705240246,115,113,158,113,82,103,51,29,684,80,764,10.471204188481675
19431,330455705240247,88,118,145,119,73,102,83,30,645,113,758,14.907651715039577
19432,330455705240248,115,119,114,152,95,99,76,63,694,139,833,16.686674669867948
19433,330455705240249,144,170,159,160,113,113,79,49,859,128,987,12.968591691995947
19434,330455705240250,44,60,41,54,35,25,12,12,259,24,283,8.480565371024735
19435,330455705240251,94,108,88,81,77,62,42,20,510,62,572,10.839160839160838
19436,330455705240252,91,94,82,76,79,44,27,26,466,53,519,10.211946050096339
19437,330455705240253,159,142,124,96,102,89,33,19,712,52,764,6.806282722513089
19438,330455705240254,46,60,56,43,49,37,27,13,291,40,331,12.084592145015106
19439,330455705240255,79,72,65,59,46,54,17,14,375,31,406,7.635467980295567
19440,330455705240256,60,69,47,70,34,25,20,15,305,35,340,10.294117647058824
19441,330455705240257,246,204,120,99,60,47,23,13,776,36,812,4.433497536945813
19442,330455705240258,218,175,136,93,62,37,14,15,721,29,750,3.8666666666666667
19443,330455705240259,79,101,53,41,35,10,8,18,319,26,345,7.536231884057971
19444,330455705240260,262,217,143,127,114,42,25,20,905,45,950,4.7368421052631575
19445,330455705240261,190,185,123,70,72,29,12,13,669,25,694,3.602305475504323
19446,330455705240262,64,44,53,63,36,28,21,17,288,38,326,11.656441717791411
19447,330455705240263,35,64,44,51,37,33,34,10,264,44,308,14.285714285714286
19448,330455705240264,5,9,10,8,14,4,9,7,50,16,66,24.242424242424242
19449,330455705240265,152,141,133,124,102,75,35,18,727,53,780,6.794871794871795
19450,330455705240266,90,101,95,101,92,80,37,31,559,68,627,10.84529505582137
19451,330455705240267,136,177,113,133,124,69,27,13,752,40,792,5.05050505050505
19452,330455705240268,118,156,98,113,130,54,27,11,669,38,707,5.374823196605375
19453,330455705240269,169,231,174,160,134,101,39,22,969,61,1030,5.922330097087379
19454,330455705240270,91,119,134,107,105,68,45,26,624,71,695,10.215827338129497
19455,330455705240271,136,134,159,153,95,82,57,27,759,84,843,9.9644128113879
19456,330455705240272,88,82,75,54,72,44,45,53,415,98,513,19.103313840155945
19457,330455705240274,41,31,31,31,33,21,21,6,188,27,215,12.55813953488372
19458,330455705240275,160,152,171,140,88,55,33,32,766,65,831,7.821901323706378
19459,330455705240276,140,129,130,108,103,83,40,24,693,64,757,8.45442536327609
19460,330455705240277,93,108,85,89,94,54,35,42,523,77,600,12.833333333333334
19461,330455705240278,69,101,117,80,106,80,42,38,553,80,633,12.638230647709321
19462,330455705240279,81,103,96,111,76,96,48,46,563,94,657,14.307458143074582
19463,330455705240280,172,199,144,147,131,84,42,36,877,78,955,8.167539267015707
19464,330455705240281,63,81,92,88,75,89,54,39,488,93,581,16.006884681583475
19465,330455705240282,29,30,25,32,32,23,25,27,171,52,223,23.318385650224215
19466,330455705240283,15,50,30,38,27,45,40,25,205,65,270,24.074074074074073
19467,330455705240284,74,70,89,39,70,38,40,65,380,105,485,21.649484536082475
19468,330455705240285,87,111,97,84,104,67,44,23,550,67,617,10.85899513776337
19469,330455705240286,50,51,72,52,50,54,34,34,329,68,397,17.12846347607053
19470,330455705240287,54,51,54,52,33,54,44,41,298,85,383,22.193211488250654
19471,330455705240288,48,32,39,40,40,28,23,24,227,47,274,17.153284671532848
19472,330455705240289,70,97,64,76,68,61,44,32,436,76,512,14.84375
19473,330455705240290,49,70,66,56,45,54,38,31,340,69,409,16.87041564792176
19474,330455705240291,93,121,112,102,93,75,42,35,596,77,673,11.441307578008916
19475,330455705240292,97,111,106,95,77,99,48,35,585,83,668,12.425149700598803
19476,330455705240293,109,131,82,125,89,69,42,30,605,72,677,10.635155096011816
19477,330455705240294,52,98,60,63,59,48,18,29,380,47,427,11.007025761124122
19478,330455705240295,97,130,114,81,98,76,34,39,596,73,669,10.911808669656203
19479,330455705240296,100,91,94,86,68,73,44,26,512,70,582,12.027491408934708
19480,330455705240297,103,141,115,84,93,71,50,38,607,88,695,12.661870503597122
19481,330455705240298,72,100,75,80,74,66,51,33,467,84,551,15.245009074410163
19482,330455705240299,34,59,56,43,46,61,45,27,299,72,371,19.40700808625337
19483,330455705240300,78,106,90,81,84,66,43,33,505,76,581,13.080895008605852
19484,330455705240301,97,111,97,98,85,81,67,37,569,104,673,15.453194650817236
19485,330455705240302,83,119,115,83,85,84,56,45,569,101,670,15.074626865671641
19486,330455705240303,55,78,66,53,52,48,30,27,352,57,409,13.93643031784841
19487,330455705240304,59,95,76,82,75,75,48,27,462,75,537,13.966480446927374
19488,330455705240305,55,81,60,65,68,57,38,40,386,78,464,16.810344827586206
19489,330455705240306,46,56,66,53,41,63,33,41,325,74,399,18.546365914786968
19490,330455705240307,97,99,86,81,75,56,40,29,494,69,563,12.255772646536412
19491,330455705240308,47,47,60,44,56,39,23,18,293,41,334,12.275449101796408
19492,330455705240309,67,108,74,76,73,54,40,29,452,69,521,13.24376199616123
19493,330455705240310,88,125,112,90,103,110,61,43,628,104,732,14.207650273224044
19494,330455705240311,42,61,47,50,53,53,37,19,306,56,362,15.469613259668508
19495,330455705240312,58,68,56,54,56,54,31,29,346,60,406,14.77832512315271
19496,330455705240313,40,68,44,52,49,53,36,30,306,66,372,17.741935483870968
19497,330455705240314,71,100,78,90,88,80,41,45,507,86,593,14.502529510961214
19498,330455705240315,83,122,91,89,89,93,56,58,567,114,681,16.740088105726873
19499,330455705240316,108,128,109,83,107,70,32,24,605,56,661,8.472012102874432
19500,330455705240317,156,144,130,144,99,85,31,30,758,61,819,7.448107448107448
19501,330455705240318,30,26,34,28,16,20,15,13,154,28,182,15.384615384615385
19502,330455705240319,200,198,193,177,152,129,66,49,1049,115,1164,9.879725085910653
19503,330455705240320,118,133,91,109,103,76,61,22,630,83,713,11.640953716690042
19504,330455705240321,75,120,45,64,45,29,10,9,378,19,397,4.785894206549118
19505,330455705240322,74,66,78,52,57,46,30,24,373,54,427,12.646370023419204
19506,330455705240323,43,45,35,34,40,22,8,6,219,14,233,6.008583690987124
19507,330455705240324,87,103,103,85,72,51,25,13,501,38,539,7.050092764378479
19508,330455705240325,150,200,174,148,120,91,80,44,883,124,1007,12.313803376365442
19509,330455705240326,161,205,151,167,142,84,45,32,910,77,987,7.801418439716312
19510,330455705240327,66,76,67,68,56,41,31,16,374,47,421,11.163895486935868
19511,330455705240328,74,82,94,82,75,71,58,24,478,82,560,14.642857142857142
19512,330455705240329,76,68,83,60,71,65,48,42,423,90,513,17.54385964912281
19513,330455705240330,129,127,79,70,76,49,19,14,530,33,563,5.86145648312611
19514,330455705240331,241,264,220,164,116,98,44,25,1103,69,1172,5.887372013651877
19515,330455705240332,130,136,131,80,74,39,26,20,590,46,636,7.232704402515723
19516,330455705240333,104,111,110,99,97,81,52,30,602,82,684,11.988304093567251
19517,330455705240334,127,140,120,139,90,76,75,48,692,123,815,15.0920245398773
19518,330455705240335,13,22,15,17,14,8,10,3,89,13,102,12.745098039215685
19519,330455705240336,188,262,194,236,228,107,51,40,1215,91,1306,6.967840735068913
19520,330455705240337,104,141,98,80,115,50,24,25,588,49,637,7.6923076923076925
19521,330455705240338,152,134,84,104,86,45,28,27,605,55,660,8.333333333333334
19522,330455705240339,260,312,167,190,155,89,27,22,1173,49,1222,4.009819967266775
19523,330455705240340,181,142,95,92,81,50,26,14,641,40,681,5.873715124816447
19524,330455705240341,165,215,120,129,114,67,27,12,810,39,849,4.593639575971731
19525,330455705240342,225,204,133,124,108,70,34,21,864,55,919,5.984766050054407
19526,330455705240343,162,163,86,106,89,60,52,48,666,100,766,13.054830287206267
19527,330455705240344,94,140,93,108,68,41,28,21,544,49,593,8.263069139966273
19528,330455705240345,195,199,133,186,111,83,49,21,907,70,977,7.164790174002047
19529,330455705240346,105,122,122,117,97,69,48,29,632,77,709,10.860366713681241
19530,330455705240347,58,70,85,73,60,59,41,33,405,74,479,15.448851774530272
19531,330455705240348,87,107,90,112,93,57,33,22,546,55,601,9.151414309484194
19532,330455705240349,58,72,53,55,56,54,28,22,348,50,398,12.56281407035176
19533,330455705240350,75,57,109,105,82,55,33,10,483,43,526,8.17490494296578
19534,330455705240351,175,165,154,160,98,81,35,24,833,59,892,6.614349775784754
19535,330455705240352,204,241,198,186,172,106,43,31,1107,74,1181,6.265876375952582
19536,330455705240353,214,287,184,223,157,94,53,31,1159,84,1243,6.757843925985519
19537,330455705240354,139,149,110,86,69,61,25,14,614,39,653,5.972434915773354
19538,330455705240355,46,66,47,40,33,26,10,8,258,18,276,6.521739130434782
19539,330455705240356,33,48,35,31,34,24,11,14,205,25,230,10.869565217391305
19540,330455705240357,111,98,78,62,49,30,18,14,428,32,460,6.956521739130435
19541,330455705240358,54,58,52,41,36,35,25,24,276,49,325,15.076923076923077
19542,330455705240359,47,47,60,42,37,45,54,26,278,80,358,22.3463687150838
19543,330455705240360,85,100,97,70,83,79,51,38,514,89,603,14.759535655058043
19544,330455705240361,158,173,157,157,106,69,26,17,820,43,863,4.9826187717265356
19545,330455705240362,166,187,167,132,114,68,32,22,834,54,888,6.081081081081081
19546,330455705240363,129,140,120,147,92,48,24,14,676,38,714,5.322128851540616
19547,330455705240364,106,139,92,98,77,40,24,12,552,36,588,6.122448979591836
19548,330455705240365,82,118,66,83,74,36,17,10,459,27,486,5.555555555555555
19549,330455705240366,125,175,118,108,108,74,27,20,708,47,755,6.225165562913907
19550,330455705240367,173,228,147,152,103,70,38,14,873,52,925,5.621621621621622
19551,330455705240368,62,89,70,76,108,62,33,54,467,87,554,15.703971119133573
19552,330455705240369,48,49,32,51,25,29,24,7,234,31,265,11.69811320754717
19553,330455705240370,84,116,143,81,86,90,37,25,600,62,662,9.365558912386707
19554,330455705240371,74,75,80,74,59,36,28,10,398,38,436,8.715596330275229
19555,330455705240372,119,175,110,141,106,63,24,20,714,44,758,5.804749340369393
19556,330455705240373,91,99,80,93,68,40,22,32,471,54,525,10.285714285714286
19557,330455705240374,91,123,115,101,120,84,32,24,634,56,690,8.115942028985508
19558,330455705240375,79,112,107,107,71,72,62,23,548,85,633,13.428120063191153
19559,330455705240376,94,86,85,111,57,50,54,20,483,74,557,13.285457809694794
19560,330455705240377,60,88,64,87,32,53,36,20,384,56,440,12.727272727272727
19561,330455705240378,58,87,81,65,64,46,28,21,401,49,450,10.88888888888889
19562,330455705240379,65,83,94,86,85,63,45,24,476,69,545,12.660550458715596
19563,330455705240380,44,66,65,54,66,40,38,27,335,65,400,16.25
19564,330455705240381,82,90,90,87,46,52,44,17,447,61,508,12.007874015748031
19565,330455705240382,69,113,109,64,75,64,22,17,494,39,533,7.317073170731708
19566,330455705240383,54,55,36,52,61,18,15,9,276,24,300,8.0
19567,330455705240384,118,115,68,71,49,30,16,10,451,26,477,5.450733752620545
19568,330455705240385,85,116,99,112,99,90,42,29,601,71,672,10.56547619047619
19569,330455705240386,57,66,71,68,57,54,20,21,373,41,414,9.903381642512077
19570,330455705240387,10,24,9,18,5,9,4,3,75,7,82,8.536585365853659
19571,330455705240388,77,100,103,89,99,66,44,33,534,77,611,12.602291325695582
19572,330455705240389,33,69,65,47,60,44,28,26,318,54,372,14.516129032258064
19573,330455705240390,96,145,106,110,108,95,47,52,660,99,759,13.043478260869565
19574,330455705240391,81,102,74,61,70,38,19,8,426,27,453,5.960264900662252
19575,330455705240392,107,99,90,101,80,66,44,32,543,76,619,12.277867528271406
19576,330455705240393,97,126,81,95,84,58,48,27,541,75,616,12.175324675324676
19577,330455705240394,106,116,114,126,75,95,51,25,632,76,708,10.734463276836157
19578,330455705240395,115,162,94,100,82,33,30,17,586,47,633,7.424960505529226
19579,330455705240396,81,80,65,99,81,55,21,19,461,40,501,7.984031936127744
19580,330455705240397,118,166,161,148,127,138,77,50,858,127,985,12.893401015228426
19581,330455705240398,125,124,99,97,77,57,27,14,579,41,620,6.612903225806452
19582,330455705240399,86,75,119,168,95,50,25,11,593,36,629,5.723370429252782
19583,330455705240400,58,45,90,112,41,28,23,5,374,28,402,6.965174129353234
19584,330455705240401,75,60,119,109,70,40,10,9,473,19,492,3.861788617886179
19585,330455705240402,89,85,118,160,62,40,30,5,554,35,589,5.942275042444821
19586,330455705240403,125,150,109,120,86,62,33,30,652,63,715,8.811188811188812
19587,330455705240404,78,114,94,80,81,54,38,30,501,68,569,11.95079086115993
19588,330455705240405,131,136,147,142,116,100,53,33,772,86,858,10.023310023310023
19589,330455705240406,68,87,76,77,53,41,25,4,402,29,431,6.728538283062645
19590,330455705240407,43,48,31,21,19,17,9,4,179,13,192,6.770833333333333
19591,330455705240408,122,127,115,85,58,42,29,8,549,37,586,6.313993174061434
19592,330455705240409,57,65,55,50,40,29,7,9,296,16,312,5.128205128205129
19593,330455705240410,84,92,80,79,70,61,47,25,466,72,538,13.382899628252789
19594,330455705240411,65,83,78,62,71,75,57,40,434,97,531,18.267419962335218
19595,330455705240412,176,207,196,155,140,75,33,28,949,61,1010,6.03960396039604
19596,330455705240413,76,75,96,93,80,70,50,26,490,76,566,13.42756183745583
19597,330455705240414,230,233,180,164,117,71,41,19,995,60,1055,5.687203791469194
19598,330455705240415,186,265,156,182,146,77,24,19,1012,43,1055,4.075829383886256
19599,330455705240416,74,84,81,81,58,51,41,17,429,58,487,11.90965092402464
19600,330455705240417,171,239,182,140,138,101,56,31,971,87,1058,8.223062381852552
19601,330455705240418,109,137,123,150,100,85,81,50,704,131,835,15.688622754491018
19602,330455705240419,131,155,140,130,94,62,34,25,712,59,771,7.652399481193256
19603,330455705240420,57,112,85,97,103,46,21,28,500,49,549,8.925318761384336
19604,330455705240421,68,100,89,76,80,38,19,12,451,31,482,6.431535269709544
19605,330455705240422,69,86,72,84,76,64,38,29,451,67,518,12.934362934362934
19606,330455705240423,103,125,97,104,100,69,49,27,598,76,674,11.275964391691394
19607,330455705240424,13,15,17,20,16,18,11,16,99,27,126,21.428571428571427
19608,330455705240425,41,45,62,48,56,41,26,36,293,62,355,17.464788732394368
19609,330455705240426,124,154,143,108,128,91,41,27,748,68,816,8.333333333333334
19610,330455705240427,74,90,84,74,62,69,20,7,453,27,480,5.625
19611,330455705240428,31,39,63,30,33,47,20,18,243,38,281,13.523131672597865
19612,330455705240429,163,103,105,95,51,34,14,5,551,19,570,3.3333333333333335
19613,330455705240430,49,75,54,60,52,24,19,15,314,34,348,9.770114942528735
19614,330455705240431,75,87,75,71,60,30,23,15,398,38,436,8.715596330275229
19615,330455705240432,112,155,101,94,74,76,35,36,612,71,683,10.395314787701318
19616,330455705240433,34,45,26,34,29,21,11,7,189,18,207,8.695652173913043
19617,330455705240434,89,132,111,81,89,55,37,15,557,52,609,8.538587848932677
19618,330455705240435,76,94,87,65,83,39,29,15,444,44,488,9.01639344262295
19619,330455705240436,106,109,100,87,81,40,31,13,523,44,567,7.760141093474426
19620,330455705240437,69,57,96,48,47,66,46,25,383,71,454,15.638766519823788
19621,330455705240438,85,91,77,72,52,42,22,11,419,33,452,7.300884955752212
19622,330455705240439,108,137,122,122,79,73,31,19,641,50,691,7.23589001447178
19623,330455705240440,133,189,94,100,94,29,22,12,639,34,673,5.052005943536404
19624,330455705240441,67,95,66,66,50,35,3,7,379,10,389,2.570694087403599
19625,330455705240442,41,58,80,51,49,60,32,22,339,54,393,13.740458015267176
19626,330455705240443,109,135,123,91,93,81,51,32,632,83,715,11.608391608391608
19627,330455705240444,86,101,105,89,63,75,50,29,519,79,598,13.210702341137123
19628,330455705240445,98,108,107,84,62,70,48,25,529,73,602,12.12624584717608
19629,330455705240446,102,107,99,89,67,67,23,19,531,42,573,7.329842931937173
19630,330455705240447,80,131,99,81,87,52,28,16,530,44,574,7.665505226480836
19631,330455705240448,55,67,44,55,50,23,11,7,294,18,312,5.769230769230769
19632,330455705240449,21,23,40,33,44,33,29,25,194,54,248,21.774193548387096
19633,330455705240450,215,226,145,164,113,57,28,23,920,51,971,5.25231719876416
19634,330455705240451,56,89,86,86,91,92,52,55,500,107,607,17.627677100494235
19635,330455705240452,41,63,57,41,70,47,48,37,319,85,404,21.03960396039604
19636,330455705240453,73,82,91,85,80,80,45,40,491,85,576,14.756944444444445
19637,330455705240454,65,76,91,89,86,84,43,32,491,75,566,13.250883392226148
19638,330455705240455,70,100,64,65,70,36,23,15,405,38,443,8.577878103837472
19639,330455705240456,155,166,117,104,71,57,22,11,670,33,703,4.694167852062589
19640,330455705240457,69,90,57,57,47,25,9,5,345,14,359,3.8997214484679668
19641,330455705240458,86,87,85,89,61,55,39,21,463,60,523,11.47227533460803
19642,330455705240459,88,126,124,123,118,93,54,30,672,84,756,11.11111111111111
19643,330455705240460,137,165,155,210,134,115,68,43,916,111,1027,10.808179162609543
19644,330455705240461,32,40,78,37,50,66,31,19,303,50,353,14.164305949008499
19645,330455705240462,61,65,87,80,77,77,48,30,447,78,525,14.857142857142858
19646,330455705240463,47,61,75,56,64,45,34,15,348,49,397,12.34256926952141
19647,330455705240464,68,78,83,84,57,65,29,31,435,60,495,12.121212121212121
19648,330455705240465,81,85,81,81,73,51,36,27,452,63,515,12.233009708737864
19649,330455705240466,57,51,70,66,62,51,27,31,357,58,415,13.975903614457831
19650,330455705240467,23,36,36,33,53,35,28,30,216,58,274,21.16788321167883
19651,330455705240468,110,131,73,163,113,33,34,24,623,58,681,8.516886930983848
19652,330455705240469,57,83,103,67,86,70,47,48,466,95,561,16.93404634581105
19653,330455705240470,125,113,106,68,55,52,19,10,519,29,548,5.291970802919708
19654,330455705240471,96,94,87,87,73,44,26,16,481,42,523,8.030592734225621
19655,330455705240472,65,81,74,68,61,34,23,22,383,45,428,10.514018691588785
19656,330455705240473,108,135,101,104,79,46,38,15,573,53,626,8.466453674121405
19657,330455705240474,70,71,68,69,49,44,38,20,371,58,429,13.51981351981352
19658,330455705240475,88,108,99,84,73,51,20,24,503,44,547,8.043875685557587
19659,330455705240476,133,126,134,161,78,87,71,28,719,99,818,12.102689486552567
19660,330455705240477,75,82,60,75,43,63,40,26,398,66,464,14.224137931034482
19661,330455705240478,79,81,99,92,71,69,42,26,491,68,559,12.164579606440071
19662,330455705240479,85,122,120,90,82,88,50,28,587,78,665,11.729323308270677
19663,330455705240480,104,126,108,108,81,85,50,25,612,75,687,10.91703056768559
19664,330455705240481,99,118,109,124,69,75,51,45,594,96,690,13.91304347826087
19665,330455705240482,30,53,49,34,45,21,13,19,232,32,264,12.121212121212121
19666,330455705240483,66,78,62,50,46,48,16,16,350,32,382,8.37696335078534
19667,330455705240484,47,44,49,49,46,45,30,21,280,51,331,15.407854984894259
19668,330455705240485,30,43,42,29,49,32,32,27,225,59,284,20.774647887323944
19669,330455705240486,49,49,57,51,37,43,31,24,286,55,341,16.129032258064516
19670,330455705240487,79,100,78,86,80,43,43,23,466,66,532,12.406015037593985
19671,330455705240488,77,101,91,77,73,63,46,31,482,77,559,13.774597495527727
19672,330455705240489,33,38,36,31,30,36,25,17,204,42,246,17.073170731707318
19673,330455705240490,45,54,42,41,53,71,41,38,306,79,385,20.51948051948052
19674,330455705240491,40,40,45,44,36,57,47,46,262,93,355,26.197183098591548
19675,330455705240492,28,50,34,19,69,44,36,44,244,80,324,24.691358024691358
19676,330455705240493,98,76,96,67,51,53,38,24,441,62,503,12.326043737574553
19677,330455705240494,94,93,106,106,72,76,50,53,547,103,650,15.846153846153847
19678,330455705240495,52,47,68,44,57,49,40,30,317,70,387,18.087855297157624
19679,330455705240496,62,61,64,62,53,58,34,27,360,61,421,14.489311163895486
19680,330455705240497,38,63,59,44,53,47,43,32,304,75,379,19.788918205804748
19681,330455705240498,38,57,42,45,49,48,44,45,279,89,368,24.184782608695652
19682,330455705240499,37,35,32,20,33,19,27,17,176,44,220,20.0
19683,330455705240500,103,97,101,113,70,55,29,19,539,48,587,8.17717206132879
19684,330455705240501,29,44,51,36,39,29,14,3,228,17,245,6.938775510204081
19685,330455705240502,66,79,78,59,63,54,28,27,399,55,454,12.114537444933921
19686,330455705240503,54,109,61,70,69,47,16,7,410,23,433,5.311778290993072
19687,330455705240504,96,145,79,95,97,35,27,14,547,41,588,6.9727891156462585
19688,330455705240505,95,56,150,139,79,43,11,5,562,16,578,2.7681660899653977
19689,330455705240506,83,53,152,141,52,33,10,9,514,19,533,3.5647279549718576
19690,330455705240507,67,47,48,50,29,20,9,2,261,11,272,4.044117647058823
19691,330455705240508,68,90,85,97,97,55,27,42,492,69,561,12.29946524064171
19692,330455705240509,98,109,111,108,74,59,43,21,559,64,623,10.272873194221509
19693,330455705240510,128,118,124,143,110,64,30,23,687,53,740,7.162162162162162
19694,330455705240511,40,46,79,100,49,39,14,5,353,19,372,5.10752688172043
19695,330455705240512,69,73,100,104,51,39,11,2,436,13,449,2.89532293986637
19696,330455705240513,106,116,80,96,78,58,28,12,534,40,574,6.968641114982578
19697,330455705240514,101,92,85,75,67,40,14,11,460,25,485,5.154639175257732
19698,330455705240515,96,101,87,84,52,25,14,17,445,31,476,6.512605042016807
19699,330455705240516,2,3,5,6,6,1,0,1,23,1,24,4.166666666666667
19700,330455705240517,72,55,113,91,47,23,11,2,401,13,414,3.140096618357488
19701,330455705240518,53,56,113,79,47,13,10,4,361,14,375,3.7333333333333334
19702,330455705240519,109,88,91,86,50,47,35,12,471,47,518,9.073359073359073
19703,330455705240520,26,47,24,18,21,11,11,4,147,15,162,9.25925925925926
19704,330455705240521,76,103,108,69,107,75,44,56,538,100,638,15.67398119122257
19705,330455705240522,135,167,142,127,102,103,50,38,776,88,864,10.185185185185185
19706,330455705240523,62,88,60,43,75,32,30,22,360,52,412,12.62135922330097
19707,330455705240524,63,67,76,59,49,70,39,27,384,66,450,14.666666666666666
19708,330455705240525,42,63,53,38,60,37,24,21,293,45,338,13.31360946745562
19709,330455705240526,89,66,40,56,30,7,9,3,288,12,300,4.0
19710,330455705240527,53,89,62,90,71,54,38,25,419,63,482,13.070539419087137
19711,330455705240528,107,106,85,66,41,29,13,8,434,21,455,4.615384615384615
19712,330455705240529,93,58,73,46,24,18,15,8,312,23,335,6.865671641791045
19713,330455705240530,27,26,26,31,21,13,10,4,144,14,158,8.860759493670885
19714,330455705240531,70,83,70,52,53,34,20,9,362,29,391,7.41687979539642
19715,330455705240532,102,102,73,67,50,28,21,7,422,28,450,6.222222222222222
19716,330455705240533,78,83,57,54,53,29,6,3,354,9,363,2.479338842975207
19717,330455705240534,213,245,219,204,138,111,60,45,1130,105,1235,8.502024291497976
19718,330455705240535,29,42,31,34,27,18,3,2,181,5,186,2.6881720430107525
19719,330455705240536,49,67,44,70,47,56,32,16,333,48,381,12.598425196850394
19720,330455705240537,131,155,92,116,76,51,12,10,621,22,643,3.421461897356143
19721,330455705240538,109,99,85,83,42,38,15,5,456,20,476,4.201680672268908
19722,330455705240539,110,139,90,105,71,40,21,9,555,30,585,5.128205128205129
19723,330455705240540,53,84,50,61,68,21,15,10,337,25,362,6.906077348066298
19724,330455705240541,112,154,137,100,78,65,30,14,646,44,690,6.3768115942028984
19725,330455705240542,59,65,72,57,52,39,24,13,344,37,381,9.711286089238845
19726,330455705240543,48,66,66,67,65,63,28,21,375,49,424,11.556603773584905
19727,330455705240544,58,75,87,85,72,63,32,30,440,62,502,12.350597609561753
19728,330455705240545,99,133,127,105,107,98,53,26,669,79,748,10.561497326203208
19729,330455705240546,132,183,178,197,130,124,57,37,944,94,1038,9.05587668593449
19730,330455705240547,94,120,121,115,95,93,57,22,638,79,717,11.01813110181311
19731,330455705240548,56,59,66,53,53,46,36,19,333,55,388,14.175257731958762
19732,330455705240549,8,12,28,11,15,16,7,5,90,12,102,11.764705882352942
19733,330455705240550,36,39,41,36,20,20,26,10,192,36,228,15.789473684210526
19734,330455705240551,79,118,101,94,93,79,55,52,564,107,671,15.946348733233979
19735,330455705240552,41,63,56,59,39,31,27,12,289,39,328,11.890243902439025
19736,330455705240553,39,58,41,47,38,33,24,17,256,41,297,13.804713804713804
19737,330455705240554,115,124,102,146,98,57,23,5,642,28,670,4.17910447761194
19738,330455705240555,78,123,102,106,68,55,32,24,532,56,588,9.523809523809524
19739,330455705240556,169,164,115,126,76,67,29,13,717,42,759,5.533596837944664
19740,330455705240557,110,156,70,87,88,32,22,8,543,30,573,5.2356020942408374
19741,330455705240558,47,76,49,67,62,35,25,17,336,42,378,11.11111111111111
19742,330455705240559,133,145,113,105,76,47,30,20,619,50,669,7.473841554559043
19743,330455705240560,134,101,112,79,50,26,13,7,502,20,522,3.8314176245210727
19744,330455705240561,82,74,139,74,44,46,34,11,459,45,504,8.928571428571429
19745,330455705240562,197,199,164,132,122,65,29,21,879,50,929,5.382131324004305
19746,330455705240563,138,153,140,134,107,81,40,26,753,66,819,8.058608058608058
19747,330455705240564,131,143,143,124,99,65,51,24,705,75,780,9.615384615384615
19748,330455705240565,110,138,107,124,102,70,41,36,651,77,728,10.576923076923077
19749,330455705240566,102,153,177,136,138,148,70,44,854,114,968,11.776859504132231
19750,330455705240567,38,61,35,50,46,28,15,12,258,27,285,9.473684210526315
19751,330455705240568,72,70,73,46,62,28,26,18,351,44,395,11.139240506329115
19752,330455705240569,99,119,97,94,90,62,35,20,561,55,616,8.928571428571429
19753,330455705240570,77,102,83,69,65,44,28,15,440,43,483,8.902691511387163
19754,330455705240571,57,96,71,89,79,60,31,19,452,50,502,9.9601593625498
19755,330455705240572,117,114,115,117,88,65,34,23,616,57,673,8.469539375928678
19756,330455705240573,160,191,101,126,95,40,35,21,713,56,769,7.282184655396619
19757,330455705240574,187,229,110,152,99,78,32,19,855,51,906,5.629139072847682
19758,330455705240575,172,218,135,113,90,58,30,16,786,46,832,5.528846153846154
19759,330455705240576,177,223,136,128,128,75,42,15,867,57,924,6.1688311688311686
19760,330455705240577,180,169,90,121,57,49,26,12,666,38,704,5.3977272727272725
19761,330455705240578,109,131,90,107,55,46,30,15,538,45,583,7.718696397941681
19762,330455705240579,140,149,122,116,90,51,20,13,668,33,701,4.70756062767475
19763,330455705240580,162,181,131,124,86,67,41,14,751,55,806,6.823821339950372
19764,330455705240581,161,166,107,128,87,69,25,21,718,46,764,6.020942408376963
19765,330455705240582,176,166,116,117,101,70,50,16,746,66,812,8.12807881773399
19766,330455705240583,146,183,124,123,80,65,28,8,721,36,757,4.755614266842801
19767,330455705240584,150,185,135,137,102,63,36,21,772,57,829,6.875753920386007
19768,330455705240585,90,123,104,79,95,71,30,20,562,50,612,8.169934640522875
19769,330455705240586,157,144,138,125,97,79,34,18,740,52,792,6.565656565656566
19770,330455705240587,145,159,125,117,126,61,38,31,733,69,802,8.603491271820449
19771,330455705240588,66,65,63,72,52,27,6,9,345,15,360,4.166666666666667
19772,330455705240589,47,45,40,46,31,22,9,3,231,12,243,4.938271604938271
19773,330455705240590,99,81,70,95,58,34,26,9,437,35,472,7.415254237288136
19774,330455705240591,127,98,110,79,51,49,19,12,514,31,545,5.6880733944954125
19775,330455705240592,101,123,97,95,94,42,25,21,552,46,598,7.6923076923076925
19776,330455705240593,8,18,5,10,6,8,3,1,55,4,59,6.779661016949152
19777,330455705240594,68,83,63,66,59,27,17,12,366,29,395,7.341772151898734
19778,330455705240595,100,120,123,120,70,69,42,15,602,57,659,8.649468892261002
19779,330455705240596,26,34,27,22,27,14,2,9,150,11,161,6.832298136645963
19780,330455705240597,59,75,32,55,31,16,8,5,268,13,281,4.6263345195729535
19781,330455705240598,115,93,85,89,52,47,10,10,481,20,501,3.992015968063872
19782,330455705240599,124,132,96,123,94,68,30,15,637,45,682,6.5982404692082115
19783,330455705240600,39,22,24,26,10,5,5,5,126,10,136,7.352941176470588
19784,330455705240601,70,60,77,53,46,43,25,17,349,42,391,10.741687979539641
19785,330455705240602,153,180,146,135,108,76,34,33,798,67,865,7.745664739884393
19786,330455705240603,22,15,11,9,6,4,1,1,67,2,69,2.898550724637681
19787,330455705240604,51,58,37,32,23,15,8,6,216,14,230,6.086956521739131
19788,330455705240605,21,20,11,12,3,2,3,1,69,4,73,5.47945205479452
19789,330455705240606,14,8,9,3,3,1,0,1,38,1,39,2.5641025641025643
19790,330455705240607,10,2,7,1,0,0,1,0,20,1,21,4.761904761904762
19791,330455705240608,41,24,27,7,11,4,2,0,114,2,116,1.7241379310344827
19792,330455705240609,87,65,60,54,32,16,8,3,314,11,325,3.3846153846153846
19793,330455705240610,189,192,118,102,74,37,31,8,712,39,751,5.193075898801598
19794,330455705240611,121,91,83,44,37,29,8,4,405,12,417,2.8776978417266186
19795,330455705240612,30,28,29,27,21,15,13,9,150,22,172,12.790697674418604
19796,330455705240613,52,78,36,42,43,16,11,10,267,21,288,7.291666666666667
19797,330455705240614,75,68,62,75,33,27,13,2,340,15,355,4.225352112676056
19798,330455705240615,71,82,51,64,30,20,17,8,318,25,343,7.288629737609329
19799,330455705240616,68,79,51,38,49,17,7,5,302,12,314,3.821656050955414
19800,330455705240617,102,84,78,62,50,33,11,6,409,17,426,3.9906103286384975
19801,330455705240618,27,24,27,14,21,16,12,6,129,18,147,12.244897959183673
19802,330455705240619,44,48,42,44,34,22,23,7,234,30,264,11.363636363636363
19803,330455705240620,14,28,24,17,5,18,9,5,106,14,120,11.666666666666666
19804,330455705240621,6,3,6,4,5,5,3,3,29,6,35,17.142857142857142
19805,330455705240622,37,34,48,24,28,25,15,10,196,25,221,11.312217194570136
19806,330455705240623,56,60,34,40,20,17,9,1,227,10,237,4.219409282700422
19807,330455705240624,94,112,95,89,66,44,16,17,500,33,533,6.191369606003752
19808,330455705240625,51,41,32,20,22,7,5,2,173,7,180,3.888888888888889
19809,330455705240631,247,184,186,126,87,54,25,8,884,33,917,3.5986913849509268
19812,330455705240640,85,95,83,68,72,62,20,24,465,44,509,8.644400785854616
19813,330455705240641,99,107,109,87,79,43,27,18,524,45,569,7.9086115992970125
19814,330455705240642,58,47,101,96,39,28,15,4,369,19,388,4.896907216494846
19815,330455705240643,97,87,71,67,46,37,20,5,405,25,430,5.813953488372093
19816,330455705250001,69,105,111,102,119,131,80,82,637,162,799,20.275344180225282
19817,330455705250002,52,53,78,76,74,88,48,70,421,118,539,21.89239332096475
19818,330455705250003,42,54,85,70,63,87,52,61,401,113,514,21.98443579766537
19819,330455705250004,96,72,107,144,131,120,66,72,670,138,808,17.07920792079208
19820,330455705250005,83,113,114,95,157,117,101,88,679,189,868,21.774193548387096
19821,330455705250006,68,87,102,102,100,103,96,69,562,165,727,22.696011004126547
19822,330455705250007,33,43,82,71,61,64,54,66,354,120,474,25.31645569620253
19823,330455705250008,37,28,54,72,33,58,36,29,282,65,347,18.73198847262248
19824,330455705250009,34,41,47,72,67,52,44,33,313,77,390,19.743589743589745
19825,330455705250010,110,186,188,140,169,140,78,63,933,141,1074,13.128491620111731
19826,330455705250011,108,118,144,121,149,107,67,75,747,142,889,15.973003374578179
19827,330455705250012,69,90,97,118,114,91,60,54,579,114,693,16.450216450216452
19828,330455705250013,45,49,68,58,61,49,35,30,330,65,395,16.455696202531644
19829,330455705250014,81,117,111,117,108,74,48,38,608,86,694,12.39193083573487
19830,330455705250015,81,93,145,117,131,101,68,93,668,161,829,19.420989143546443
19831,330455705250016,52,62,79,85,63,56,32,30,397,62,459,13.507625272331154
19832,330455705250017,49,57,75,63,52,38,33,19,334,52,386,13.471502590673575
19833,330455705250018,84,121,115,105,92,96,42,42,613,84,697,12.051649928263988
19834,330455705250019,63,86,68,97,95,51,47,24,460,71,531,13.370998116760829
19835,330455705250020,100,104,115,118,98,63,53,49,598,102,700,14.571428571428571
19836,330455705250021,69,76,101,126,106,88,66,70,566,136,702,19.373219373219374
19837,330455705250022,59,78,94,72,102,104,51,62,509,113,622,18.167202572347268
19838,330455705250023,69,86,107,87,86,81,46,53,516,99,615,16.097560975609756
19839,330455705250024,78,87,84,92,70,73,34,31,484,65,549,11.839708561020036
19840,330455705250025,109,164,166,140,136,107,50,49,822,99,921,10.749185667752442
19841,330455705250026,90,112,106,104,78,48,27,27,538,54,592,9.121621621621621
19842,330455705250027,60,76,57,62,69,45,26,25,369,51,420,12.142857142857142
19843,330455705250028,39,52,62,49,49,36,16,23,287,39,326,11.963190184049079
19844,330455705250029,76,76,70,106,78,61,61,38,467,99,566,17.491166077738516
19845,330455705250030,70,83,109,107,107,100,72,71,576,143,719,19.88873435326843
19846,330455705250031,109,136,135,109,115,91,39,44,695,83,778,10.668380462724937
19847,330455705250032,32,48,46,41,46,33,18,17,246,35,281,12.455516014234876
19848,330455705250033,72,81,107,85,85,84,55,27,514,82,596,13.758389261744966
19849,330455705250034,98,102,117,97,99,65,40,27,578,67,645,10.387596899224807
19850,330455705250035,35,33,40,24,35,17,7,15,184,22,206,10.679611650485437
19851,330455705250036,50,53,56,76,73,45,30,34,353,64,417,15.347721822541967
19852,330455705250037,74,69,114,123,99,71,48,42,550,90,640,14.0625
19853,330455705250038,71,80,138,122,96,94,50,46,601,96,697,13.773314203730273
19854,330455705250039,36,55,65,77,67,47,25,25,347,50,397,12.594458438287154
19855,330455705250040,81,84,131,149,111,77,64,67,633,131,764,17.146596858638745
19856,330455705250041,43,51,56,81,72,56,39,39,359,78,437,17.848970251716246
19857,330455705250042,101,121,135,179,136,101,96,72,773,168,941,17.85334750265675
19858,330455705250043,65,75,129,114,90,75,61,41,548,102,650,15.692307692307692
19859,330455705250044,68,70,130,113,75,77,55,41,533,96,629,15.262321144674086
19860,330455705250045,66,68,95,94,72,81,43,32,476,75,551,13.611615245009075
19861,330455705250046,21,48,46,64,60,59,51,69,298,120,418,28.708133971291865
19862,330455705250047,45,56,98,75,93,88,64,88,455,152,607,25.041186161449755
19863,330455705250048,61,82,135,123,106,122,84,92,629,176,805,21.86335403726708
19864,330455705250049,63,111,179,147,128,113,82,65,741,147,888,16.554054054054053
19865,330455705250050,63,91,122,107,106,135,80,81,624,161,785,20.50955414012739
19866,330455705250051,82,106,128,114,125,129,54,63,684,117,801,14.606741573033707
19867,330455705250052,48,66,89,82,84,82,59,63,451,122,573,21.291448516579408
19868,330455705250053,78,78,112,134,95,110,83,91,607,174,781,22.279129321382843
19869,330455705250054,42,44,79,76,69,63,52,46,373,98,471,20.8067940552017
19870,330455705250055,73,60,105,94,87,84,46,53,503,99,602,16.44518272425249
19871,330455705250056,52,80,92,81,95,74,61,56,474,117,591,19.79695431472081
19872,330455705250057,79,69,110,84,110,97,73,81,549,154,703,21.906116642958747
19873,330455705250058,69,89,96,78,80,67,41,29,479,70,549,12.750455373406194
19874,330455705250059,74,110,111,124,98,89,63,39,606,102,708,14.40677966101695
19875,330455705250060,80,81,159,105,104,103,75,42,632,117,749,15.620827770360481
19876,330455705250061,143,148,166,156,122,89,62,24,824,86,910,9.45054945054945
19877,330455705250062,88,116,145,141,132,92,61,57,714,118,832,14.182692307692308
19878,330455705250063,23,48,33,26,53,28,36,14,211,50,261,19.157088122605366
19879,330455705250064,60,77,91,86,66,78,33,44,458,77,535,14.392523364485982
19880,330455705250065,82,105,140,138,122,55,25,9,642,34,676,5.029585798816568
19881,330455705250066,130,171,166,156,117,90,52,24,830,76,906,8.388520971302428
19882,330455705250067,82,106,106,99,74,61,33,22,528,55,583,9.433962264150944
19883,330455705250068,37,37,72,60,57,65,50,47,328,97,425,22.823529411764707
19884,330455705250069,107,115,122,123,82,71,39,24,620,63,683,9.224011713030746
19885,330455705250070,133,133,201,148,115,94,40,16,824,56,880,6.363636363636363
19886,330455705250071,50,77,111,66,73,42,43,31,419,74,493,15.010141987829615
19887,330455705250072,183,239,225,184,172,142,52,24,1145,76,1221,6.224406224406224
19888,330455705250073,40,48,48,47,38,19,6,2,240,8,248,3.225806451612903
19889,330455705250074,119,167,147,126,129,72,41,24,760,65,825,7.878787878787879
19890,330455705250075,89,153,160,175,172,150,86,73,899,159,1058,15.028355387523629
19891,330455705250076,49,47,55,56,36,30,21,7,273,28,301,9.30232558139535
19892,330455705250077,95,100,150,139,130,102,76,44,716,120,836,14.354066985645932
19893,330455705250078,62,80,92,71,89,64,41,22,458,63,521,12.092130518234166
19894,330455705250079,97,133,167,152,122,89,58,57,760,115,875,13.142857142857142
19895,330455705250080,18,38,46,39,36,30,13,12,207,25,232,10.775862068965518
19896,330455705250081,78,111,158,99,91,73,28,19,610,47,657,7.153729071537291
19897,330455705250082,89,115,125,125,112,84,35,30,650,65,715,9.090909090909092
19898,330455705250083,95,99,136,113,99,56,58,25,598,83,681,12.187958883994126
19899,330455705250084,71,65,101,98,106,105,89,59,546,148,694,21.32564841498559
19900,330455705250085,56,82,120,86,118,105,79,83,567,162,729,22.22222222222222
19901,330455705250086,38,63,87,92,75,86,66,62,441,128,569,22.49560632688928
19902,330455705250087,104,115,157,171,138,125,96,56,810,152,962,15.8004158004158
19903,330455705250088,83,103,149,114,114,119,68,92,682,160,842,19.002375296912113
19904,330455705250089,68,101,120,106,84,81,57,36,560,93,653,14.241960183767228
19905,330455705250090,105,149,131,158,167,84,57,49,794,106,900,11.777777777777779
19906,330455705250091,109,147,145,121,85,75,41,30,682,71,753,9.428950863213812
19907,330455705250092,40,66,80,110,68,68,44,57,432,101,533,18.94934333958724
19908,330455705250093,18,19,42,25,36,32,21,27,172,48,220,21.818181818181817
19909,330455705250094,83,90,159,138,135,117,80,83,722,163,885,18.418079096045197
19910,330455705250095,68,78,123,130,130,116,90,102,645,192,837,22.939068100358423
19911,330455705250096,65,105,88,113,108,92,67,53,571,120,691,17.36613603473227
19912,330455705250097,89,93,141,128,128,112,76,56,691,132,823,16.038882138517618
19913,330455705250098,110,131,167,204,208,171,132,108,991,240,1231,19.496344435418358
19914,330455705250099,70,93,157,112,148,109,75,79,689,154,843,18.26809015421115
19915,330455705250100,39,40,60,75,73,58,42,59,345,101,446,22.6457399103139
19916,330455705250101,46,46,65,67,70,61,46,44,355,90,445,20.224719101123597
19917,330455705250102,41,68,105,85,79,90,75,65,468,140,608,23.026315789473685
19918,330455705250103,63,52,99,102,106,68,39,52,490,91,581,15.662650602409638
19919,330455705250104,43,53,103,85,69,75,57,45,428,102,530,19.245283018867923
19920,330455705250105,54,79,86,114,89,102,80,71,524,151,675,22.37037037037037
19921,330455705250106,45,49,102,90,76,81,71,56,443,127,570,22.280701754385966
19922,330455705250107,70,99,142,129,131,111,74,45,682,119,801,14.856429463171036
19923,330455705250108,93,104,142,146,138,100,82,58,723,140,863,16.22247972190035
19924,330455705250109,51,87,82,82,96,80,49,50,478,99,577,17.157712305025996
19925,330455705250110,39,54,84,110,68,78,54,66,433,120,553,21.699819168173597
19926,330455705250111,41,61,76,81,70,85,57,51,414,108,522,20.689655172413794
19927,330455705250112,38,46,79,67,69,63,39,34,362,73,435,16.7816091954023
19928,330455705250113,47,70,68,73,82,73,45,39,413,84,497,16.901408450704224
19929,330455705250114,62,124,110,97,141,137,95,84,671,179,850,21.058823529411764
19930,330455705250115,51,68,107,121,89,88,93,96,524,189,713,26.507713884992988
19931,330455705250116,65,67,113,142,111,107,84,95,605,179,784,22.831632653061224
19932,330455705250117,21,57,68,61,70,62,50,37,339,87,426,20.422535211267604
19933,330455705250118,57,73,114,109,86,78,76,76,517,152,669,22.720478325859492
19934,330455705250119,69,58,99,100,88,95,91,81,509,172,681,25.25697503671072
19935,330455705250120,60,94,143,120,139,136,88,103,692,191,883,21.630804077010193
19936,330455705250121,53,85,116,135,117,105,70,104,611,174,785,22.1656050955414
19937,330455705250122,68,93,150,131,136,136,83,82,714,165,879,18.77133105802048
19938,330455705250123,122,145,224,199,200,207,118,117,1097,235,1332,17.64264264264264
19939,330455705250124,73,119,177,140,177,213,102,86,899,188,1087,17.295308187672493
19940,330455705250125,38,50,83,86,67,76,52,64,400,116,516,22.48062015503876
19941,330455705250126,40,64,82,67,75,81,44,57,409,101,510,19.80392156862745
19942,330455705250127,39,64,106,90,85,100,58,61,484,119,603,19.734660033167497
19943,330455705250128,57,83,103,114,113,100,82,93,570,175,745,23.48993288590604
19944,330455705250129,61,73,90,137,102,87,93,87,550,180,730,24.65753424657534
19945,330455705250130,25,31,58,50,49,60,50,45,273,95,368,25.815217391304348
19946,330455705250131,60,63,85,103,105,89,99,68,505,167,672,24.851190476190474
19947,330455705250132,47,55,76,87,88,74,66,56,427,122,549,22.22222222222222
19948,330455705250133,67,82,74,107,146,84,66,49,560,115,675,17.037037037037038
19949,330455705250134,50,61,81,110,66,91,65,49,459,114,573,19.895287958115183
19950,330455705250135,66,81,91,103,117,72,49,31,530,80,610,13.114754098360656
19951,330455705250136,82,106,144,137,135,128,92,62,732,154,886,17.381489841986458
19952,330455705250137,61,103,111,113,120,116,88,78,624,166,790,21.0126582278481
19953,330455705250138,36,48,53,59,39,71,48,55,306,103,409,25.183374083129586
19954,330455705250139,79,91,103,108,83,89,61,33,553,94,647,14.528593508500773
19955,330455705250140,46,63,82,76,61,75,53,55,403,108,511,21.135029354207436
19956,330455705250141,47,65,103,90,97,95,84,56,497,140,637,21.978021978021978
19957,330455705250142,69,102,120,87,110,80,45,40,568,85,653,13.016845329249618
19958,330455705250143,204,141,183,189,99,77,59,33,893,92,985,9.34010152284264
19959,330455705250144,82,85,106,82,86,75,24,22,516,46,562,8.185053380782918
19960,330455705250145,70,76,116,87,92,75,39,37,516,76,592,12.837837837837839
19961,330455705250146,65,91,80,94,96,84,68,45,510,113,623,18.13804173354735
19962,330455705250147,29,50,74,60,71,60,33,48,344,81,425,19.058823529411764
19963,330455705250148,29,51,69,57,58,56,40,71,320,111,431,25.754060324825986
19964,330455705250149,80,75,122,144,105,124,82,84,650,166,816,20.34313725490196
19965,330455705250150,77,63,100,71,71,60,47,26,442,73,515,14.174757281553399
19966,330455705250151,115,147,147,138,99,95,42,39,741,81,822,9.854014598540147
19967,330455705250152,107,140,112,123,85,90,58,23,657,81,738,10.975609756097562
19968,330455705250153,130,97,124,165,91,72,44,17,679,61,740,8.243243243243244
19969,330455705250154,104,77,106,80,67,49,31,24,483,55,538,10.223048327137546
19970,330455705250155,83,81,105,114,83,79,41,33,545,74,619,11.954765751211632
19971,330455705250156,55,85,90,58,99,75,34,50,462,84,546,15.384615384615385
19972,330455705250157,95,129,121,157,140,105,83,73,747,156,903,17.27574750830565
19973,330455705250158,49,52,83,67,62,63,51,54,376,105,481,21.82952182952183
19974,330455705250159,61,91,107,128,84,107,71,51,578,122,700,17.428571428571427
19975,330455705250160,99,107,127,112,145,147,67,52,737,119,856,13.901869158878505
19976,330455705250161,64,84,109,111,111,128,79,75,607,154,761,20.2365308804205
19977,330455705250162,93,114,197,160,130,115,71,53,809,124,933,13.290460878885316
19978,330455705250163,60,91,90,92,141,82,65,70,556,135,691,19.536903039073806
19979,330455705250164,88,119,122,128,109,91,35,36,657,71,728,9.752747252747254
19980,330455705250165,129,141,202,167,127,100,54,37,866,91,957,9.508881922675027
19981,330455705250166,77,88,104,89,76,55,28,30,489,58,547,10.603290676416819
19982,330455705250167,88,128,158,111,109,104,64,52,698,116,814,14.25061425061425
19983,330455705250168,100,123,162,147,123,101,80,55,756,135,891,15.151515151515152
19984,330455705250169,101,119,167,161,119,99,47,50,766,97,863,11.239860950173812
19985,330455705250170,53,76,102,90,89,94,59,66,504,125,629,19.87281399046105
19986,330455705250171,43,60,115,86,83,85,65,59,472,124,596,20.80536912751678
19987,330455705250172,75,106,118,119,85,87,44,28,590,72,662,10.876132930513595
19988,330455705250173,59,85,86,97,107,102,43,61,536,104,640,16.25
19989,330455705250174,31,74,92,86,70,86,65,58,439,123,562,21.88612099644128
19990,330455705250175,50,58,82,64,61,62,42,49,377,91,468,19.444444444444443
19991,330455705250176,26,37,25,34,19,20,14,10,161,24,185,12.972972972972974
19992,330455705250177,87,126,97,127,95,82,48,40,614,88,702,12.535612535612536
19993,330455705250178,33,74,77,65,88,62,39,32,399,71,470,15.106382978723405
19994,330455705250179,134,165,157,118,114,71,29,17,759,46,805,5.714285714285714
19995,330455705250180,86,109,126,102,97,73,40,33,593,73,666,10.96096096096096
19996,330455705250181,88,114,113,108,83,89,48,34,595,82,677,12.112259970457902
19997,330455705250182,65,49,61,62,47,37,13,14,321,27,348,7.758620689655173
19998,330455705250183,47,55,50,51,48,35,17,32,286,49,335,14.626865671641792
19999,330455705250184,39,37,56,51,69,62,30,48,314,78,392,19.897959183673468
20000,330455705250185,92,111,149,147,121,114,90,79,734,169,903,18.715393133997786
20001,330455705250186,59,82,121,115,86,96,79,85,559,164,723,22.68326417704011
20002,330455705250187,56,45,91,77,62,63,33,62,394,95,489,19.427402862985684
20003,330455705250188,80,116,100,112,104,85,42,28,597,70,667,10.494752623688155
20004,330455705250189,58,62,58,49,50,26,21,8,303,29,332,8.734939759036145
20005,330455705250190,41,33,46,42,37,22,12,10,221,22,243,9.053497942386832
20006,330455705250191,141,121,141,123,91,51,35,9,668,44,712,6.179775280898877
20007,330455705250192,126,166,158,150,123,88,42,54,811,96,907,10.584343991179713
20008,330455705250193,128,101,133,114,99,71,49,23,646,72,718,10.027855153203342
20009,330455705250194,71,73,85,79,61,43,27,18,412,45,457,9.846827133479213
20010,330455705250195,72,121,111,124,97,93,50,52,618,102,720,14.166666666666666
20011,330455705250196,65,90,127,139,129,134,95,106,684,201,885,22.71186440677966
20012,330455705250197,23,44,48,47,48,71,31,24,281,55,336,16.36904761904762
20013,330455705250198,43,67,57,73,79,62,58,53,381,111,492,22.5609756097561
20014,330455705250199,57,70,80,104,87,83,63,48,481,111,592,18.75
20015,330455705250200,80,73,56,59,57,28,24,15,353,39,392,9.948979591836734
20016,330455705250201,110,75,130,78,63,44,34,18,500,52,552,9.420289855072463
20017,330455705250202,112,132,154,121,99,73,39,32,691,71,762,9.317585301837271
20018,330455705250203,110,114,138,103,97,62,34,21,624,55,679,8.100147275405007
20019,330455705250204,92,135,124,122,88,73,36,16,634,52,686,7.580174927113703
20020,330455705250205,70,115,134,113,124,115,85,83,671,168,839,20.0238379022646
20021,330455705250206,61,84,109,137,111,90,83,38,592,121,713,16.97054698457223
20022,330455705250207,165,178,173,117,118,72,37,21,823,58,881,6.583427922814983
20023,330455705250208,129,136,133,112,87,59,32,11,656,43,699,6.1516452074391985
20024,330455705250209,65,76,80,66,47,27,15,12,361,27,388,6.958762886597938
20025,330455705250210,291,286,283,229,151,125,61,35,1365,96,1461,6.570841889117043
20026,330455705250211,43,47,48,76,58,36,32,24,308,56,364,15.384615384615385
20027,330455705250212,53,78,88,86,101,89,61,53,495,114,609,18.7192118226601
20028,330455705250213,43,58,74,77,68,61,35,38,381,73,454,16.079295154185022
20029,330455705250214,147,150,188,174,139,128,71,41,926,112,1038,10.789980732177264
20030,330455705250215,17,29,53,39,31,19,10,3,188,13,201,6.467661691542289
20031,330455705250216,117,97,97,105,79,40,16,10,535,26,561,4.634581105169341
20032,330455705250217,52,77,100,82,110,92,81,100,513,181,694,26.080691642651296
20033,330455705250218,59,53,128,182,103,110,90,91,635,181,816,22.181372549019606
20034,330455705250219,39,63,64,67,97,83,44,51,413,95,508,18.700787401574804
20035,330455705250220,60,98,141,140,132,119,102,86,690,188,878,21.4123006833713
20036,330455705250221,38,58,50,67,74,48,49,44,335,93,428,21.72897196261682
20037,330455705250222,46,44,75,61,56,62,52,52,344,104,448,23.214285714285715
20038,330455705250223,27,56,70,62,76,75,50,44,366,94,460,20.434782608695652
20039,330455705250224,27,29,51,50,41,55,28,32,253,60,313,19.169329073482427
20040,330455705250225,35,47,71,64,60,46,47,62,323,109,432,25.23148148148148
20041,330455705250226,69,75,144,123,125,80,65,84,616,149,765,19.477124183006534
20042,330455705250227,32,30,43,73,34,43,33,34,255,67,322,20.80745341614907
20043,330455705250228,46,78,138,104,94,155,138,93,615,231,846,27.30496453900709
20044,330455705250229,24,48,74,46,43,64,59,48,299,107,406,26.354679802955665
20045,330455705250230,56,87,123,120,118,125,101,132,629,233,862,27.03016241299304
20046,330455705250231,42,78,85,106,110,88,72,84,509,156,665,23.458646616541355
20047,330455705250232,16,21,36,30,38,44,39,31,185,70,255,27.45098039215686
20048,330455705250233,86,92,161,136,135,130,94,137,740,231,971,23.789907312049433
20049,330455705250234,66,94,128,134,112,158,97,70,692,167,859,19.441210710128058
20050,330455705250235,11,18,40,30,33,33,44,20,165,64,229,27.94759825327511
20051,330455705250236,34,67,94,77,87,64,72,60,423,132,555,23.783783783783782
20052,330455705250237,32,59,92,75,77,92,81,79,427,160,587,27.2572402044293
20053,330455705250238,34,68,69,71,98,67,55,69,407,124,531,23.35216572504708
20054,330455705250239,39,70,87,82,89,97,70,76,464,146,610,23.934426229508198
20055,330455705250240,45,47,89,82,69,65,42,41,397,83,480,17.291666666666668
20056,330455705250241,49,50,126,97,55,71,52,55,448,107,555,19.27927927927928
20057,330455705250242,44,62,102,107,66,91,81,51,472,132,604,21.85430463576159
20058,330455705250243,59,72,91,113,81,94,60,52,510,112,622,18.006430868167204
20059,330455705250244,64,78,100,115,95,58,65,34,510,99,609,16.25615763546798
20060,330455705250245,22,34,48,33,38,39,34,33,214,67,281,23.843416370106763
20061,330455705250246,44,49,92,79,69,102,83,59,435,142,577,24.61005199306759
20062,330455705250247,35,29,57,76,57,57,59,64,311,123,434,28.341013824884794
20063,330455705250248,42,68,76,86,98,97,60,65,467,125,592,21.114864864864863
20064,330455705250249,61,80,95,101,134,112,129,124,583,253,836,30.263157894736842
20065,330455705250250,47,53,83,68,96,97,68,70,444,138,582,23.711340206185568
20066,330455705250251,59,71,117,95,97,124,92,110,563,202,765,26.405228758169933
20067,330455705250252,40,56,75,68,61,48,52,30,348,82,430,19.069767441860463
20068,330455705250253,99,116,126,92,92,49,26,6,574,32,606,5.2805280528052805
20069,330455705250254,216,247,309,189,155,65,48,33,1181,81,1262,6.418383518225039
20070,330455705250255,55,62,91,55,55,42,26,17,360,43,403,10.66997518610422
20071,330455705250256,99,141,141,105,87,81,30,16,654,46,700,6.571428571428571
20072,330455705250257,154,188,177,164,109,80,24,11,872,35,907,3.8588754134509373
20073,330455705250258,142,298,91,207,162,40,38,16,940,54,994,5.4325955734406435
20074,330455705250259,133,163,149,133,189,74,37,18,841,55,896,6.138392857142857
20075,330455705250260,165,529,165,219,206,86,36,26,1370,62,1432,4.329608938547486
20076,330455705250261,90,76,98,86,84,52,17,27,486,44,530,8.30188679245283
20077,330455705250262,151,173,159,147,95,81,33,13,806,46,852,5.39906103286385
20078,330455705250263,151,155,218,163,125,102,35,33,914,68,982,6.924643584521385
20079,330455705250264,102,105,93,115,150,78,23,130,643,153,796,19.22110552763819
20080,330455705250265,164,189,154,160,120,85,38,21,872,59,931,6.337271750805585
20081,330455705250266,200,153,209,172,108,66,38,17,908,55,963,5.711318795430945
20082,330455705250267,213,257,195,224,138,89,38,14,1116,52,1168,4.4520547945205475
20083,330455705250268,60,77,94,75,47,45,32,11,398,43,441,9.750566893424036
20084,330455705250269,82,98,91,96,59,50,24,19,476,43,519,8.285163776493256
20085,330455705250270,129,118,180,126,109,69,40,15,731,55,786,6.997455470737913
20086,330455705250271,196,205,235,212,165,110,59,34,1123,93,1216,7.6480263157894735
20087,330455705250272,102,97,145,127,84,75,27,12,630,39,669,5.829596412556054
20088,330455705250273,67,82,57,102,71,40,31,28,419,59,478,12.343096234309623
20089,330455705250274,147,226,133,261,287,52,12,17,1106,29,1135,2.555066079295154
20090,330455705250275,81,144,73,151,173,50,11,8,672,19,691,2.7496382054992763
20091,330455705250276,73,114,88,104,88,100,65,43,567,108,675,16.0
20092,330455705250277,78,121,80,93,94,68,54,29,534,83,617,13.452188006482983
20094,330455705250279,38,57,19,47,57,6,3,0,224,3,227,1.3215859030837005
20095,330455705250280,137,216,230,146,195,131,68,53,1055,121,1176,10.289115646258503
20096,330455705250281,6,12,12,8,12,6,6,7,56,13,69,18.840579710144926
20097,330455705250282,39,57,63,56,89,74,33,57,378,90,468,19.23076923076923
20098,330455705250283,50,63,70,66,107,63,49,53,419,102,521,19.57773512476008
20099,330455705250284,49,57,57,68,46,50,32,23,327,55,382,14.397905759162304
20100,330455705250285,50,75,58,61,74,57,43,29,375,72,447,16.107382550335572
20101,330455705250286,66,55,85,81,79,69,41,35,435,76,511,14.87279843444227
20102,330455705250287,129,126,164,181,103,103,68,32,806,100,906,11.037527593818984
20103,330455705250288,28,23,38,47,36,43,19,11,215,30,245,12.244897959183673
20104,330455705250289,88,129,112,121,101,92,66,64,643,130,773,16.81759379042691
20105,330455705250290,31,43,70,77,55,66,55,57,342,112,454,24.669603524229075
20106,330455705250291,51,48,61,61,53,47,30,18,321,48,369,13.008130081300813
20107,330455705250292,49,53,76,86,83,71,48,71,418,119,537,22.160148975791433
20108,330455705250293,17,37,69,43,61,58,41,49,285,90,375,24.0
20109,330455705250294,14,26,33,36,26,36,20,30,171,50,221,22.624434389140273
20110,330455705250295,32,69,92,77,80,89,53,46,439,99,538,18.401486988847584
20111,330455705250296,39,41,70,47,68,97,53,64,362,117,479,24.4258872651357
20112,330455705250297,76,96,101,153,76,54,38,26,556,64,620,10.32258064516129
20113,330455705250298,88,88,112,97,78,65,50,31,528,81,609,13.300492610837438
20114,330455705250299,22,48,53,65,63,68,40,34,319,74,393,18.829516539440203
20115,330455705250300,28,33,55,59,51,60,29,35,286,64,350,18.285714285714285
20116,330455705250301,87,90,129,94,92,63,32,38,555,70,625,11.2
20117,330455705250302,60,71,70,117,66,54,23,21,438,44,482,9.12863070539419
20118,330455705250303,31,27,56,56,41,55,30,38,266,68,334,20.35928143712575
20119,330455705250304,19,46,56,49,61,63,44,62,294,106,400,26.5
20120,330455705250305,34,42,90,79,62,62,42,39,369,81,450,18.0
20121,330455705250306,31,50,83,63,69,56,60,65,352,125,477,26.20545073375262
20122,330455705250307,24,31,57,54,34,47,27,54,247,81,328,24.695121951219512
20123,330455705250308,25,30,79,68,62,81,72,58,345,130,475,27.36842105263158
20124,330455705250309,27,49,68,63,62,64,57,55,333,112,445,25.168539325842698
20125,330455705250310,124,113,127,83,98,42,19,5,587,24,611,3.927986906710311
20126,330455705250311,93,111,107,112,62,34,9,5,519,14,533,2.626641651031895
20127,330455705250312,179,175,191,210,140,84,30,21,979,51,1030,4.951456310679611
20128,330455705250313,162,155,165,131,92,76,19,13,781,32,813,3.936039360393604
20129,330455705250314,78,125,84,95,67,52,20,12,501,32,533,6.0037523452157595
20130,330455705250315,136,132,174,159,85,83,34,10,769,44,813,5.412054120541206
20131,330455705250316,94,92,138,113,64,48,18,6,549,24,573,4.18848167539267
20132,330455705250317,20,38,28,41,33,21,23,11,181,34,215,15.813953488372093
20134,330455705250319,90,113,100,100,65,44,31,8,512,39,551,7.078039927404719
20135,330455705250320,71,80,92,75,72,59,42,31,449,73,522,13.984674329501916
20136,330455705250321,57,88,86,96,91,83,56,53,501,109,610,17.868852459016395
20137,330455705250322,74,87,91,100,70,92,47,34,514,81,595,13.61344537815126
20138,330455705250323,54,82,74,64,80,95,34,55,449,89,538,16.54275092936803
20139,330455705250324,71,85,119,121,91,95,54,48,582,102,684,14.912280701754385
20140,330455705250325,133,161,171,157,134,118,60,44,874,104,978,10.633946830265849
20141,330455705250326,115,117,122,94,88,70,28,29,606,57,663,8.597285067873303
20142,330455705250327,202,216,249,225,167,60,29,17,1119,46,1165,3.948497854077253
20143,330455705250328,125,125,118,122,90,56,50,39,636,89,725,12.275862068965518
20144,330455705250329,107,124,116,111,105,69,45,40,632,85,717,11.854951185495118
20145,330455705250330,65,68,57,46,28,16,18,10,280,28,308,9.090909090909092
20146,330455705250331,103,118,215,125,102,50,22,38,713,60,773,7.7619663648124195
20147,330455705250332,142,121,101,111,74,55,18,16,604,34,638,5.329153605015674
20148,330455705250333,37,42,70,48,50,38,27,13,285,40,325,12.307692307692308
20149,330455705250334,15,24,20,22,18,18,6,4,117,10,127,7.874015748031496
20152,330455705260001,72,83,75,67,70,103,67,90,470,157,627,25.039872408293462
20153,330455705260002,18,28,21,21,24,41,43,51,153,94,247,38.05668016194332
20154,330455705260003,15,37,16,28,37,51,37,40,184,77,261,29.50191570881226
20155,330455705260004,27,50,53,42,50,52,51,83,274,134,408,32.84313725490196
20156,330455705260005,66,84,60,70,79,67,59,60,426,119,545,21.834862385321102
20157,330455705260006,15,20,15,18,29,31,33,24,128,57,185,30.81081081081081
20158,330455705260007,54,32,53,33,43,31,10,4,246,14,260,5.384615384615385
20159,330455705260008,72,61,61,56,41,56,30,14,347,44,391,11.253196930946292
20160,330455705260009,30,36,55,33,38,34,24,7,226,31,257,12.062256809338521
20163,330455705270001,69,42,147,120,139,142,53,33,659,86,745,11.543624161073826
20164,330455705270002,53,89,88,102,104,111,86,67,547,153,700,21.857142857142858
20165,330455705270003,86,103,108,122,106,99,77,66,624,143,767,18.64406779661017
20166,330455705270004,52,103,143,91,118,119,80,78,626,158,784,20.153061224489797
20167,330455705270005,123,127,157,130,146,123,71,86,806,157,963,16.303219106957425
20168,330455705270006,71,85,102,124,78,106,67,54,566,121,687,17.612809315866084
20169,330455705270007,45,95,87,77,82,76,50,62,462,112,574,19.51219512195122
20170,330455705270008,59,77,75,69,57,75,53,39,412,92,504,18.253968253968253
20171,330455705270009,63,51,79,52,63,77,58,30,385,88,473,18.6046511627907
20172,330455705270010,82,114,123,139,116,105,89,72,679,161,840,19.166666666666668
20173,330455705270011,82,98,117,116,104,139,103,74,656,177,833,21.248499399759904
20174,330455705270012,97,143,127,134,122,122,113,73,745,186,931,19.978517722878625
20175,330455705270013,71,113,96,126,112,102,81,65,620,146,766,19.06005221932115
20176,330455705270014,57,71,77,86,90,82,99,77,463,176,639,27.54303599374022
20177,330455705270015,78,96,98,131,103,123,113,92,629,205,834,24.58033573141487
20178,330455705270016,59,96,100,124,81,98,77,49,558,126,684,18.42105263157895
20179,330455705270017,38,47,63,62,52,42,28,43,304,71,375,18.933333333333334
20180,330455705270018,104,117,118,110,91,83,55,48,623,103,726,14.18732782369146
20181,330455705270019,99,138,128,110,127,91,45,55,693,100,793,12.610340479192939
20182,330455705270020,78,118,112,111,111,83,60,62,613,122,735,16.598639455782312
20183,330455705270021,192,263,223,258,162,138,115,63,1236,178,1414,12.58840169731259
20184,330455705270022,164,183,167,197,140,136,90,55,987,145,1132,12.809187279151944
20185,330455705270023,139,169,140,83,93,51,24,15,675,39,714,5.46218487394958
20186,330455705270024,199,211,150,161,112,84,50,16,917,66,983,6.714140386571719
20187,330455705270025,34,41,43,51,46,53,54,51,268,105,373,28.15013404825737
20188,330455705270026,280,358,245,242,231,119,87,73,1475,160,1635,9.785932721712538
20189,330455705270027,133,186,171,122,138,95,35,28,845,63,908,6.938325991189427
20190,330455705270028,165,177,183,184,168,107,64,52,984,116,1100,10.545454545454545
20191,330455705270029,65,86,78,72,62,58,42,21,421,63,484,13.016528925619834
20192,330455705270030,78,130,136,127,131,127,59,68,729,127,856,14.836448598130842
20193,330455705270031,118,138,170,130,158,130,66,72,844,138,982,14.052953156822811
20194,330455705270032,66,70,71,77,55,53,26,39,392,65,457,14.223194748358862
20195,330455705270033,10,17,41,37,33,31,14,6,169,20,189,10.582010582010582
20196,330455705270034,117,163,136,144,136,99,43,46,795,89,884,10.06787330316742
20197,330455705270035,56,78,84,75,100,95,52,54,488,106,594,17.845117845117844
20198,330455705270036,76,97,123,101,111,115,56,50,623,106,729,14.540466392318244
20199,330455705270037,89,137,120,140,130,138,94,98,754,192,946,20.29598308668076
20200,330455705270038,72,90,98,109,88,76,64,38,533,102,635,16.062992125984252
20201,330455705270039,69,74,86,81,81,68,39,29,459,68,527,12.903225806451612
20202,330455705270040,107,114,143,142,116,78,80,70,700,150,850,17.647058823529413
20203,330455705270041,38,28,36,27,13,15,7,5,157,12,169,7.100591715976331
20204,330455705270042,94,125,118,141,139,82,42,22,699,64,763,8.387942332896461
20205,330455705270043,81,138,121,101,96,106,86,71,643,157,800,19.625
20206,330455705270044,55,69,95,78,66,58,69,39,421,108,529,20.415879017013232
20207,330455705270045,84,120,153,117,98,86,84,62,658,146,804,18.1592039800995
20208,330455705270046,61,77,78,79,80,84,45,47,459,92,551,16.696914700544465
20209,330455705270047,93,111,134,119,119,139,104,74,715,178,893,19.932810750279955
20210,330455705270048,69,73,102,116,81,95,91,57,536,148,684,21.637426900584796
20211,330455705270049,63,80,112,106,89,85,72,56,535,128,663,19.306184012066364
20212,330455705270050,42,71,84,69,77,86,78,37,429,115,544,21.139705882352942
20213,330455705270051,40,82,77,103,79,74,46,33,455,79,534,14.794007490636703
20214,330455705270052,55,63,84,90,68,67,66,39,427,105,532,19.736842105263158
20215,330455705270053,52,82,84,137,82,102,87,85,539,172,711,24.19127988748242
20216,330455705270054,61,74,104,121,109,91,97,90,560,187,747,25.0334672021419
20217,330455705270055,78,92,109,144,111,105,100,89,639,189,828,22.82608695652174
20218,330455705270056,15,26,26,30,45,54,44,31,196,75,271,27.675276752767527
20219,330455705270057,32,44,44,51,47,33,45,45,251,90,341,26.392961876832846
20220,330455705270058,47,54,56,54,48,61,47,42,320,89,409,21.760391198044008
20221,330455705270059,79,84,105,101,86,101,46,73,556,119,675,17.62962962962963
20222,330455705270060,103,106,94,126,100,104,87,84,633,171,804,21.26865671641791
20223,330455705270061,44,47,63,64,43,57,48,43,318,91,409,22.249388753056234
20224,330455705270062,100,122,136,115,112,99,70,27,684,97,781,12.419974391805377
20225,330455705270063,63,117,106,88,96,91,37,20,561,57,618,9.223300970873787
20226,330455705270064,107,102,117,78,56,55,25,15,515,40,555,7.207207207207207
20227,330455705270065,117,146,126,118,102,94,39,20,703,59,762,7.742782152230971
20228,330455705270066,83,128,98,108,76,59,35,27,552,62,614,10.09771986970684
20229,330455705270067,79,116,85,114,95,93,35,44,582,79,661,11.951588502269288
20230,330455705270068,149,205,155,182,154,130,76,53,975,129,1104,11.684782608695652
20231,330455705270069,86,94,149,139,131,100,50,26,699,76,775,9.806451612903226
20232,330455705270070,99,131,106,87,79,51,29,17,553,46,599,7.679465776293823
20233,330455705270071,154,210,158,143,136,95,43,19,896,62,958,6.471816283924843
20234,330455705270072,171,196,163,158,124,123,61,37,935,98,1033,9.486931268151016
20235,330455705270073,84,119,104,80,84,72,31,23,543,54,597,9.045226130653266
20236,330455705270074,95,108,130,105,107,88,46,58,633,104,737,14.111261872455902
20237,330455705270075,85,103,120,111,109,79,52,55,607,107,714,14.985994397759104
20238,330455705270076,74,61,96,100,73,98,59,41,502,100,602,16.611295681063122
20239,330455705270077,151,174,141,167,113,112,70,52,858,122,980,12.448979591836734
20240,330455705270078,83,107,125,125,116,109,92,46,665,138,803,17.185554171855543
20241,330455705270079,93,120,121,103,114,103,58,67,654,125,779,16.046213093709884
20242,330455705270080,86,129,113,116,103,132,65,78,679,143,822,17.39659367396594
20243,330455705270081,117,192,177,183,182,163,90,67,1014,157,1171,13.40734415029889
20244,330455705270082,67,95,119,103,79,87,47,45,550,92,642,14.330218068535826
20245,330455705270083,128,114,114,91,64,53,25,7,564,32,596,5.369127516778524
20246,330455705270084,74,104,99,105,90,95,53,29,567,82,649,12.63482280431433
20247,330455705270085,76,116,135,101,104,70,53,24,602,77,679,11.34020618556701
20248,330455705270086,99,140,152,133,118,114,48,54,756,102,858,11.888111888111888
20249,330455705270087,101,125,119,147,89,85,50,29,666,79,745,10.604026845637584
20250,330455705270088,142,147,186,132,104,104,66,34,815,100,915,10.92896174863388
20251,330455705270089,69,98,85,98,82,78,38,31,510,69,579,11.917098445595855
20252,330455705270090,72,88,78,79,59,53,27,27,429,54,483,11.180124223602485
20253,330455705270091,128,125,114,137,116,88,60,41,708,101,809,12.484548825710753
20254,330455705270092,84,102,86,105,70,59,43,16,506,59,565,10.442477876106194
20255,330455705270093,45,76,73,56,72,65,27,38,387,65,452,14.380530973451327
20256,330455705270094,99,120,126,104,108,84,60,61,641,121,762,15.879265091863518
20257,330455705270095,126,141,179,166,144,138,100,80,894,180,1074,16.75977653631285
20258,330455705270096,85,92,98,83,80,78,35,22,516,57,573,9.947643979057592
20259,330455705270097,107,128,98,136,103,71,40,37,643,77,720,10.694444444444445
20260,330455705270098,123,133,141,140,109,121,65,58,767,123,890,13.820224719101123
20261,330455705270099,106,140,169,122,135,118,70,51,790,121,911,13.282107574094402
20262,330455705270100,119,140,182,120,143,112,52,60,816,112,928,12.068965517241379
20263,330455705270101,27,37,19,26,24,19,11,7,152,18,170,10.588235294117647
20264,330455705270102,162,169,175,142,139,95,59,48,882,107,989,10.819009100101113
20265,330455705270103,24,29,16,14,17,13,4,1,113,5,118,4.237288135593221
20266,330455705270104,71,107,109,95,92,83,48,40,557,88,645,13.643410852713178
20267,330455705270105,70,78,113,94,84,87,52,48,526,100,626,15.97444089456869
20268,330455705270106,52,67,62,62,62,37,34,23,342,57,399,14.285714285714286
20269,330455705270107,60,91,114,77,98,77,53,58,517,111,628,17.67515923566879
20270,330455705270108,42,84,96,70,88,82,21,28,462,49,511,9.58904109589041
20271,330455705270109,3,6,5,4,3,4,3,0,25,3,28,10.714285714285714
20272,330455705270110,59,97,84,94,81,64,30,33,479,63,542,11.623616236162361
20273,330455705270111,54,71,74,63,62,58,26,43,382,69,451,15.299334811529933
20274,330455705270112,73,103,157,113,106,110,62,64,662,126,788,15.98984771573604
20275,330455705270113,55,88,80,73,81,81,34,35,458,69,527,13.092979127134726
20276,330455705270114,112,130,148,98,137,125,52,37,750,89,839,10.607866507747318
20277,330455705270115,21,28,18,17,15,10,6,1,109,7,116,6.0344827586206895
20278,330455705270116,111,124,134,123,111,77,36,29,680,65,745,8.724832214765101
20279,330455705270117,119,167,150,132,159,93,87,71,820,158,978,16.155419222903884
20280,330455705270118,55,96,80,87,67,51,38,37,436,75,511,14.677103718199609
20281,330455705270119,75,104,103,94,99,94,48,54,569,102,671,15.201192250372578
20282,330455705270120,32,33,25,30,16,15,16,8,151,24,175,13.714285714285714
20283,330455705270121,112,149,143,155,122,93,66,47,774,113,887,12.739571589627959
20284,330455705270122,52,70,48,50,41,34,15,15,295,30,325,9.23076923076923
20285,330455705270123,128,230,183,156,170,127,65,31,994,96,1090,8.807339449541285
20286,330455705270124,111,121,172,144,123,119,84,57,790,141,931,15.14500537056928
20287,330455705270125,35,61,44,46,52,50,20,13,288,33,321,10.280373831775702
20288,330455705270126,62,71,86,65,66,55,31,27,405,58,463,12.526997840172786
20289,330455705270127,85,134,115,107,107,88,41,42,636,83,719,11.543810848400556
20290,330455705270128,68,63,69,63,70,60,28,22,393,50,443,11.286681715575622
20291,330455705270129,38,36,70,56,44,34,9,8,278,17,295,5.762711864406779
20292,330455705270130,56,61,57,48,42,22,23,12,286,35,321,10.903426791277258
20293,330455705270131,85,97,77,66,62,37,13,15,424,28,452,6.1946902654867255
20294,330455705270132,66,71,59,43,48,39,18,10,326,28,354,7.909604519774011
20295,330455705270133,94,90,73,76,44,43,31,9,420,40,460,8.695652173913043
20296,330455705270134,164,188,167,125,137,99,50,19,880,69,949,7.2708113804004215
20297,330455705270135,124,153,122,125,95,83,70,38,702,108,810,13.333333333333334
20298,330455705270136,129,172,170,173,173,131,46,41,948,87,1035,8.405797101449275
20299,330455705270137,82,90,76,75,61,74,40,30,458,70,528,13.257575757575758
20300,330455705270138,144,203,195,173,161,153,80,73,1029,153,1182,12.944162436548224
20301,330455705270139,77,98,110,77,107,94,51,55,563,106,669,15.844544095665173
20302,330455705270140,53,80,117,95,109,69,51,48,523,99,622,15.916398713826366
20303,330455705270141,110,90,139,128,124,129,80,105,720,185,905,20.441988950276244
20304,330455705270142,78,113,92,112,93,89,55,43,577,98,675,14.518518518518519
20305,330455705270143,91,123,127,105,120,107,70,67,673,137,810,16.91358024691358
20306,330455705270144,37,61,80,67,61,56,53,36,362,89,451,19.733924611973393
20307,330455705270145,38,58,77,65,70,77,49,41,385,90,475,18.94736842105263
20308,330455705270146,112,150,151,173,141,127,112,66,854,178,1032,17.248062015503876
20309,330455705270147,92,125,152,99,129,101,80,45,698,125,823,15.188335358444714
20310,330455705270148,72,100,101,125,122,87,58,41,607,99,706,14.022662889518413
20311,330455705270149,101,127,129,138,134,92,70,51,721,121,842,14.370546318289787
20312,330455705270150,103,141,132,129,110,109,55,40,724,95,819,11.5995115995116
20313,330455705270151,110,172,146,132,127,125,66,46,812,112,924,12.121212121212121
20314,330455705270152,76,69,79,81,68,57,40,25,430,65,495,13.131313131313131
20315,330455705270153,163,186,150,134,101,80,44,21,814,65,879,7.39476678043231
20316,330455705270154,108,151,123,112,131,109,46,67,734,113,847,13.34120425029516
20317,330455705270155,53,74,59,71,56,57,22,30,370,52,422,12.322274881516588
20318,330455705270156,114,148,171,156,144,121,83,99,854,182,1036,17.56756756756757
20319,330455705270157,86,112,107,124,110,96,48,69,635,117,752,15.558510638297872
20320,330455705270158,106,145,149,155,154,120,89,61,829,150,979,15.321756894790603
20321,330455705270159,95,108,111,114,99,78,61,52,605,113,718,15.73816155988858
20322,330455705270160,60,97,108,126,119,95,104,58,605,162,767,21.121251629726206
20323,330455705270161,95,121,136,130,121,81,84,39,684,123,807,15.241635687732343
20324,330455705270162,88,97,102,116,108,74,80,50,585,130,715,18.181818181818183
20325,330455705270163,98,126,150,124,136,107,87,50,741,137,878,15.60364464692483
20326,330455705270164,128,115,143,138,129,72,86,45,725,131,856,15.30373831775701
20327,330455705270165,119,122,137,145,97,110,70,45,730,115,845,13.609467455621301
20328,330455705270166,39,76,58,44,50,43,26,11,310,37,347,10.662824207492795
20329,330455705270167,107,114,90,137,83,83,67,34,614,101,715,14.125874125874127
20330,330455705270168,98,127,106,130,87,68,62,33,616,95,711,13.361462728551336
20331,330455705270169,142,177,155,179,184,123,105,87,960,192,1152,16.666666666666668
20332,330455705270170,54,97,95,123,74,59,42,24,502,66,568,11.619718309859154
20333,330455705270171,84,105,96,110,84,73,62,39,552,101,653,15.46707503828484
20334,330455705270172,97,116,117,113,101,70,71,48,614,119,733,16.234652114597544
20335,330455705270173,65,76,92,115,89,67,56,24,504,80,584,13.698630136986301
20336,330455705270174,70,101,86,84,114,87,53,39,542,92,634,14.511041009463723
20337,330455705270175,51,67,58,68,67,48,37,37,359,74,433,17.090069284064665
20338,330455705270176,131,202,238,253,211,124,82,51,1159,133,1292,10.294117647058824
20339,330455705270177,134,202,171,199,168,133,78,61,1007,139,1146,12.12914485165794
20340,330455705270178,73,132,89,85,70,74,26,30,523,56,579,9.671848013816925
20341,330455705270179,112,124,76,108,86,59,30,12,565,42,607,6.919275123558484
20342,330455705270180,142,215,144,140,140,119,53,37,900,90,990,9.090909090909092
20343,330455705270181,81,89,92,100,66,66,32,24,494,56,550,10.181818181818182
20344,330455705270182,41,63,65,46,52,59,30,28,326,58,384,15.104166666666666
20345,330455705270183,73,138,116,80,113,91,40,39,611,79,690,11.44927536231884
20346,330455705270184,92,120,122,124,111,85,54,41,654,95,749,12.683578104138851
20347,330455705270185,82,118,108,84,85,65,25,11,542,36,578,6.228373702422146
20348,330455705270186,116,159,110,131,92,63,34,14,671,48,719,6.675938803894297
20349,330455705270187,115,116,118,94,114,70,41,20,627,61,688,8.866279069767442
20350,330455705270188,133,160,188,158,133,109,53,21,881,74,955,7.7486910994764395
20351,330455705270189,84,102,153,109,131,94,59,44,673,103,776,13.27319587628866
20352,330455705270190,111,114,126,136,107,96,68,58,690,126,816,15.441176470588236
20353,330455705270191,88,110,105,120,98,104,66,57,625,123,748,16.44385026737968
20354,330455705270192,102,109,97,109,91,94,61,48,602,109,711,15.330520393811533
20355,330455705270193,57,84,102,85,85,72,54,47,485,101,586,17.235494880546074
20356,330455705270194,95,117,118,102,106,97,53,46,635,99,734,13.487738419618529
20357,330455705270195,80,85,109,94,69,63,41,24,500,65,565,11.504424778761061
20358,330455705270196,61,80,80,68,91,71,46,35,451,81,532,15.225563909774436
20359,330455705270197,89,103,73,110,89,72,71,73,536,144,680,21.176470588235293
20360,330455705270198,111,147,132,131,114,99,50,52,734,102,836,12.200956937799043
20361,330455705270199,120,167,124,147,131,123,58,71,812,129,941,13.708820403825717
20362,330455705270200,74,86,85,81,112,60,66,52,498,118,616,19.155844155844157
20363,330455705270201,103,129,115,112,108,93,65,54,660,119,779,15.27599486521181
20364,330455705270202,126,172,181,136,142,134,99,66,891,165,1056,15.625
20365,330455705270203,111,131,137,129,130,100,67,61,738,128,866,14.780600461893764
20366,330455705270204,59,101,92,89,83,68,49,63,492,112,604,18.543046357615893
20367,330455705270205,75,79,106,86,75,98,39,49,519,88,607,14.497528830313016
20368,330455705270206,40,73,89,88,90,102,51,51,482,102,584,17.465753424657535
20369,330455705270207,43,67,67,64,84,77,35,54,402,89,491,18.126272912423627
20370,330455705270208,60,84,87,79,104,92,71,61,506,132,638,20.689655172413794
20371,330455705270209,69,82,111,97,89,98,63,61,546,124,670,18.507462686567163
20372,330455705270210,111,120,104,94,116,63,53,49,608,102,710,14.366197183098592
20373,330455705270211,106,133,139,110,140,98,67,61,726,128,854,14.988290398126464
20374,330455705270212,53,80,66,71,74,55,33,27,399,60,459,13.071895424836601
20375,330455705270213,27,17,23,28,34,15,13,3,144,16,160,10.0
20376,330455705270214,233,224,190,214,115,86,25,21,1062,46,1108,4.1516245487364625
20377,330455705270215,115,132,97,107,85,53,25,14,589,39,628,6.210191082802548
20378,330455705270216,74,71,79,44,46,32,16,2,346,18,364,4.945054945054945
20379,330455705270217,31,45,33,19,29,23,2,7,180,9,189,4.761904761904762
20380,330455705270218,19,19,17,17,20,11,11,12,103,23,126,18.253968253968253
20381,330455705270219,44,37,34,29,21,14,5,3,179,8,187,4.278074866310161
20382,330455705270220,50,59,28,32,23,25,10,2,217,12,229,5.240174672489083
20383,330455705270221,18,14,28,23,13,14,13,8,110,21,131,16.03053435114504
20384,330455705270222,16,18,20,14,25,15,6,8,108,14,122,11.475409836065573
20385,330455705270223,38,31,36,35,25,40,15,3,205,18,223,8.071748878923767
20386,330455705270224,131,123,112,82,68,52,31,11,568,42,610,6.885245901639344
20387,330455705270225,300,244,281,358,200,167,99,36,1550,135,1685,8.011869436201781
20388,330455705270226,24,42,23,28,16,14,15,7,147,22,169,13.017751479289942
20389,330455705270227,98,118,116,124,93,66,47,36,615,83,698,11.89111747851003
20390,330455705270228,53,67,70,58,76,68,41,23,392,64,456,14.035087719298245
20391,330455705270229,97,83,164,226,137,89,82,28,796,110,906,12.141280353200884
20392,330455705270230,81,87,85,107,79,57,55,55,496,110,606,18.151815181518153
20393,330455705270231,39,61,54,53,73,46,25,34,326,59,385,15.324675324675324
20394,330455705270232,40,35,37,40,29,12,8,7,193,15,208,7.211538461538462
20395,330455705270233,13,38,23,19,22,12,8,5,127,13,140,9.285714285714286
20396,330455705280001,73,85,117,138,124,141,67,53,678,120,798,15.037593984962406
20397,330455705280002,91,113,108,75,60,34,19,8,481,27,508,5.31496062992126
20398,330455705280003,68,87,71,53,39,27,13,11,345,24,369,6.504065040650406
20399,330455705280004,80,97,81,73,49,24,12,7,404,19,423,4.491725768321513
20400,330455705280005,83,100,137,78,45,61,25,11,504,36,540,6.666666666666667
20401,330455705280006,44,62,42,45,41,38,16,8,272,24,296,8.108108108108109
20402,330455705280007,81,59,96,61,26,10,4,5,333,9,342,2.6315789473684212
20403,330455705280008,102,118,165,90,65,44,31,17,584,48,632,7.594936708860759
20404,330455705280009,118,97,173,125,44,29,40,16,586,56,642,8.722741433021806
20405,330455705280010,34,51,53,71,71,57,32,26,337,58,395,14.683544303797468
20406,330455705280011,16,29,51,31,29,10,7,2,166,9,175,5.142857142857143
20407,330455705280012,42,55,71,66,57,58,25,32,349,57,406,14.039408866995075
20408,330455705280013,42,42,43,53,36,29,27,21,245,48,293,16.38225255972696
20409,330455705280014,21,34,32,21,31,17,3,16,156,19,175,10.857142857142858
20410,330455705280015,107,150,132,134,94,74,33,25,691,58,749,7.74365821094793
20411,330455705280016,53,78,131,158,76,88,64,52,584,116,700,16.571428571428573
20412,330455705280017,77,108,121,105,75,79,35,31,565,66,631,10.45958795562599
20413,330455705280018,21,38,42,24,31,16,9,8,172,17,189,8.994708994708995
20414,330455705280019,109,126,154,117,105,64,28,20,675,48,723,6.639004149377594
20415,330455705280020,167,194,211,179,107,55,26,12,913,38,951,3.995793901156677
20416,330455705280021,161,254,225,281,181,112,61,31,1214,92,1306,7.044410413476263
20417,330455705280022,145,159,222,278,97,97,81,10,998,91,1089,8.356290174471992
20418,330455705280023,98,124,154,166,144,93,49,72,779,121,900,13.444444444444445
20419,330455705280024,88,92,121,108,120,73,39,30,602,69,671,10.283159463487332
20420,330455705280025,39,61,76,100,138,102,36,38,516,74,590,12.542372881355933
20421,330455705280026,25,54,55,65,65,48,27,32,312,59,371,15.902964959568733
20422,330455705280027,18,33,19,34,18,15,10,7,137,17,154,11.03896103896104
20423,330455705280028,37,57,79,72,46,54,30,20,345,50,395,12.658227848101266
20424,330455705280029,51,64,92,101,90,67,48,48,465,96,561,17.112299465240643
20425,330455705280030,83,96,137,134,137,109,73,88,696,161,857,18.78646441073512
20426,330455705280031,36,58,109,100,82,58,46,50,443,96,539,17.810760667903526
20427,330455705280032,114,151,180,171,163,141,64,59,920,123,1043,11.792905081495686
20428,330455705280033,18,25,26,38,21,26,9,9,154,18,172,10.465116279069768
20429,330455705280034,16,18,27,32,21,26,16,19,140,35,175,20.0
20430,330455705280035,88,122,194,165,165,123,61,62,857,123,980,12.551020408163266
20431,330455705280036,20,26,62,62,50,44,29,34,264,63,327,19.26605504587156
20432,330455705280037,68,99,178,174,164,107,69,53,790,122,912,13.37719298245614
20433,330455705280038,11,19,37,50,33,48,20,20,198,40,238,16.80672268907563
20434,330455705280039,40,55,82,109,117,88,44,48,491,92,583,15.780445969125214
20435,330455705280040,26,18,52,66,53,36,25,33,251,58,309,18.77022653721683
20436,330455705280041,32,23,37,66,34,55,23,23,247,46,293,15.699658703071673
20437,330455705280042,31,40,64,90,76,74,38,30,375,68,443,15.349887133182845
20438,330455705280043,28,39,33,42,50,31,25,19,223,44,267,16.47940074906367
20439,330455705280044,6,10,8,9,7,4,1,4,44,5,49,10.204081632653061
20440,330455705280045,35,40,98,74,44,48,39,50,339,89,428,20.794392523364486
20441,330455705280046,14,14,18,17,16,13,9,6,92,15,107,14.018691588785046
20442,330455705280047,14,23,54,61,50,54,26,34,256,60,316,18.9873417721519
20443,330455705280048,55,57,112,79,86,83,52,42,472,94,566,16.607773851590107
20444,330455705280049,14,28,49,45,36,20,21,19,192,40,232,17.24137931034483
20445,330455705280050,21,37,60,70,61,52,29,29,301,58,359,16.15598885793872
20446,330455705280051,27,57,71,75,58,54,34,25,342,59,401,14.713216957605985
20447,330455705280052,13,9,12,10,8,9,2,1,61,3,64,4.6875
20448,330455705280053,14,10,27,11,14,8,10,4,84,14,98,14.285714285714286
20449,330455705280054,19,21,35,26,37,34,19,25,172,44,216,20.37037037037037
20450,330455705280055,18,16,39,31,23,20,21,17,147,38,185,20.54054054054054
20451,330455705280056,29,54,101,82,75,84,57,44,425,101,526,19.20152091254753
20452,330455705280057,14,12,22,40,25,38,22,11,151,33,184,17.934782608695652
20453,330455705280058,7,14,15,18,26,17,11,15,97,26,123,21.13821138211382
20454,330455705280059,55,52,144,125,135,99,51,59,610,110,720,15.277777777777779
20455,330455705280060,39,37,33,55,33,19,13,4,216,17,233,7.296137339055794
20456,330455705280061,27,39,70,41,50,49,18,17,276,35,311,11.254019292604502
20457,330455705280062,3,10,15,17,14,11,7,6,70,13,83,15.662650602409638
20458,330455705280063,52,67,87,113,98,74,56,44,491,100,591,16.920473773265652
20459,330455705280064,14,23,44,45,45,53,30,18,224,48,272,17.647058823529413
20460,330455705280065,68,79,184,117,83,67,35,19,598,54,652,8.282208588957054
20461,330455705280066,24,45,52,65,52,42,17,15,280,32,312,10.256410256410257
20462,330455705280067,35,48,96,75,65,64,52,42,383,94,477,19.70649895178197
20463,330455705280068,73,103,196,158,126,110,78,81,766,159,925,17.18918918918919
20464,330455705280069,74,89,168,159,110,99,62,47,699,109,808,13.490099009900991
20465,330455705280070,13,46,85,75,70,49,25,43,338,68,406,16.748768472906406
20466,330455705280071,8,28,51,30,29,33,26,111,179,137,316,43.35443037974684
20467,330455705280072,19,30,92,63,69,71,37,28,344,65,409,15.89242053789731
20468,330455705280073,23,23,54,86,55,55,30,54,296,84,380,22.105263157894736
20469,330455705280074,19,37,69,77,56,41,32,34,299,66,365,18.08219178082192
20470,330455705280075,36,55,98,89,62,66,32,31,406,63,469,13.432835820895523
20471,330455705280076,14,19,20,27,32,28,18,15,140,33,173,19.07514450867052
20472,330455705280077,43,41,47,70,54,62,27,34,317,61,378,16.137566137566136
20473,330455705280078,14,35,105,116,90,67,43,27,427,70,497,14.084507042253522
20474,330455705280079,5,11,19,20,11,15,10,6,81,16,97,16.49484536082474
20475,330455705280080,32,67,110,78,91,69,50,56,447,106,553,19.168173598553345
20476,330455705280081,76,96,151,160,142,116,78,52,741,130,871,14.925373134328359
20477,330455705280082,111,116,127,134,92,88,54,43,668,97,765,12.679738562091503
20478,330455705280083,24,25,27,37,16,16,7,5,145,12,157,7.643312101910828
20479,330455705280084,9,12,10,4,11,2,6,1,48,7,55,12.727272727272727
20480,330455705280085,25,25,77,66,32,14,14,1,239,15,254,5.905511811023622
20481,330455705280086,2,9,5,6,0,5,2,1,27,3,30,10.0
20482,330455705280087,142,173,195,189,125,67,25,14,891,39,930,4.193548387096774
20483,330455705280088,1,1,4,3,1,1,2,0,11,2,13,15.384615384615385
20484,330455705280089,65,55,53,60,40,22,13,9,295,22,317,6.94006309148265
20485,330455705280090,28,44,19,39,15,17,4,2,162,6,168,3.5714285714285716
20486,330455705280091,6,4,8,14,5,10,2,5,47,7,54,12.962962962962964
20487,330455705280092,4,0,3,4,1,3,2,2,15,4,19,21.05263157894737
20488,330455705280093,30,45,76,91,86,58,55,51,386,106,492,21.54471544715447
20489,330455705280094,54,64,52,36,34,28,16,18,268,34,302,11.258278145695364
20490,330455705280095,11,18,14,21,11,16,11,4,91,15,106,14.150943396226415
20491,330455705290001,62,71,136,125,126,124,111,63,644,174,818,21.271393643031786
20492,330455705290002,43,53,94,66,75,86,83,51,417,134,551,24.319419237749546
20493,330455705290003,209,266,341,302,273,172,92,32,1563,124,1687,7.350326022525192
20494,330455705290004,88,113,158,125,94,68,42,32,646,74,720,10.277777777777779
20495,330455705290005,92,91,179,167,93,31,19,8,653,27,680,3.9705882352941178
20496,330455705290006,80,92,140,115,66,39,12,7,532,19,551,3.4482758620689653
20497,330455705290007,213,184,325,210,125,63,22,10,1120,32,1152,2.7777777777777777
20498,330455705290008,90,108,157,131,149,139,86,54,774,140,914,15.317286652078774
20499,330455705290009,83,80,96,94,66,40,21,16,459,37,496,7.459677419354839
20500,330455705290010,166,145,215,228,134,74,33,12,962,45,1007,4.468718967229394
20501,330455705290011,202,266,280,280,197,144,66,42,1369,108,1477,7.312119160460393
20502,330455705290012,167,216,164,209,181,81,38,19,1018,57,1075,5.3023255813953485
20503,330455705290013,140,107,146,118,55,25,10,2,591,12,603,1.9900497512437811
20504,330455705290014,367,367,471,382,209,86,31,12,1882,43,1925,2.2337662337662336
20505,330455705290015,188,143,241,187,94,35,7,5,888,12,900,1.3333333333333333
20506,330455705290016,198,180,287,224,111,35,10,8,1035,18,1053,1.7094017094017093
20507,330455705290017,125,136,196,143,82,35,13,6,717,19,736,2.5815217391304346
20508,330455705290018,121,92,141,157,59,17,3,5,587,8,595,1.3445378151260505
20509,330455705290022,136,123,148,235,182,111,55,38,935,93,1028,9.04669260700389
20510,330455705290023,106,124,136,195,158,103,40,23,822,63,885,7.11864406779661
20511,330455705290024,115,102,107,201,169,94,40,18,788,58,846,6.855791962174941
20512,330455705290025,111,128,116,224,187,109,48,26,875,74,949,7.79768177028451
20513,330455705290026,47,73,59,84,68,47,14,13,378,27,405,6.666666666666667
20514,330455705290027,110,150,160,143,153,166,108,51,882,159,1041,15.27377521613833
20515,330455705290028,26,38,34,28,33,39,29,12,198,41,239,17.15481171548117
20516,330455705290029,63,71,59,93,70,49,23,17,405,40,445,8.98876404494382
20517,330455705290030,121,144,173,126,112,75,28,7,751,35,786,4.4529262086514
20518,330455705290031,233,372,268,461,367,194,63,20,1895,83,1978,4.196157735085945
20519,330455705290032,137,168,213,167,196,204,161,130,1085,291,1376,21.148255813953487
20520,330455705290033,56,73,102,76,111,98,67,58,516,125,641,19.50078003120125
20521,330455705290034,52,70,87,100,88,107,66,75,504,141,645,21.86046511627907
20522,330455705290035,52,88,93,100,108,104,66,63,545,129,674,19.13946587537092
20523,330455705290036,61,63,92,103,126,76,71,56,521,127,648,19.598765432098766
20524,330455705290037,10,12,23,35,31,27,18,16,138,34,172,19.767441860465116
20525,330455705290038,59,62,98,100,80,108,81,77,507,158,665,23.7593984962406
20526,330455705290039,31,29,63,68,54,65,53,53,310,106,416,25.48076923076923
20527,330455705290040,37,50,84,125,118,85,63,71,499,134,633,21.169036334913113
20528,330455705290041,48,51,107,100,92,99,78,69,497,147,644,22.82608695652174
20529,330455705290042,53,64,101,90,102,97,72,52,507,124,631,19.6513470681458
20530,330455705290043,20,23,32,45,41,24,32,51,185,83,268,30.970149253731343
20531,330455705290044,78,91,107,126,94,130,99,80,626,179,805,22.236024844720497
20532,330455705290045,70,57,99,142,113,115,101,89,596,190,786,24.173027989821882
20533,330455705290046,55,84,128,115,115,126,113,86,623,199,822,24.209245742092456
20534,330455705290047,40,38,96,82,72,87,74,55,415,129,544,23.71323529411765
20535,330455705290048,83,71,117,156,118,134,134,80,679,214,893,23.96416573348264
20536,330455705290049,70,53,107,116,101,86,57,51,533,108,641,16.848673946957877
20537,330455705290050,108,128,184,168,210,196,148,98,994,246,1240,19.838709677419356
20538,330455705290051,132,111,173,213,173,209,137,124,1011,261,1272,20.5188679245283
20539,330455705290052,59,62,113,105,99,117,75,72,555,147,702,20.94017094017094
20540,330455705290053,73,81,124,154,137,155,127,77,724,204,928,21.982758620689655
20541,330455705290054,80,67,79,115,99,107,91,40,547,131,678,19.321533923303836
20542,330455705290055,65,68,62,120,107,81,66,72,503,138,641,21.52886115444618
20543,330455705290056,46,78,102,84,111,143,75,88,564,163,727,22.420907840440165
20544,330455705290057,53,64,111,105,102,110,92,69,545,161,706,22.804532577903682
20545,330455705290058,64,91,139,144,142,149,127,91,729,218,947,23.020063357972546
20546,330455705290059,179,248,358,415,291,235,141,74,1726,215,1941,11.076764554353426
20547,330455705290060,10,21,27,18,15,15,7,3,106,10,116,8.620689655172415
20548,330455705290061,91,103,148,211,134,139,85,44,826,129,955,13.507853403141361
20549,330455705290062,26,46,134,188,104,98,78,49,596,127,723,17.56569847856155
20550,330455705290063,42,58,107,102,91,119,116,94,519,210,729,28.80658436213992
20551,330455705290064,54,34,74,83,81,71,69,54,397,123,520,23.653846153846153
20552,330455705290065,44,70,79,70,102,98,74,52,463,126,589,21.39219015280136
20553,330455705290066,12,19,51,67,59,58,45,26,266,71,337,21.068249258160236
20554,330455705290067,60,55,46,53,79,57,35,24,350,59,409,14.425427872860636
20555,330455705290068,85,62,60,102,90,59,53,36,458,89,547,16.270566727605118
20556,330455705290069,15,26,59,85,93,57,31,39,335,70,405,17.28395061728395
20557,330455705290070,102,73,137,171,148,84,60,40,715,100,815,12.269938650306749
20558,330455705290071,66,31,128,233,72,68,49,34,598,83,681,12.187958883994126
20559,330455705290072,52,52,114,166,84,94,72,50,562,122,684,17.83625730994152
20560,330455705290073,77,96,98,109,115,127,76,44,622,120,742,16.172506738544474
20561,330455705290074,46,52,70,49,73,71,24,26,361,50,411,12.165450121654501
20562,330455705290075,29,43,69,71,58,53,36,31,323,67,390,17.17948717948718
20563,330455705290076,74,87,182,160,106,125,73,65,734,138,872,15.825688073394495
20564,330455705290077,50,33,70,86,66,65,68,34,370,102,472,21.610169491525422
20565,330455705290078,29,36,77,75,76,79,50,42,372,92,464,19.82758620689655
20566,330455705290079,77,105,145,103,116,160,79,47,706,126,832,15.14423076923077
20567,330455705290080,65,107,138,132,145,153,91,93,740,184,924,19.913419913419915
20568,330455705290081,32,41,77,75,67,61,29,27,353,56,409,13.691931540342297
20569,330455705290082,31,25,94,92,45,51,25,12,338,37,375,9.866666666666667
20570,330455705290083,46,58,89,88,87,64,42,19,432,61,493,12.373225152129818
20571,330455705290084,69,94,122,120,110,149,82,59,664,141,805,17.51552795031056
20572,330455705290085,48,37,115,148,103,105,75,62,556,137,693,19.76911976911977
20573,330455705290086,71,86,130,168,120,121,88,66,696,154,850,18.11764705882353
20574,330455705290087,19,28,41,30,39,51,34,17,208,51,259,19.69111969111969
20575,330455705290088,54,73,114,84,114,117,76,41,556,117,673,17.38484398216939
20576,330455705290089,93,64,115,208,145,107,61,53,732,114,846,13.47517730496454
20577,330455705290090,56,77,131,99,98,160,70,101,621,171,792,21.59090909090909
20578,330455705290091,74,85,108,138,123,103,64,42,631,106,737,14.382632293080054
20579,330455705290092,28,41,61,125,109,115,118,128,479,246,725,33.93103448275862
20580,330455705290093,51,49,66,110,81,111,115,144,468,259,727,35.62585969738652
20581,330455705290094,11,8,17,48,46,74,52,21,204,73,277,26.353790613718413
20582,330455705290095,9,32,45,50,60,75,96,75,271,171,442,38.68778280542986
20583,330455705290096,86,98,175,92,162,160,89,37,773,126,899,14.015572858731923
20584,330455705290097,29,30,72,53,58,67,63,79,309,142,451,31.485587583148558
20585,330455705290098,127,116,175,194,208,199,103,44,1019,147,1166,12.607204116638078
20586,330455705290099,23,57,61,44,55,85,66,52,325,118,443,26.636568848758465
20587,330455705290100,53,94,75,64,95,86,97,71,467,168,635,26.456692913385826
20588,330455705290101,46,60,56,65,95,73,52,53,395,105,500,21.0
20589,330455705290102,69,69,54,73,90,80,49,29,435,78,513,15.2046783625731
20590,330455705290103,47,64,92,82,93,127,85,53,505,138,643,21.46189735614308
20591,330455705290104,133,107,122,191,199,153,116,43,905,159,1064,14.943609022556391
20592,330455705290105,123,134,182,279,195,221,125,80,1134,205,1339,15.30993278566094
20593,330455705290106,16,19,64,109,45,40,24,10,293,34,327,10.397553516819572
20594,330455705290107,62,31,111,176,107,71,63,42,558,105,663,15.83710407239819
20595,330455705290108,21,25,67,80,42,33,11,11,268,22,290,7.586206896551724
20596,330455705290109,19,19,84,109,43,43,29,17,317,46,363,12.672176308539944
20597,330455705290110,19,17,78,86,38,44,37,32,282,69,351,19.65811965811966
20598,330455705290111,5,1,39,55,28,18,35,23,146,58,204,28.431372549019606
20599,330455705290112,14,6,58,58,34,39,17,16,209,33,242,13.636363636363637
20600,330455705290113,22,13,72,81,30,51,38,29,269,67,336,19.94047619047619
20601,330455705290114,17,27,150,101,78,42,38,22,415,60,475,12.631578947368421
20602,330455705290115,17,9,67,80,40,42,16,13,255,29,284,10.211267605633802
20603,330455705290116,62,111,134,118,128,135,106,74,688,180,868,20.737327188940093
20604,330455705290117,48,76,90,71,83,103,72,48,471,120,591,20.304568527918782
20605,330455705290118,50,45,79,93,83,115,106,118,465,224,689,32.51088534107402
20606,330455705290119,37,44,79,71,87,106,100,106,424,206,630,32.698412698412696
20607,330455705290120,74,96,115,118,132,160,161,109,695,270,965,27.979274611398964
20608,330455705290121,4,31,30,46,32,27,16,12,170,28,198,14.141414141414142
20609,330455705290122,38,59,113,88,86,130,103,99,514,202,716,28.212290502793294
20610,330455705290123,57,81,93,111,96,82,66,47,520,113,633,17.851500789889414
20611,330455705290124,44,55,101,94,84,107,94,68,485,162,647,25.038639876352395
20612,330455705290125,229,209,200,257,297,270,192,139,1462,331,1793,18.460680423870606
20613,330455705290126,32,23,43,49,31,33,28,17,211,45,256,17.578125
20614,330455705290128,30,56,58,54,60,69,59,49,327,108,435,24.82758620689655
20615,330455705290129,9,18,62,52,41,54,57,64,236,121,357,33.89355742296919
20616,330455705290130,26,17,74,73,54,69,78,93,313,171,484,35.33057851239669
20617,330455705290131,71,75,122,133,120,162,116,94,683,210,893,23.516237402015676
20618,330455705290132,27,21,68,62,47,80,55,56,305,111,416,26.682692307692307
20619,330455705290133,21,39,66,52,52,63,45,41,293,86,379,22.691292875989447
20620,330455705290134,20,35,61,50,45,69,55,37,280,92,372,24.731182795698924
20621,330455705290135,30,38,74,113,64,93,61,37,412,98,510,19.215686274509803
20622,330455705290136,40,31,68,98,64,66,49,50,367,99,466,21.244635193133046
20623,330455705290137,61,77,111,120,102,136,108,117,607,225,832,27.04326923076923
20624,330455705290138,50,49,82,77,83,105,74,56,446,130,576,22.569444444444443
20625,330455705290139,21,22,39,63,47,64,56,53,256,109,365,29.863013698630137
20626,330455705290140,36,39,78,82,61,88,79,72,384,151,535,28.22429906542056
20627,330455705290141,44,40,71,79,52,87,68,66,373,134,507,26.429980276134124
20628,330455705290142,56,44,94,81,66,92,62,47,433,109,542,20.11070110701107
20629,330455705290143,12,10,35,34,40,40,45,43,171,88,259,33.97683397683398
20630,330455705290144,14,8,26,28,23,23,29,19,122,48,170,28.235294117647058
20631,330455705290145,172,137,156,175,203,220,128,80,1063,208,1271,16.365066876475215
20632,330455705290146,2,2,12,15,12,13,11,6,56,17,73,23.28767123287671
20633,330455705290147,5,3,35,34,27,43,32,13,147,45,192,23.4375
20634,330455705290148,17,19,27,48,35,36,30,24,182,54,236,22.88135593220339
20635,330455705290149,12,12,24,32,23,26,17,10,129,27,156,17.307692307692307
20636,330455705290150,61,63,102,120,99,100,79,51,545,130,675,19.25925925925926
20637,330455705290151,63,80,109,101,103,79,55,66,535,121,656,18.445121951219512
20638,330455705290152,50,90,93,77,115,107,121,108,532,229,761,30.09198423127464
20639,330455705290153,72,85,114,105,111,123,178,139,610,317,927,34.19633225458468
20640,330455705290154,11,16,43,46,29,41,42,32,186,74,260,28.46153846153846
20641,330455705290155,20,24,39,50,28,48,32,36,209,68,277,24.548736462093864
20642,330455705290156,15,21,47,72,45,37,27,24,237,51,288,17.708333333333332
20643,330455705290157,11,9,21,36,31,30,25,24,138,49,187,26.203208556149733
20644,330455705290158,6,24,36,47,34,36,33,25,183,58,241,24.066390041493776
20645,330455705290159,30,60,76,51,64,97,78,73,378,151,529,28.544423440453688
20646,330455705290160,11,17,19,18,15,28,32,20,108,52,160,32.5
20647,330455705290161,29,40,51,65,45,77,77,34,307,111,418,26.555023923444978
20648,330455705290162,63,66,90,92,89,107,118,68,507,186,693,26.83982683982684
20649,330455705290163,33,48,61,74,68,55,53,59,339,112,451,24.83370288248337
20650,330455705290164,47,74,106,100,88,102,72,64,517,136,653,20.82695252679939
20651,330455705290165,86,99,83,107,105,88,75,35,568,110,678,16.224188790560472
20652,330455705290166,86,154,157,113,162,194,115,105,866,220,1086,20.257826887661142
20653,330455705290167,51,54,77,78,76,83,97,76,419,173,592,29.222972972972972
20654,330455705290168,68,106,107,88,125,133,73,76,627,149,776,19.201030927835053
20655,330455705290169,59,105,135,101,102,128,75,61,630,136,766,17.754569190600524
20656,330455705290170,53,58,104,116,83,100,77,91,514,168,682,24.633431085043988
20657,330455705290171,25,40,56,55,46,67,38,44,289,82,371,22.10242587601078
20658,330455705290172,116,115,121,137,206,119,88,54,814,142,956,14.853556485355648
20659,330455705290173,52,77,99,65,74,114,67,55,481,122,603,20.23217247097844
20660,330455705290174,153,103,112,229,151,88,55,17,836,72,908,7.929515418502203
20661,330455705290175,57,51,91,153,79,52,37,27,483,64,547,11.70018281535649
20662,330455705290176,60,63,76,106,83,74,40,38,462,78,540,14.444444444444445
20663,330455705290177,71,49,46,118,81,58,37,15,423,52,475,10.947368421052632
20664,330455705290178,78,51,54,119,84,63,32,29,449,61,510,11.96078431372549
20665,330455705290179,36,56,76,124,84,73,39,24,449,63,512,12.3046875
20666,330455705290180,55,43,55,112,76,55,36,36,396,72,468,15.384615384615385
20667,330455705290181,53,55,54,118,93,41,40,39,414,79,493,16.024340770791074
20668,330455705290182,63,48,88,93,99,71,40,31,462,71,533,13.320825515947467
20669,330455705290183,112,101,112,128,128,133,52,48,714,100,814,12.285012285012286
20670,330455705290184,76,78,103,155,96,80,44,33,588,77,665,11.578947368421053
20671,330455705290185,47,25,77,120,63,47,42,13,379,55,434,12.672811059907835
20672,330455705290186,76,71,92,117,136,69,36,16,561,52,613,8.482871125611746
20673,330455705290187,32,13,43,64,41,25,16,12,218,28,246,11.382113821138212
20674,330455705290188,235,243,225,199,161,100,58,31,1163,89,1252,7.108626198083067
20675,330455705290189,267,253,291,338,293,271,143,81,1713,224,1937,11.564274651522974
20676,330455705290190,108,151,221,139,201,202,104,78,1022,182,1204,15.116279069767442
20677,330455705290191,80,134,205,110,140,195,119,72,864,191,1055,18.104265402843602
20678,330455705290192,94,160,131,82,149,155,74,72,771,146,917,15.921483097055615
20679,330455705290193,50,84,122,55,110,140,59,59,561,118,679,17.378497790868924
20680,330455705290194,33,84,86,57,94,116,107,75,470,182,652,27.914110429447852
20681,330455705290195,60,70,86,92,102,115,115,92,525,207,732,28.278688524590162
20682,330455705290196,65,80,97,101,124,116,114,114,583,228,811,28.1134401972873
20683,330455705290197,91,101,135,141,143,136,144,146,747,290,1037,27.965284474445514
20684,330455705290198,53,61,132,123,98,69,40,27,536,67,603,11.11111111111111
20685,330455705290199,89,179,113,128,158,157,69,43,824,112,936,11.965811965811966
20686,330455705290200,11,34,45,16,42,38,24,22,186,46,232,19.82758620689655
20687,330455705290201,209,234,238,246,277,256,144,104,1460,248,1708,14.519906323185012
20688,330455705290202,85,101,88,116,148,111,75,46,649,121,770,15.714285714285714
20689,330455705290203,18,38,61,40,56,65,47,35,278,82,360,22.77777777777778
20690,330455705290204,23,29,72,61,59,57,39,34,301,73,374,19.518716577540108
20691,330455705290205,28,34,62,70,48,54,52,50,296,102,398,25.628140703517587
20692,330455705290206,34,43,56,62,55,63,41,54,313,95,408,23.284313725490197
20693,330455705290207,24,36,68,62,60,64,53,43,314,96,410,23.414634146341463
20694,330455705290208,24,44,55,52,56,59,34,38,290,72,362,19.88950276243094
20695,330455705290209,24,31,79,40,42,64,49,43,280,92,372,24.731182795698924
20696,330455705290210,21,42,62,56,46,73,44,40,300,84,384,21.875
20697,330455705290211,33,34,51,74,43,48,42,28,283,70,353,19.8300283286119
20698,330455705290212,22,37,69,71,71,71,42,42,341,84,425,19.764705882352942
20699,330455705290213,32,33,64,57,70,55,50,45,311,95,406,23.399014778325125
20700,330455705290214,21,35,55,60,61,73,37,40,305,77,382,20.157068062827225
20701,330455705290215,30,53,72,93,61,84,57,51,393,108,501,21.55688622754491
20702,330455705290216,38,35,75,87,47,74,48,45,356,93,449,20.71269487750557
20703,330455705290217,34,42,68,67,52,55,46,39,318,85,403,21.09181141439206
20704,330455705290218,30,27,54,65,52,41,29,21,269,50,319,15.67398119122257
20705,330455705290219,79,60,100,169,102,81,63,19,591,82,673,12.184249628528974
20706,330455705290220,94,68,104,161,113,100,53,32,640,85,725,11.724137931034482
20707,330455705290221,82,76,120,151,124,89,57,48,642,105,747,14.056224899598394
20708,330455705290222,45,38,80,129,73,59,39,32,424,71,495,14.343434343434344
20709,330455705290223,41,29,36,97,50,22,20,6,275,26,301,8.637873754152825
20710,330455705290224,277,270,407,325,166,73,25,9,1518,34,1552,2.1907216494845363
20711,330455705290225,122,109,237,120,60,22,10,7,670,17,687,2.4745269286754
20712,330455705290226,84,124,153,119,90,47,29,6,617,35,652,5.368098159509202
20713,330455705290227,112,170,197,130,187,192,94,51,988,145,1133,12.797881729920565
20714,330455705290228,104,108,211,125,75,52,9,5,675,14,689,2.0319303338171264
20715,330455705290229,53,62,90,107,93,64,42,37,469,79,548,14.416058394160585
20716,330455705290230,75,62,105,131,79,99,78,46,551,124,675,18.37037037037037
20717,330455705290231,78,68,100,143,114,86,65,49,589,114,703,16.216216216216218
20718,330455705290232,56,40,94,103,60,59,35,16,412,51,463,11.01511879049676
20719,330455705290233,80,88,156,113,105,103,62,24,645,86,731,11.764705882352942
20720,330455705290234,31,30,55,66,32,67,29,21,281,50,331,15.105740181268882
20721,330455705290235,91,85,101,113,107,83,74,34,580,108,688,15.69767441860465
20722,330455705290236,108,123,156,203,169,142,99,64,901,163,1064,15.319548872180452
20723,330455705290237,19,25,49,30,40,34,29,25,197,54,251,21.51394422310757
20724,330455705290238,109,71,135,148,131,94,55,50,688,105,793,13.240857503152585
20725,330455705290239,30,23,54,57,40,50,44,20,254,64,318,20.12578616352201
20726,330455705290240,22,33,17,29,23,19,19,17,143,36,179,20.11173184357542
20727,330455705290241,49,67,60,86,87,89,43,33,438,76,514,14.785992217898833
20728,330455705290242,56,56,68,81,77,81,44,24,419,68,487,13.963039014373717
20729,330455705290243,36,42,62,56,43,67,33,26,306,59,365,16.164383561643834
20730,330455705290244,61,50,75,114,79,73,55,38,452,93,545,17.06422018348624
20731,330455705290245,39,46,54,74,53,61,37,21,327,58,385,15.064935064935066
20732,330455705290246,45,65,62,102,72,71,54,53,417,107,524,20.419847328244273
20733,330455705290247,41,34,73,78,73,54,27,27,353,54,407,13.267813267813267
20734,330455705290248,72,71,100,113,113,88,57,43,557,100,657,15.220700152207002
20735,330455705290249,100,75,133,193,141,119,105,74,761,179,940,19.04255319148936
20736,330455705290250,52,69,81,98,86,77,59,40,463,99,562,17.615658362989326
20737,330455705290251,85,98,106,121,121,128,97,50,659,147,806,18.23821339950372
20738,330455705290252,21,24,46,37,37,42,26,18,207,44,251,17.529880478087648
20739,330455705290253,94,85,128,169,113,147,56,39,736,95,831,11.432009626955475
20740,330455705290254,50,61,85,93,76,59,61,48,424,109,533,20.45028142589118
20741,330455705290255,54,61,123,72,63,38,4,5,411,9,420,2.142857142857143
20742,330455705290256,29,34,58,59,38,47,45,24,265,69,334,20.65868263473054
20743,330455705290257,167,213,267,317,269,288,164,94,1521,258,1779,14.502529510961214
20744,330455705290258,125,152,197,243,200,197,139,55,1114,194,1308,14.831804281345565
20745,330455705290259,186,176,263,329,251,243,147,94,1448,241,1689,14.268798105387804
20746,330455705290260,65,88,119,109,117,110,53,35,608,88,696,12.64367816091954
20747,330455705290261,102,108,105,141,125,79,42,29,660,71,731,9.712722298221614
20748,330455705290262,91,99,100,133,116,83,54,48,622,102,724,14.088397790055248
20749,330455705290263,18,34,24,26,21,12,5,1,135,6,141,4.25531914893617
20750,330455705290264,317,395,350,421,412,256,129,104,2151,233,2384,9.773489932885907
20751,330455705290265,86,102,112,109,107,55,33,21,571,54,625,8.64
20752,330455705290266,41,62,49,50,42,23,13,4,267,17,284,5.985915492957746
20753,330455705290267,97,105,62,157,103,73,24,17,597,41,638,6.4263322884012535
20754,330455705290268,330,425,539,407,271,202,92,41,2174,133,2307,5.76506285218899
20755,330455705290269,19,14,32,35,17,26,18,20,143,38,181,20.994475138121548
20756,330455705290270,69,74,135,221,135,73,58,78,707,136,843,16.132858837485173
20757,330455705290271,107,110,136,172,153,106,68,65,784,133,917,14.50381679389313
20758,330455705290272,167,169,220,289,244,176,104,63,1265,167,1432,11.662011173184357
20759,330455705290273,175,178,235,293,270,242,133,103,1393,236,1629,14.487415592387968
20760,330455705290274,177,191,220,315,266,221,116,67,1390,183,1573,11.633820724729816
20761,330455705290275,133,157,199,216,231,178,110,74,1114,184,1298,14.175654853620955
20762,330455705290276,178,196,239,240,222,191,119,72,1266,191,1457,13.109128345916266
20763,330455705290277,130,144,220,177,106,76,32,17,853,49,902,5.4323725055432375
20764,330455705290278,238,276,364,234,196,86,34,9,1394,43,1437,2.9923451635351426
20765,330455705290279,201,361,354,381,310,183,127,75,1790,202,1992,10.140562248995984
20766,330455705290280,49,45,60,74,62,37,24,24,327,48,375,12.8
20767,330455705290281,83,85,112,168,116,115,52,34,679,86,765,11.241830065359476
20768,330455705290282,56,138,136,99,160,149,80,57,738,137,875,15.657142857142857
20769,330455705290283,145,161,186,200,191,164,98,64,1047,162,1209,13.399503722084367
20770,330455705290284,74,76,97,76,62,49,25,8,434,33,467,7.0663811563169165
20771,330455705290285,36,43,56,47,53,44,21,16,279,37,316,11.708860759493671
20772,330455705290286,32,37,28,31,21,9,5,4,158,9,167,5.389221556886228
20773,330455705290287,188,221,178,205,190,119,58,49,1101,107,1208,8.857615894039736
20774,330455705290288,115,117,146,106,77,47,19,5,608,24,632,3.7974683544303796
20775,330455705290289,87,126,115,96,101,49,24,16,574,40,614,6.514657980456026
20776,330455705290290,61,91,66,76,71,63,33,17,428,50,478,10.460251046025105
20777,330455705290291,84,86,109,107,134,98,67,49,618,116,734,15.803814713896458
20778,330455705290292,120,162,179,145,169,160,78,72,935,150,1085,13.824884792626728
20779,330455705290293,96,152,131,131,183,112,56,42,805,98,903,10.852713178294573
20780,330455705290294,62,90,103,84,103,84,59,46,526,105,631,16.64025356576862
20781,330455705290295,140,179,216,204,159,144,81,65,1042,146,1188,12.289562289562289
20782,330455705290296,69,94,68,111,80,59,30,21,481,51,532,9.586466165413533
20783,330455705290297,77,65,63,82,35,23,14,2,345,16,361,4.43213296398892
20784,330455705290298,232,236,249,183,152,102,49,30,1154,79,1233,6.407137064071371
20785,330455705290299,31,60,67,88,46,57,27,27,349,54,403,13.399503722084367
20786,330455705290300,84,113,113,123,120,92,50,36,645,86,731,11.764705882352942
20787,330455705290301,189,200,188,173,104,70,23,3,924,26,950,2.736842105263158
20788,330455705290302,101,115,105,110,102,74,43,34,607,77,684,11.257309941520468
20789,330455705290303,79,163,112,130,85,56,20,14,625,34,659,5.159332321699544
20790,330455705290304,79,90,76,97,107,71,38,35,520,73,593,12.310286677908937
20791,330455705290305,69,80,106,121,120,80,58,47,576,105,681,15.418502202643172
20792,330455705290306,83,85,92,113,102,96,55,27,571,82,653,12.557427258805513
20793,330455705290307,111,155,158,173,182,153,79,45,932,124,1056,11.742424242424242
20794,330455705290308,197,220,196,199,121,63,29,21,996,50,1046,4.780114722753346
20795,330455705290309,277,328,212,194,163,84,29,11,1258,40,1298,3.0816640986132513
20796,330455705290310,185,225,183,172,125,59,29,13,949,42,991,4.238143289606458
20797,330455705290311,126,120,117,81,60,48,17,6,552,23,575,4.0
20798,330455705290312,195,242,150,143,104,47,29,27,881,56,937,5.976520811099253
20799,330455705290313,114,113,183,226,128,101,30,18,865,48,913,5.257393209200438
20800,330455705290314,47,68,59,57,42,48,13,18,321,31,352,8.806818181818182
20801,330455705290315,73,83,90,76,73,33,38,18,428,56,484,11.570247933884298
20802,330455705290316,44,33,53,44,29,28,10,2,231,12,243,4.938271604938271
20803,330455705290317,117,133,127,164,124,65,23,10,730,33,763,4.325032765399738
20804,330455705290318,45,90,79,63,117,51,42,20,445,62,507,12.22879684418146
20805,330455705290319,55,33,67,89,55,70,35,30,369,65,434,14.976958525345623
20806,330455705290320,84,69,114,100,95,70,41,18,532,59,591,9.983079526226735
20807,330455705290321,71,61,64,122,91,58,47,20,467,67,534,12.546816479400748
20808,330455705290322,69,90,91,89,95,75,47,35,509,82,591,13.874788494077833
20809,330455705290323,73,79,82,120,94,58,57,36,506,93,599,15.525876460767947
20810,330455705290324,21,39,43,45,53,37,19,15,238,34,272,12.5
20811,330455705290325,41,45,59,72,68,78,46,37,363,83,446,18.609865470852018
20812,330455705290326,126,106,127,156,179,133,84,44,827,128,955,13.403141361256544
20813,330455705290327,65,56,86,114,86,83,63,29,490,92,582,15.807560137457045
20814,330455705290328,21,37,63,70,64,66,52,22,321,74,395,18.734177215189874
20815,330455705290329,31,41,57,61,48,69,31,18,307,49,356,13.764044943820224
20816,330455705290330,27,23,38,45,46,41,26,17,220,43,263,16.34980988593156
20817,330455705290331,31,40,47,71,54,54,43,17,297,60,357,16.80672268907563
20818,330455705290332,84,82,96,120,78,73,37,27,533,64,597,10.720268006700168
20819,330455705290333,62,46,70,115,74,85,33,32,452,65,517,12.572533849129593
20820,330455705290334,48,43,60,85,59,64,38,26,359,64,423,15.130023640661939
20821,330455705290335,59,72,113,122,110,87,54,37,563,91,654,13.914373088685016
20822,330455705290336,62,56,83,82,100,91,57,16,474,73,547,13.345521023765997
20823,330455705290337,49,57,75,97,85,70,51,32,433,83,516,16.085271317829456
20824,330455705290338,34,21,41,58,35,37,38,21,226,59,285,20.70175438596491
20825,330455705290339,23,27,33,34,23,28,19,23,168,42,210,20.0
20826,330455705290340,13,25,24,24,31,26,11,14,143,25,168,14.880952380952381
20827,330455705290341,34,44,61,69,55,42,38,33,305,71,376,18.882978723404257
20828,330455705290342,35,48,67,70,73,83,78,50,376,128,504,25.396825396825395
20829,330455705290343,121,110,83,162,150,94,51,35,720,86,806,10.66997518610422
20830,330455705290344,22,18,57,108,31,25,11,10,261,21,282,7.446808510638298
20831,330455705290345,89,65,96,162,93,81,52,44,586,96,682,14.07624633431085
20832,330455705290346,87,77,110,163,115,91,55,44,643,99,742,13.342318059299192
20833,330455705290347,126,74,156,178,97,72,36,19,703,55,758,7.255936675461742
20834,330455705290348,70,75,80,79,97,65,31,18,466,49,515,9.514563106796116
20835,330455705290349,63,50,66,104,92,58,46,23,433,69,502,13.745019920318725
20836,330455705290350,0,1,2,5,3,1,1,1,12,2,14,14.285714285714286
20837,330455705290351,129,148,284,231,166,128,62,40,1086,102,1188,8.585858585858587
20838,330455705290352,94,107,87,145,114,62,24,26,609,50,659,7.587253414264036
20839,330455705290353,24,27,10,35,29,20,7,7,145,14,159,8.80503144654088
20840,330455705290354,106,73,70,115,114,91,41,12,569,53,622,8.520900321543408
20841,330455705290355,204,154,136,247,223,153,107,58,1117,165,1282,12.870514820592824
20842,330455705290356,160,163,188,210,189,150,84,75,1060,159,1219,13.043478260869565
20843,330455705290357,60,49,90,142,50,50,33,22,441,55,496,11.088709677419354
20844,330455705290358,181,151,72,190,159,84,42,28,837,70,907,7.717750826901875
20845,330455705290359,120,72,138,257,109,70,54,24,766,78,844,9.24170616113744
20846,330455705290360,148,71,89,214,113,74,38,22,709,60,769,7.802340702210663
20847,330455705290361,114,63,108,192,110,81,56,43,668,99,767,12.907431551499348
20848,330455705290362,117,83,68,114,120,73,22,16,575,38,613,6.199021207177814
20849,330455705290363,23,13,52,71,28,32,11,7,219,18,237,7.594936708860759
20850,330455705290364,107,138,117,145,159,121,65,54,787,119,906,13.13465783664459
20851,330455705290365,67,57,67,113,84,42,26,8,430,34,464,7.327586206896552
20852,330455705290366,17,19,8,21,25,12,7,4,102,11,113,9.734513274336283
20853,330455705290367,73,54,74,90,95,62,32,21,448,53,501,10.578842315369261
20854,330455705290368,103,63,95,209,106,76,49,19,652,68,720,9.444444444444445
20855,330455705290370,10,8,4,8,7,4,1,1,41,2,43,4.651162790697675
20856,330455705290371,52,59,59,69,64,62,33,30,365,63,428,14.719626168224298
20857,330455705290372,82,154,134,101,153,150,80,70,774,150,924,16.233766233766232
20858,330455705290373,108,94,87,101,127,72,24,13,589,37,626,5.9105431309904155
20859,330455705290374,106,86,105,111,128,124,73,34,660,107,767,13.95045632333768
20860,330455705290375,22,20,38,60,25,16,10,7,181,17,198,8.585858585858587
20861,330455705290378,83,62,84,186,96,67,45,16,578,61,639,9.546165884194053
20862,330455705290379,112,100,113,135,119,120,59,40,699,99,798,12.406015037593985
20863,330455705290380,17,18,40,43,20,35,32,23,173,55,228,24.12280701754386
20864,330455705290381,5,8,5,6,5,4,0,2,33,2,35,5.714285714285714
20865,330455705290382,87,64,174,129,75,70,30,41,599,71,670,10.597014925373134
20866,330455705290383,4,6,4,10,6,3,2,1,33,3,36,8.333333333333334
20867,330455705290384,59,49,58,58,21,19,6,4,264,10,274,3.6496350364963503
20868,330455705290385,94,100,87,92,62,26,10,5,461,15,476,3.1512605042016806
20869,330455705290386,19,16,17,11,10,14,0,0,87,0,87,0.0
20870,330455705290387,29,18,29,24,16,7,3,4,123,7,130,5.384615384615385
20871,330455705290388,57,55,48,41,28,21,8,2,250,10,260,3.8461538461538463
20872,330455705290389,7,4,9,2,4,4,1,2,30,3,33,9.090909090909092
20873,330455705290390,194,256,239,188,148,90,36,10,1115,46,1161,3.962101636520241
20874,330455705290391,9,14,15,16,11,11,4,3,76,7,83,8.433734939759036
20875,330455705290392,123,155,184,145,95,90,32,15,792,47,839,5.601907032181168
20876,330455705290393,22,28,20,18,17,7,3,3,112,6,118,5.084745762711864
20877,330455705290394,197,235,260,215,149,94,45,29,1150,74,1224,6.045751633986928
20878,330455705290395,10,17,10,15,10,7,1,5,69,6,75,8.0
20879,330455705290396,16,32,23,25,40,23,12,9,159,21,180,11.666666666666666
20880,330455705290397,7,13,7,7,8,3,3,1,45,4,49,8.16326530612245
20881,330455705290398,12,20,13,27,21,14,14,3,107,17,124,13.709677419354838
20882,330455705290399,25,20,33,23,15,18,5,2,134,7,141,4.964539007092198
20883,330455705290400,10,3,15,3,8,3,1,0,42,1,43,2.3255813953488373
20884,330455705290401,23,23,31,16,16,7,3,0,116,3,119,2.5210084033613445
20885,330455705290402,80,91,104,84,55,38,10,12,452,22,474,4.641350210970464
20886,330455705290404,9,16,13,19,13,9,13,8,79,21,100,21.0
20887,330455705290405,38,33,63,57,20,7,1,2,218,3,221,1.3574660633484164
20888,330455705290407,46,37,45,32,18,15,5,0,193,5,198,2.525252525252525
20889,330455705290408,19,15,17,31,23,16,11,6,121,17,138,12.318840579710145
20891,330455705290410,28,51,42,37,28,20,12,2,206,14,220,6.363636363636363
20892,330455705290411,385,396,563,520,296,130,59,21,2290,80,2370,3.3755274261603376
20893,330455705290412,210,175,395,294,153,98,30,13,1325,43,1368,3.1432748538011697
20894,330455705290413,2,2,4,3,3,4,1,1,18,2,20,10.0
20895,330455705290414,196,179,183,159,78,28,9,3,823,12,835,1.437125748502994
20896,330455705290415,252,207,299,248,149,49,12,3,1204,15,1219,1.2305168170631666
20897,330455705290416,93,117,164,143,63,30,13,4,610,17,627,2.7113237639553427
20898,330455705290417,163,195,225,161,148,62,36,15,954,51,1005,5.074626865671642
20899,330455705290418,88,137,188,178,122,81,46,29,794,75,869,8.63060989643268
20900,330455705290419,176,197,234,210,150,87,41,17,1054,58,1112,5.215827338129497
20901,330455705290420,193,173,257,280,131,50,28,12,1084,40,1124,3.5587188612099645
20902,330455705290421,36,41,47,52,53,57,29,31,286,60,346,17.341040462427745
20903,330455705290422,156,146,342,211,115,53,20,8,1023,28,1051,2.664129400570885
20904,330455705290423,158,202,291,260,180,146,82,41,1237,123,1360,9.044117647058824
20905,330455705290424,158,219,187,182,145,76,44,19,967,63,1030,6.116504854368932
20906,330455705290426,102,113,146,124,95,64,21,5,644,26,670,3.8805970149253732
20907,330455705290427,3,3,10,2,4,3,4,0,25,4,29,13.793103448275861
20909,330455705290449,83,48,78,126,67,41,22,16,443,38,481,7.9002079002079
20910,330455705290450,86,101,108,140,115,76,44,38,626,82,708,11.581920903954803
20911,330455705290452,49,44,79,51,69,55,27,20,347,47,394,11.928934010152284
20912,330455705290453,77,63,55,122,67,56,22,16,440,38,478,7.949790794979079
20913,330455705290454,222,174,271,218,181,81,27,23,1147,50,1197,4.177109440267335
20914,330455705290455,121,145,195,186,120,60,28,9,827,37,864,4.282407407407407
20915,330455705290456,90,96,159,96,38,13,8,1,492,9,501,1.7964071856287425
20916,330455705290457,81,80,159,94,65,40,15,8,519,23,542,4.243542435424354
20917,330455705290458,166,176,272,175,123,75,18,9,987,27,1014,2.662721893491124
20918,330455705290459,23,18,29,30,20,10,8,1,130,9,139,6.474820143884892
20919,330455705290460,74,96,131,71,61,68,22,6,501,28,529,5.293005671077505
20920,330455705290461,28,34,45,38,35,21,12,6,201,18,219,8.219178082191782
20921,330455705290462,73,69,106,97,97,64,35,18,506,53,559,9.481216457960643
20922,330455705290463,38,57,82,64,53,43,26,10,337,36,373,9.651474530831099
20923,330455705290464,18,27,45,26,19,25,13,4,160,17,177,9.6045197740113
20924,330455705290465,95,102,83,119,102,56,23,21,557,44,601,7.321131447587354
20925,330455705290466,56,88,109,109,77,56,36,10,495,46,541,8.502772643253234
20926,330455705290467,49,28,53,98,58,42,14,18,328,32,360,8.88888888888889
20927,330455705290468,23,19,27,59,33,25,16,8,186,24,210,11.428571428571429
20928,330455705290469,117,111,149,218,148,93,71,33,836,104,940,11.063829787234043
20929,330455705290470,63,61,45,70,68,39,27,19,346,46,392,11.73469387755102
20930,330455705290471,55,89,77,125,109,66,56,34,521,90,611,14.729950900163667
20931,330455705290472,51,54,73,60,28,30,12,9,296,21,317,6.624605678233438
20932,330455705290473,77,85,68,106,83,53,46,18,472,64,536,11.940298507462687
20933,330455705290474,72,115,97,107,100,67,42,29,558,71,629,11.287758346581876
20934,330455705290475,60,94,113,96,105,84,33,33,552,66,618,10.679611650485437
20935,330455705290476,39,36,45,55,38,43,26,11,256,37,293,12.627986348122867
20936,330455705290477,33,52,45,60,37,43,23,18,270,41,311,13.183279742765274
20937,330455705290478,140,126,142,152,88,34,18,2,682,20,702,2.849002849002849
20938,330455705290479,154,185,142,162,109,46,17,2,798,19,817,2.3255813953488373
20939,330455705290480,71,78,72,70,53,21,8,3,365,11,376,2.925531914893617
20940,330455705290481,148,149,125,140,101,37,20,16,700,36,736,4.891304347826087
20941,330455705290482,168,184,159,167,109,42,18,14,829,32,861,3.7166085946573753
20942,330455705290483,76,88,92,87,61,19,13,4,423,17,440,3.8636363636363638
20943,330455705290484,157,132,206,177,105,62,26,20,839,46,885,5.19774011299435
20944,330455705290485,122,94,117,103,55,26,2,4,517,6,523,1.147227533460803
20945,330455705290486,35,24,77,119,34,43,29,14,332,43,375,11.466666666666667
20946,330455705290487,11,17,22,30,41,62,34,32,183,66,249,26.50602409638554
20947,330455705290489,128,144,156,269,184,177,106,68,1058,174,1232,14.123376623376624
20948,330455705290490,101,130,164,218,214,92,43,28,919,71,990,7.171717171717172
20949,330455705290491,71,65,79,99,94,83,31,25,491,56,547,10.23765996343693
20950,330455705290492,23,26,53,53,47,46,31,23,248,54,302,17.880794701986755
20951,330455705290493,28,31,55,59,42,58,23,21,273,44,317,13.8801261829653
20952,330455705290494,125,156,259,154,81,41,16,2,816,18,834,2.158273381294964
20953,330455705290503,119,136,180,182,98,80,30,17,795,47,842,5.581947743467934
20954,330455705290504,263,272,292,319,147,80,39,13,1373,52,1425,3.6491228070175437
20955,330455705300001,37,63,87,103,75,81,63,61,446,124,570,21.75438596491228
20956,330455705300002,55,94,71,118,91,58,81,30,487,111,598,18.561872909698998
20957,330455705300003,117,143,136,130,150,136,85,78,812,163,975,16.71794871794872
20958,330455705300004,58,79,84,99,84,73,42,72,477,114,591,19.289340101522843
20959,330455705300005,90,97,110,120,106,79,84,88,602,172,774,22.22222222222222
20960,330455705300006,60,92,75,91,64,60,62,39,442,101,543,18.60036832412523
20961,330455705300007,108,112,117,139,127,92,80,76,695,156,851,18.331374853113985
20962,330455705300008,102,138,123,139,148,95,78,75,745,153,898,17.037861915367483
20963,330455705300009,99,129,120,134,127,98,76,47,707,123,830,14.819277108433734
20964,330455705300010,90,115,130,127,96,102,85,56,660,141,801,17.60299625468165
20965,330455705300011,89,96,111,122,96,100,73,47,614,120,734,16.348773841961854
20966,330455705300012,92,118,119,118,100,124,66,57,671,123,794,15.4911838790932
20967,330455705300013,36,39,32,45,42,37,38,20,231,58,289,20.069204152249135
20968,330455705300014,102,101,161,132,111,123,88,71,730,159,889,17.885264341957257
20969,330455705300015,64,75,83,84,75,52,63,46,433,109,542,20.11070110701107
20970,330455705300016,46,59,62,71,53,82,42,50,373,92,465,19.78494623655914
20971,330455705300017,63,67,103,81,78,79,79,66,471,145,616,23.538961038961038
20972,330455705300018,29,61,45,47,50,60,50,31,292,81,373,21.715817694369974
20973,330455705300019,102,116,93,95,65,53,30,17,524,47,571,8.231173380035026
20974,330455705300020,38,80,72,78,80,73,60,49,421,109,530,20.566037735849058
20975,330455705300021,119,160,163,140,140,138,59,59,860,118,978,12.065439672801636
20976,330455705300022,87,103,87,136,102,66,46,56,581,102,683,14.93411420204978
20977,330455705300023,123,141,163,166,169,148,89,85,910,174,1084,16.051660516605168
20978,330455705300024,42,66,83,77,70,65,58,72,403,130,533,24.390243902439025
20979,330455705300025,45,66,82,55,51,64,28,27,363,55,418,13.157894736842104
20980,330455705300026,83,122,96,126,103,79,64,46,609,110,719,15.299026425591098
20981,330455705300027,79,112,102,86,117,92,56,40,588,96,684,14.035087719298245
20982,330455705300028,98,126,120,104,114,86,44,46,648,90,738,12.195121951219512
20983,330455705300029,63,78,78,70,67,53,25,26,409,51,460,11.08695652173913
20984,330455705300030,65,105,75,70,70,38,19,26,423,45,468,9.615384615384615
20985,330455705300031,70,117,99,84,76,57,25,32,503,57,560,10.178571428571429
20986,330455705300032,58,67,59,59,43,54,25,14,340,39,379,10.29023746701847
20987,330455705300033,27,55,45,40,41,24,19,12,232,31,263,11.787072243346008
20988,330455705300034,47,65,59,88,74,61,39,31,394,70,464,15.086206896551724
20989,330455705300035,25,37,28,31,31,13,10,14,165,24,189,12.698412698412698
20990,330455705300036,18,18,21,15,16,23,5,8,111,13,124,10.483870967741936
20991,330455705300037,17,40,25,27,35,27,12,18,171,30,201,14.925373134328359
20992,330455705300038,22,34,32,35,27,32,13,12,182,25,207,12.077294685990339
20993,330455705300039,32,43,41,30,27,33,20,13,206,33,239,13.807531380753138
20994,330455705300040,60,92,67,89,89,59,50,49,456,99,555,17.83783783783784
20995,330455705300041,99,120,120,111,108,110,60,45,668,105,773,13.583441138421733
20996,330455705300042,134,102,157,149,119,128,83,43,789,126,915,13.770491803278688
20997,330455705300043,108,127,136,139,104,113,52,38,727,90,817,11.015911872705018
20998,330455705300044,124,129,145,157,141,114,77,49,810,126,936,13.461538461538462
20999,330455705300045,123,163,145,171,144,116,92,65,862,157,1019,15.407262021589794
21000,330455705300046,125,135,132,107,107,75,39,22,681,61,742,8.221024258760108
21001,330455705300047,53,80,71,87,100,78,52,68,469,120,589,20.37351443123939
21002,330455705300048,83,88,103,81,78,77,42,53,510,95,605,15.702479338842975
21003,330455705300049,122,171,126,156,135,116,68,59,826,127,953,13.326337880377755
21004,330455705300050,154,140,137,137,117,112,52,46,797,98,895,10.949720670391061
21005,330455705300051,85,148,104,152,124,73,93,69,686,162,848,19.10377358490566
21006,330455705300052,121,147,111,121,98,84,35,40,682,75,757,9.907529722589167
21007,330455705300053,98,116,115,95,97,85,61,30,606,91,697,13.055954088952655
21008,330455705300054,188,160,248,177,114,58,26,19,945,45,990,4.545454545454546
21009,330455705300056,59,59,47,35,29,20,5,0,249,5,254,1.968503937007874
21010,330455705300057,160,157,151,134,77,68,40,20,747,60,807,7.434944237918216
21011,330455705300058,110,99,107,90,62,45,21,17,513,38,551,6.896551724137931
21012,330455705300059,127,114,139,155,109,104,66,52,748,118,866,13.625866050808314
21013,330455705300060,142,174,159,111,94,107,46,45,787,91,878,10.364464692482915
21014,330455705300061,62,65,74,60,44,41,19,9,346,28,374,7.4866310160427805
21015,330455705300062,223,209,228,210,113,78,36,18,1061,54,1115,4.84304932735426
21016,330455705300063,197,226,209,175,106,54,35,14,967,49,1016,4.822834645669292
21017,330455705300064,419,409,461,402,193,124,51,25,2008,76,2084,3.6468330134357005
21018,330455705300065,64,75,87,64,58,36,23,9,384,32,416,7.6923076923076925
21019,330455705300066,210,263,334,221,126,92,42,26,1246,68,1314,5.175038051750381
21020,330455705300067,168,166,200,211,133,91,66,47,969,113,1082,10.44362292051756
21021,330455705300068,113,164,93,81,54,48,22,10,553,32,585,5.47008547008547
21022,330455705300069,172,222,189,111,95,62,25,25,851,50,901,5.549389567147614
21023,330455705300070,157,141,160,100,103,52,30,17,713,47,760,6.184210526315789
21024,330455705300071,98,108,91,78,52,40,22,10,467,32,499,6.412825651302605
21026,330455705300073,100,134,109,91,82,50,40,22,566,62,628,9.872611464968152
21027,330455705300074,98,102,107,103,69,49,20,13,528,33,561,5.882352941176471
21028,330455705300075,284,316,266,236,184,147,76,30,1433,106,1539,6.887589343729695
21029,330455705300076,146,148,140,122,88,71,51,26,715,77,792,9.722222222222221
21030,330455705300077,19,31,23,11,30,13,9,7,127,16,143,11.188811188811188
21031,330455705300078,129,169,146,115,100,96,38,43,755,81,836,9.688995215311005
21032,330455705300079,166,163,132,128,141,61,38,27,791,65,856,7.593457943925234
21033,330455705300080,170,182,148,130,134,60,41,37,824,78,902,8.647450110864744
21034,330455705300081,116,132,127,113,88,65,48,31,641,79,720,10.972222222222221
21035,330455705300082,120,87,127,86,50,47,22,14,517,36,553,6.509945750452079
21036,330455705300083,71,72,83,46,75,37,23,27,384,50,434,11.52073732718894
21037,330455705300084,36,69,85,58,73,43,33,26,364,59,423,13.947990543735225
21038,330455705300085,38,66,59,62,55,45,29,19,325,48,373,12.868632707774799
21039,330455705300086,50,53,44,52,26,39,24,8,264,32,296,10.81081081081081
21040,330455705300087,96,126,140,138,92,77,65,47,669,112,781,14.340588988476313
21041,330455705300088,77,69,92,91,62,52,45,26,443,71,514,13.813229571984436
21042,330455705300089,51,95,59,58,93,46,21,31,402,52,454,11.45374449339207
21043,330455705300090,52,80,64,69,67,39,22,25,371,47,418,11.24401913875598
21044,330455705300091,57,80,74,106,61,57,9,10,435,19,454,4.185022026431718
21045,330455705300092,66,59,39,70,62,35,16,6,331,22,353,6.232294617563739
21046,330455705300093,80,95,67,89,74,72,36,25,477,61,538,11.338289962825279
21047,330455705300094,170,205,139,137,100,88,34,27,839,61,900,6.777777777777778
21048,330455705300095,33,52,51,38,47,48,17,8,269,25,294,8.503401360544217
21049,330455705300096,51,43,38,96,48,39,17,29,315,46,361,12.742382271468143
21050,330455705300097,13,29,27,20,26,35,18,10,150,28,178,15.730337078651685
21051,330455705300098,43,56,40,35,56,53,18,21,283,39,322,12.111801242236025
21052,330455705300099,42,50,65,40,51,46,27,8,294,35,329,10.638297872340425
21053,330455705300100,36,45,51,33,29,43,23,16,237,39,276,14.130434782608695
21054,330455705300101,60,79,59,55,65,45,41,39,363,80,443,18.058690744920995
21055,330455705300102,16,14,34,17,22,22,29,12,125,41,166,24.698795180722893
21056,330455705300103,52,62,90,72,67,91,63,63,434,126,560,22.5
21057,330455705300104,78,85,112,77,99,62,39,34,513,73,586,12.457337883959044
21058,330455705300105,112,100,113,96,84,73,53,30,578,83,661,12.556732223903177
21059,330455705300106,109,165,140,133,119,93,40,36,759,76,835,9.10179640718563
21060,330455705300107,31,42,38,43,44,27,15,15,225,30,255,11.764705882352942
21061,330455705300108,161,202,179,136,138,96,49,31,912,80,992,8.064516129032258
21062,330455705300109,45,67,58,68,50,48,16,25,336,41,377,10.875331564986737
21063,330455705300110,155,174,157,107,143,78,46,16,814,62,876,7.077625570776256
21064,330455705300111,157,153,156,126,104,94,36,23,790,59,849,6.9493521790341575
21065,330455705300112,135,133,149,91,99,51,38,27,658,65,723,8.990318118948824
21066,330455705300113,194,199,179,140,97,87,29,20,896,49,945,5.185185185185185
21067,330455705300114,128,134,134,99,76,79,45,22,650,67,717,9.344490934449093
21068,330455705300115,63,103,83,74,45,43,17,15,411,32,443,7.223476297968397
21069,330455705300116,249,250,243,219,134,89,64,29,1184,93,1277,7.282693813625685
21070,330455705300117,210,244,251,211,151,127,79,34,1194,113,1307,8.64575363427697
21071,330455705300118,158,162,175,160,134,110,49,42,899,91,990,9.191919191919192
21072,330455705300119,54,75,70,91,66,58,48,55,414,103,517,19.922630560928432
21073,330455705300120,89,137,140,114,141,92,77,63,713,140,853,16.412661195779602
21074,330455705300121,88,96,81,97,94,59,46,50,515,96,611,15.711947626841244
21075,330455705300122,78,99,114,114,82,109,45,21,596,66,662,9.969788519637461
21076,330455705300123,219,210,146,144,123,63,49,23,905,72,977,7.36949846468782
21077,330455705300124,23,19,27,31,22,20,16,7,142,23,165,13.93939393939394
21078,330455705300125,13,12,12,19,19,11,11,4,86,15,101,14.851485148514852
21079,330455705300126,51,52,40,43,60,34,8,9,280,17,297,5.723905723905724
21080,330455705300127,38,54,63,48,50,36,24,12,289,36,325,11.076923076923077
21081,330455705300128,58,58,54,57,48,52,36,30,327,66,393,16.793893129770993
21082,330455705300129,152,178,160,113,135,88,32,30,826,62,888,6.981981981981982
21083,330455705300130,32,37,31,28,33,36,22,17,197,39,236,16.52542372881356
21084,330455705300131,44,72,49,38,47,31,9,12,281,21,302,6.953642384105961
21085,330455705300132,177,216,158,156,130,96,37,15,933,52,985,5.279187817258883
21086,330455705300133,275,304,222,202,147,81,40,19,1231,59,1290,4.573643410852713
21087,330455705300134,64,92,59,40,47,28,13,5,330,18,348,5.172413793103448
21088,330455705300135,39,71,38,47,39,29,17,6,263,23,286,8.041958041958042
21089,330455705300136,117,124,111,96,73,34,16,12,555,28,583,4.802744425385935
21090,330455705300137,108,104,100,76,73,58,32,14,519,46,565,8.141592920353983
21091,330455705300138,68,81,61,60,54,40,15,13,364,28,392,7.142857142857143
21092,330455705300139,100,122,95,109,69,47,36,24,542,60,602,9.966777408637874
21093,330455705300140,65,58,56,67,42,54,26,15,342,41,383,10.704960835509139
21094,330455705300141,174,200,232,158,163,121,62,49,1048,111,1159,9.577221742881795
21095,330455705300142,123,113,158,173,110,97,69,50,774,119,893,13.325867861142218
21096,330455705300143,13,28,17,18,21,14,10,10,111,20,131,15.267175572519085
21097,330455705300144,101,117,144,150,121,110,90,64,743,154,897,17.16833890746934
21098,330455705300145,62,70,93,83,87,68,67,60,463,127,590,21.52542372881356
21099,330455705300146,74,94,120,110,99,85,74,53,582,127,709,17.912552891396334
21100,330455705300147,59,87,96,103,94,87,47,68,526,115,641,17.940717628705148
21101,330455705300148,107,133,142,158,108,128,75,56,776,131,907,14.44321940463065
21102,330455705300149,117,148,113,164,111,98,63,61,751,124,875,14.17142857142857
21103,330455705300150,78,108,114,103,121,122,78,70,646,148,794,18.639798488664987
21104,330455705300151,74,111,94,89,102,64,50,54,534,104,638,16.300940438871475
21105,330455705300152,122,138,109,128,143,73,54,23,713,77,790,9.746835443037975
21106,330455705300153,61,64,66,69,82,44,44,42,386,86,472,18.220338983050848
21107,330455705300154,66,90,73,104,93,59,45,53,485,98,583,16.80960548885077
21108,330455705300155,56,66,67,72,73,45,49,50,379,99,478,20.711297071129707
21109,330455705300156,111,133,117,153,127,111,96,64,752,160,912,17.54385964912281
21110,330455705300157,101,110,133,147,130,113,99,69,734,168,902,18.625277161862527
21111,330455705300158,78,97,96,86,87,78,52,51,522,103,625,16.48
21112,330455705300159,101,140,138,136,156,128,68,86,799,154,953,16.1594963273872
21113,330455705300160,74,82,102,89,89,99,75,52,535,127,662,19.184290030211482
21114,330455705300161,70,90,84,89,73,69,53,26,475,79,554,14.259927797833935
21115,330455705300162,75,74,75,86,65,44,38,24,419,62,481,12.88981288981289
21116,330455705300163,42,79,78,81,83,105,62,62,468,124,592,20.945945945945947
21117,330455705300164,182,177,164,278,201,98,39,16,1100,55,1155,4.761904761904762
21118,330455705300165,44,59,70,52,77,58,37,55,360,92,452,20.353982300884955
21119,330455705300166,65,120,137,135,130,103,69,86,690,155,845,18.34319526627219
21120,330455705300167,39,40,115,91,82,61,35,14,428,49,477,10.272536687631026
21121,330455705300168,43,76,106,93,133,74,57,37,525,94,619,15.18578352180937
21122,330455705300169,102,123,140,113,121,109,53,61,708,114,822,13.86861313868613
21123,330455705300170,71,126,137,140,139,93,73,72,706,145,851,17.038777908343125
21124,330455705300171,36,46,66,60,48,57,45,32,313,77,390,19.743589743589745
21125,330455705300172,64,94,83,84,73,58,56,47,456,103,559,18.4257602862254
21126,330455705300173,58,67,78,78,84,86,56,47,451,103,554,18.592057761732853
21127,330455705300174,69,101,117,92,96,119,57,65,594,122,716,17.039106145251395
21128,330455705300175,136,168,146,146,131,142,87,54,869,141,1010,13.96039603960396
21129,330455705300176,71,101,109,113,98,81,56,32,573,88,661,13.313161875945537
21130,330455705300177,60,135,121,100,86,103,50,55,605,105,710,14.788732394366198
21131,330455705300178,73,103,101,112,107,108,67,78,604,145,749,19.359145527369826
21132,330455705300179,69,96,96,95,101,71,59,45,528,104,632,16.455696202531644
21133,330455705300180,109,113,119,133,112,94,79,61,680,140,820,17.073170731707318
21134,330455705300181,193,182,193,225,145,127,71,29,1065,100,1165,8.583690987124463
21135,330455705300182,18,34,39,26,26,26,5,5,169,10,179,5.58659217877095
21136,330455705300183,85,118,103,131,126,68,67,64,631,131,762,17.191601049868765
21137,330455705300184,51,70,86,77,100,57,39,60,441,99,540,18.333333333333332
21139,330455705300186,162,215,177,183,126,89,53,31,952,84,1036,8.108108108108109
21140,330455705300187,31,47,22,30,22,14,2,4,166,6,172,3.488372093023256
21141,330455705300188,58,169,115,117,134,110,42,55,703,97,800,12.125
21142,330455705300189,52,83,86,71,85,63,42,32,440,74,514,14.396887159533074
21143,330455705300190,64,90,79,80,71,48,37,19,432,56,488,11.475409836065573
21144,330455705300191,50,63,69,77,84,43,27,28,386,55,441,12.471655328798185
21145,330455705300192,79,115,122,111,115,115,47,65,657,112,769,14.564369310793237
21146,330455705300193,80,85,91,90,76,58,38,48,480,86,566,15.19434628975265
21147,330455705300194,100,91,82,64,68,38,20,17,443,37,480,7.708333333333333
21148,330455705300195,74,114,58,73,70,35,9,9,424,18,442,4.072398190045249
21149,330455705300196,121,116,96,116,93,53,27,14,595,41,636,6.446540880503145
21150,330455705300197,109,117,88,68,46,36,19,7,464,26,490,5.3061224489795915
21151,330455705300198,49,81,55,69,68,42,28,14,364,42,406,10.344827586206897
21152,330455705300199,89,92,70,57,50,37,22,15,395,37,432,8.564814814814815
21153,330455705300200,86,112,107,80,53,46,30,11,484,41,525,7.809523809523809
21154,330455705300201,37,44,32,23,16,15,4,4,167,8,175,4.571428571428571
21155,330455705300202,167,137,83,84,72,39,23,15,582,38,620,6.129032258064516
21156,330455705300203,76,96,60,57,30,41,12,8,360,20,380,5.2631578947368425
21157,330455705300204,172,165,148,150,104,64,37,23,803,60,863,6.952491309385863
21158,330455705300205,160,194,152,176,128,110,75,41,920,116,1036,11.196911196911197
21159,330455705300206,79,81,73,63,44,42,23,16,382,39,421,9.263657957244655
21160,330455705300207,90,91,90,83,64,40,23,21,458,44,502,8.764940239043824
21161,330455705300208,180,126,173,113,65,46,41,9,703,50,753,6.6401062416998675
21162,330455705300209,83,84,88,80,51,41,21,9,427,30,457,6.564551422319475
21163,330455705300210,100,107,93,88,62,51,36,17,501,53,554,9.566787003610107
21164,330455705300211,95,121,114,101,99,101,41,32,631,73,704,10.369318181818182
21165,330455705300212,191,175,107,98,69,60,30,13,700,43,743,5.787348586810229
21166,330455705300213,134,169,180,171,143,108,96,58,905,154,1059,14.542020774315391
21167,330455705300214,125,202,111,219,117,93,77,57,867,134,1001,13.386613386613387
21168,330455705300215,79,102,128,103,106,106,36,21,624,57,681,8.370044052863436
21169,330455705300216,86,141,105,154,131,88,101,82,705,183,888,20.60810810810811
21170,330455705300217,96,142,118,136,122,129,80,65,743,145,888,16.32882882882883
21171,330455705300218,100,139,156,133,133,124,90,89,785,179,964,18.568464730290458
21172,330455705300219,51,63,78,64,58,57,45,29,371,74,445,16.629213483146067
21173,330455705300220,94,120,132,105,99,96,59,46,646,105,751,13.981358189081226
21174,330455705300221,67,75,65,79,67,53,25,34,406,59,465,12.688172043010752
21175,330455705300222,95,134,119,166,184,83,47,18,781,65,846,7.68321513002364
21176,330455705300223,68,77,122,82,89,78,44,48,516,92,608,15.131578947368421
21177,330455705300224,98,87,117,100,74,59,46,42,535,88,623,14.125200642054574
21178,330455705300225,141,168,128,112,79,61,27,11,689,38,727,5.226960110041265
21179,330455705300226,163,189,141,120,84,45,18,13,742,31,773,4.010349288486417
21180,330455705300227,191,198,115,105,78,58,40,19,745,59,804,7.338308457711443
21181,330455705300228,196,203,151,140,137,83,34,25,910,59,969,6.0887512899896805
21182,330455705300229,194,241,146,129,104,72,29,14,886,43,929,4.628632938643703
21183,330455705300230,74,92,98,85,70,91,50,43,510,93,603,15.422885572139304
21184,330455705300231,23,43,60,40,81,76,31,55,323,86,409,21.026894865525673
21185,330455705300232,62,89,72,77,118,89,48,80,507,128,635,20.15748031496063
21186,330455705300233,63,105,113,103,102,91,62,57,577,119,696,17.097701149425287
21187,330455705300234,114,133,91,85,70,33,22,8,526,30,556,5.39568345323741
21188,330455705300235,110,157,100,114,90,57,29,16,628,45,673,6.686478454680535
21189,330455705300236,112,119,144,130,108,100,111,75,713,186,899,20.689655172413794
21190,330455705300237,141,161,140,137,117,91,67,51,787,118,905,13.03867403314917
21191,330455705300238,147,165,153,142,114,87,53,31,808,84,892,9.417040358744394
21192,330455705300239,118,114,124,103,81,70,35,22,610,57,667,8.545727136431784
21193,330455705300240,79,106,108,86,71,75,36,26,525,62,587,10.562180579216355
21194,330455705300241,135,149,186,141,120,120,64,33,851,97,948,10.232067510548523
21195,330455705300242,65,59,46,49,41,31,18,15,291,33,324,10.185185185185185
21196,330455705300243,44,63,41,37,33,21,8,8,239,16,255,6.2745098039215685
21197,330455705300244,189,221,227,181,181,165,92,67,1164,159,1323,12.01814058956916
21198,330455705300245,98,116,104,92,74,83,31,34,567,65,632,10.284810126582279
21199,330455705300246,41,69,90,68,66,80,30,17,414,47,461,10.195227765726681
21200,330455705300247,45,64,102,91,72,93,37,22,467,59,526,11.216730038022813
21201,330455705300248,60,70,91,91,61,68,34,9,441,43,484,8.884297520661157
21202,330455705300249,89,129,144,154,147,145,65,36,808,101,909,11.11111111111111
21203,330455705300250,94,97,132,123,86,93,46,20,625,66,691,9.55137481910275
21204,330455705300251,46,46,80,85,46,71,29,12,374,41,415,9.879518072289157
21205,330455705300252,66,87,126,138,113,110,55,28,640,83,723,11.479944674965422
21206,330455705300253,90,108,154,131,111,139,83,34,733,117,850,13.764705882352942
21207,330455705300254,93,104,149,138,132,131,73,25,747,98,845,11.597633136094675
21208,330455705300255,94,113,163,173,103,113,71,29,759,100,859,11.641443538998836
21209,330455705300256,51,135,115,115,103,70,65,51,589,116,705,16.45390070921986
21210,330455705300257,65,87,84,84,103,79,64,48,502,112,614,18.241042345276874
21211,330455705300258,37,49,58,53,51,45,29,34,293,63,356,17.696629213483146
21212,330455705300259,82,85,102,102,74,82,61,61,527,122,649,18.79815100154083
21213,330455705300260,44,74,84,61,67,47,50,53,377,103,480,21.458333333333332
21214,330455705300261,147,169,174,176,165,133,98,108,964,206,1170,17.60683760683761
21215,330455705300262,63,107,118,111,81,92,55,49,572,104,676,15.384615384615385
21216,330455705300263,34,67,58,56,62,54,46,41,331,87,418,20.8133971291866
21217,330455705300264,68,73,151,129,87,110,61,42,618,103,721,14.285714285714286
21218,330455705300265,81,148,123,117,172,119,65,83,760,148,908,16.29955947136564
21219,330455705300266,117,197,149,208,182,158,76,75,1011,151,1162,12.994836488812393
21220,330455705300267,22,33,14,21,18,12,1,2,120,3,123,2.4390243902439024
21221,330455705300268,172,231,164,155,138,78,46,26,938,72,1010,7.128712871287129
21222,330455705300269,82,118,119,88,90,91,50,37,588,87,675,12.88888888888889
21223,330455705300270,207,212,148,128,95,61,24,3,851,27,878,3.075170842824601
21224,330455705300271,170,186,125,110,72,54,20,13,717,33,750,4.4
21225,330455705300272,94,92,78,76,41,46,18,9,427,27,454,5.947136563876652
21226,330455705300273,86,101,72,84,54,41,14,9,438,23,461,4.989154013015185
21227,330455705300274,58,111,93,104,119,76,64,54,561,118,679,17.378497790868924
21228,330455705300275,80,100,85,102,90,72,45,59,529,104,633,16.429699842022117
21229,330455705300276,149,142,102,87,53,53,17,9,586,26,612,4.248366013071895
21230,330455705300277,115,61,51,47,22,17,9,4,313,13,326,3.9877300613496933
21231,330455705300278,71,91,35,59,25,22,10,2,303,12,315,3.8095238095238093
21232,330455705300279,127,103,72,53,46,33,17,2,434,19,453,4.194260485651214
21233,330455705300280,84,73,52,43,36,19,5,3,307,8,315,2.5396825396825395
21234,330455705300281,50,43,33,36,27,24,8,6,213,14,227,6.167400881057269
21235,330455705300282,130,138,119,96,63,36,13,10,582,23,605,3.8016528925619837
21236,330455705300283,289,374,287,232,180,132,52,24,1494,76,1570,4.840764331210191
21237,330455705300284,111,71,64,60,29,31,2,1,366,3,369,0.8130081300813008
21238,330455705300285,105,91,77,66,36,23,3,3,398,6,404,1.4851485148514851
21240,330455705300287,130,139,143,178,160,97,38,10,847,48,895,5.363128491620111
21241,330455705300288,12,18,11,18,14,10,5,2,83,7,90,7.777777777777778
21242,330455705300289,37,55,41,35,43,31,9,7,242,16,258,6.2015503875969
21244,330455705300291,17,16,25,13,18,9,4,3,98,7,105,6.666666666666667
21245,330455705300292,11,16,11,19,8,8,8,4,73,12,85,14.117647058823529
21246,330455705300293,17,44,18,16,34,13,3,4,142,7,149,4.697986577181208
21247,330455705300294,57,50,39,32,22,20,10,2,220,12,232,5.172413793103448
21248,330455705300295,47,32,47,50,35,23,27,37,234,64,298,21.476510067114095
21249,330455705300296,87,127,90,86,80,43,24,16,513,40,553,7.233273056057866
21250,330455705300297,108,136,110,98,68,59,42,19,579,61,640,9.53125
21251,330455705300298,146,134,147,102,53,43,33,13,625,46,671,6.855439642324888
21252,330455705300299,31,43,24,33,27,27,17,9,185,26,211,12.322274881516588
21253,330455705300300,64,73,67,58,61,35,22,9,358,31,389,7.969151670951157
21254,330455705300301,235,166,146,95,43,36,20,5,721,25,746,3.351206434316354
21255,330455705300302,154,108,100,62,39,20,11,4,483,15,498,3.0120481927710845
21256,330455705300303,88,90,52,49,35,27,9,0,341,9,350,2.5714285714285716
21257,330455705300304,122,96,134,161,108,56,27,7,677,34,711,4.781997187060478
21258,330455705300305,184,151,143,204,101,36,18,6,819,24,843,2.8469750889679717
21259,330455705300306,77,97,90,61,45,36,20,17,406,37,443,8.352144469525959
21260,330455705300307,46,48,59,47,46,57,23,36,303,59,362,16.298342541436465
21261,330455705300308,110,146,113,123,82,60,31,13,634,44,678,6.489675516224189
21262,330455705300309,77,43,39,28,19,6,2,0,212,2,214,0.9345794392523364
21263,330455705300310,103,103,103,75,75,58,30,20,517,50,567,8.818342151675486
21264,330455705300311,62,70,98,80,88,84,56,61,482,117,599,19.532554257095157
21265,330455705300312,74,124,102,121,83,88,69,42,592,111,703,15.789473684210526
21266,330455705300313,60,89,62,68,49,37,26,23,365,49,414,11.83574879227053
21267,330455705300314,152,105,106,100,61,41,12,6,565,18,583,3.0874785591766725
21268,330455705300315,237,205,180,127,97,62,25,8,908,33,941,3.5069075451647183
21269,330455705300316,145,108,116,116,53,44,14,1,582,15,597,2.512562814070352
21270,330455705300317,87,80,71,85,54,50,18,24,427,42,469,8.955223880597014
21271,330455705300318,71,67,54,55,47,34,25,14,328,39,367,10.626702997275205
21272,330455705300319,39,59,62,67,38,27,15,17,292,32,324,9.876543209876543
21273,330455705300320,68,87,85,61,54,34,17,20,389,37,426,8.685446009389672
21274,330455705300321,20,22,17,21,18,15,9,3,113,12,125,9.6
21275,330455705300322,5,5,5,5,3,2,1,0,25,1,26,3.8461538461538463
21276,330455705300323,45,45,37,36,32,17,13,8,212,21,233,9.012875536480687
21277,330455705300324,24,27,32,23,22,11,10,1,139,11,150,7.333333333333333
21278,330455705300325,14,16,14,11,9,3,0,1,67,1,68,1.4705882352941178
21279,330455705300326,34,44,40,38,24,18,6,6,198,12,210,5.714285714285714
21280,330455705300327,218,277,254,148,106,72,37,12,1075,49,1124,4.359430604982206
21281,330455705300328,12,12,10,9,10,12,1,5,65,6,71,8.450704225352112
21282,330455705300329,78,93,74,65,61,42,28,10,413,38,451,8.425720620842572
21283,330455705300330,61,63,71,52,41,33,21,9,321,30,351,8.547008547008547
21284,330455705300331,58,62,55,38,37,20,14,5,270,19,289,6.57439446366782
21285,330455705300332,108,108,102,63,72,52,20,10,505,30,535,5.607476635514018
21286,330455705300333,136,260,176,167,159,85,52,18,983,70,1053,6.647673314339981
21287,330455705300334,62,98,61,67,66,37,15,12,391,27,418,6.45933014354067
21288,330455705300335,109,115,106,69,52,41,15,12,492,27,519,5.202312138728324
21289,330455705300336,76,78,60,68,20,26,18,4,328,22,350,6.285714285714286
21290,330455705300337,104,112,106,123,144,93,35,23,682,58,740,7.837837837837838
21291,330455705300338,132,187,127,115,118,71,21,21,750,42,792,5.303030303030303
21292,330455705300339,145,164,141,124,126,80,38,24,780,62,842,7.363420427553444
21293,330455705310001,81,95,74,67,51,35,20,10,403,30,433,6.928406466512702
21294,330455705310002,51,72,47,38,56,39,23,23,303,46,349,13.180515759312321
21295,330455705310003,55,58,46,63,47,45,34,30,314,64,378,16.93121693121693
21296,330455705310004,40,62,37,48,56,48,33,20,291,53,344,15.406976744186046
21297,330455705310005,32,32,38,19,42,28,17,18,191,35,226,15.486725663716815
21298,330455705310006,47,54,62,60,51,49,51,38,323,89,412,21.601941747572816
21299,330455705310007,12,17,23,13,19,26,13,9,110,22,132,16.666666666666668
21300,330455705310008,73,94,76,81,78,54,33,20,456,53,509,10.412573673870334
21301,330455705310009,220,136,201,232,140,88,68,19,1017,87,1104,7.880434782608695
21302,330455705310010,87,121,86,109,63,42,36,15,508,51,559,9.123434704830053
21303,330455705310011,41,56,59,55,31,23,12,5,265,17,282,6.028368794326241
21304,330455705310012,96,80,86,86,73,31,24,10,452,34,486,6.995884773662551
21305,330455705310013,136,147,111,110,72,42,27,11,618,38,656,5.7926829268292686
21306,330455705310014,23,33,27,31,26,22,11,9,162,20,182,10.989010989010989
21307,330455705310015,36,75,120,85,41,22,13,8,379,21,400,5.25
21308,330455705310016,37,46,35,42,28,21,18,10,209,28,237,11.814345991561181
21309,330455705310017,77,97,104,96,96,88,54,34,558,88,646,13.622291021671826
21310,330455705310018,44,55,49,41,40,34,14,16,263,30,293,10.238907849829351
21311,330455705310019,143,180,129,144,134,74,41,22,804,63,867,7.26643598615917
21312,330455705310020,102,135,97,97,72,66,34,27,569,61,630,9.682539682539682
21313,330455705310021,111,163,97,121,127,62,47,30,681,77,758,10.158311345646437
21314,330455705310022,155,148,140,149,113,59,35,30,764,65,829,7.840772014475271
21315,330455705310023,43,54,43,48,36,23,7,4,247,11,258,4.263565891472868
21316,330455705310024,130,161,144,138,98,57,33,15,728,48,776,6.185567010309279
21317,330455705310025,46,42,35,60,43,32,31,26,258,57,315,18.095238095238095
21318,330455705310026,99,89,104,77,101,39,39,18,509,57,566,10.070671378091873
21319,330455705310027,116,115,116,99,87,41,34,26,574,60,634,9.46372239747634
21320,330455705310028,191,227,259,213,170,102,52,48,1162,100,1262,7.9239302694136295
21321,330455705310029,102,115,87,103,77,96,40,39,580,79,659,11.987860394537178
21322,330455705310030,80,91,88,100,64,69,51,26,492,77,569,13.532513181019333
21323,330455705310031,110,167,83,101,95,64,21,17,620,38,658,5.775075987841945
21324,330455705310032,60,88,76,83,72,62,37,43,441,80,521,15.355086372360844
21325,330455705310033,44,82,83,92,62,35,28,11,398,39,437,8.924485125858123
21326,330455705310034,132,154,158,145,134,69,58,35,792,93,885,10.508474576271187
21327,330455705310035,147,158,130,136,111,57,39,20,739,59,798,7.393483709273183
21328,330455705310036,48,63,54,82,64,30,23,8,341,31,372,8.333333333333334
21329,330455705310037,77,84,88,80,68,51,26,20,448,46,494,9.31174089068826
21330,330455705310038,25,34,29,43,25,30,9,6,186,15,201,7.462686567164179
21331,330455705310039,100,132,132,137,110,105,54,42,716,96,812,11.822660098522167
21332,330455705310040,33,51,33,41,22,38,10,11,218,21,239,8.786610878661088
21333,330455705310041,85,130,103,101,87,77,59,50,583,109,692,15.751445086705202
21334,330455705310042,65,83,66,79,53,62,39,30,408,69,477,14.465408805031446
21335,330455705310043,56,61,59,58,58,42,27,21,334,48,382,12.565445026178011
21336,330455705310044,80,78,77,124,95,57,41,32,511,73,584,12.5
21337,330455705310045,171,238,173,173,160,108,78,51,1023,129,1152,11.197916666666666
21338,330455705310046,94,142,112,105,95,54,25,44,602,69,671,10.283159463487332
21339,330455705310047,120,161,109,132,111,71,41,40,704,81,785,10.318471337579618
21340,330455705310048,143,182,139,133,97,92,34,22,786,56,842,6.65083135391924
21341,330455705310049,63,45,68,95,48,31,14,6,350,20,370,5.405405405405405
21342,330455705310050,107,125,116,119,96,76,47,32,639,79,718,11.002785515320335
21343,330455705310051,32,35,36,35,27,19,14,18,184,32,216,14.814814814814815
21344,330455705310052,83,101,101,119,102,62,39,20,568,59,627,9.409888357256778
21345,330455705310053,36,73,54,85,95,30,32,26,373,58,431,13.45707656612529
21346,330455705310054,13,10,28,11,12,10,7,6,84,13,97,13.402061855670103
21347,330455705310055,29,50,34,34,45,38,19,13,230,32,262,12.213740458015268
21349,330455705310057,112,125,81,117,58,51,21,13,544,34,578,5.882352941176471
21350,330455705310058,165,173,167,183,136,113,49,41,937,90,1027,8.763388510223953
21351,330455705310059,2,1,4,7,5,4,4,1,23,5,28,17.857142857142858
21352,330455705310060,2,2,5,1,6,3,1,0,19,1,20,5.0
21353,330455705310061,9,18,7,14,12,7,10,4,67,14,81,17.28395061728395
21354,330455705310062,125,203,115,157,101,69,24,12,770,36,806,4.4665012406947895
21355,330455705310063,87,72,141,117,59,71,31,32,547,63,610,10.327868852459016
21356,330455705310064,70,90,89,106,90,46,32,27,491,59,550,10.727272727272727
21357,330455705310065,55,78,84,72,74,59,40,18,422,58,480,12.083333333333334
21358,330455705310066,105,132,153,124,114,85,62,40,713,102,815,12.515337423312884
21359,330455705310067,147,162,160,156,145,96,69,54,866,123,989,12.43680485338726
21360,330455705310068,39,69,66,56,75,50,30,19,355,49,404,12.128712871287128
21361,330455705310069,72,95,100,118,88,92,61,37,565,98,663,14.781297134238311
21362,330455705310070,66,68,65,81,57,64,25,18,401,43,444,9.684684684684685
21363,330455705310071,30,43,40,37,45,32,11,19,227,30,257,11.673151750972762
21364,330455705310072,33,40,42,38,37,34,17,14,224,31,255,12.156862745098039
21365,330455705310073,37,22,11,47,25,4,0,2,146,2,148,1.3513513513513513
21366,330455705310074,218,256,218,286,223,132,63,48,1333,111,1444,7.686980609418282
21367,330455705310075,54,89,81,73,71,52,32,35,420,67,487,13.757700205338809
21368,330455705310076,106,105,91,105,90,46,44,37,543,81,624,12.98076923076923
21370,330455705310079,101,109,79,133,81,53,45,36,556,81,637,12.71585557299843
21371,330455705310080,15,18,26,25,17,20,9,4,121,13,134,9.701492537313433
21372,330455705310081,150,165,135,122,115,76,33,28,763,61,824,7.402912621359223
21373,330455705310082,110,96,105,115,89,67,24,28,582,52,634,8.201892744479496
21374,330455705310083,57,72,61,64,47,22,8,4,323,12,335,3.582089552238806
21375,330455705310084,139,114,123,99,48,12,13,2,535,15,550,2.727272727272727
21376,330455705310085,10,11,7,8,5,2,1,0,43,1,44,2.272727272727273
21377,330455705310086,207,230,206,212,180,122,52,28,1157,80,1237,6.467259498787389
21378,330455705310087,28,40,50,56,51,46,21,23,271,44,315,13.968253968253968
21379,330455705310088,52,43,59,46,51,57,22,18,308,40,348,11.494252873563218
21381,330455705310090,60,91,93,66,75,63,41,29,448,70,518,13.513513513513514
21382,330455705310091,59,93,80,64,89,58,42,22,443,64,507,12.6232741617357
21383,330455705310092,75,77,97,93,73,59,32,29,474,61,535,11.401869158878505
21384,330455705310093,66,86,75,95,82,65,45,35,469,80,549,14.571948998178506
21385,330455705310094,86,114,85,109,84,105,57,46,583,103,686,15.01457725947522
21386,330455705310095,61,70,70,74,59,67,62,54,401,116,517,22.437137330754354
21387,330455705310096,25,28,27,25,29,24,13,16,158,29,187,15.508021390374331
21388,330455705310097,70,90,89,76,89,71,39,44,485,83,568,14.612676056338028
21389,330455705310098,101,123,138,134,118,112,96,79,726,175,901,19.42286348501665
21390,330455705310099,24,22,26,32,38,25,16,29,167,45,212,21.22641509433962
21391,330455705310100,27,25,36,34,31,34,18,9,187,27,214,12.616822429906541
21392,330455705310101,91,115,160,113,135,127,65,40,741,105,846,12.411347517730496
21393,330455705310102,74,83,97,85,74,45,45,24,458,69,527,13.092979127134726
21394,330455705310103,72,119,115,71,76,47,30,20,500,50,550,9.090909090909092
21395,330455705310104,25,78,56,72,77,69,52,40,377,92,469,19.616204690831555
21396,330455705310105,33,43,49,42,42,49,37,30,258,67,325,20.615384615384617
21397,330455705310106,26,31,21,30,48,26,23,13,182,36,218,16.513761467889907
21398,330455705310107,16,19,25,22,22,19,10,6,123,16,139,11.510791366906474
21399,330455705310108,41,74,75,66,82,84,44,37,422,81,503,16.10337972166998
21400,330455705310109,115,146,118,119,121,71,40,21,690,61,751,8.122503328894807
21401,330455705310110,58,85,71,64,57,45,31,22,380,53,433,12.240184757505773
21402,330455705310111,109,130,110,120,95,65,50,30,629,80,709,11.283497884344147
21403,330455705310112,56,64,76,66,80,45,37,21,387,58,445,13.03370786516854
21404,330455705310113,36,71,48,70,46,32,27,18,303,45,348,12.931034482758621
21405,330455705310114,64,65,45,66,46,25,6,4,311,10,321,3.115264797507788
21406,330455705310115,110,105,144,123,43,29,17,5,554,22,576,3.8194444444444446
21407,330455705310116,151,148,151,148,107,72,41,26,777,67,844,7.938388625592417
21408,330455705310117,146,137,139,152,84,40,16,11,698,27,725,3.7241379310344827
21409,330455705310118,61,40,52,52,36,13,12,4,254,16,270,5.925925925925926
21410,330455705310119,91,86,91,72,55,35,25,6,430,31,461,6.724511930585683
21411,330455705310120,124,145,135,115,89,59,23,14,667,37,704,5.255681818181818
21412,330455705310121,75,95,54,79,48,28,10,4,379,14,393,3.5623409669211195
21413,330455705310122,175,147,147,129,88,58,24,19,744,43,787,5.463786531130877
21414,330455705310123,71,96,70,64,61,37,17,12,399,29,428,6.775700934579439
21415,330455705310124,132,108,107,98,74,37,24,8,556,32,588,5.442176870748299
21416,330455705310125,141,129,82,112,69,42,13,13,575,26,601,4.3261231281198
21417,330455705310126,91,90,83,71,51,36,23,7,422,30,452,6.6371681415929205
21418,330455705310127,93,86,101,69,63,42,27,15,454,42,496,8.46774193548387
21419,330455705310128,35,60,43,42,64,70,43,28,314,71,385,18.441558441558442
21420,330455705310129,36,44,23,37,43,34,23,14,217,37,254,14.566929133858268
21421,330455705310130,22,29,34,23,39,19,42,49,166,91,257,35.40856031128405
21422,330455705310131,203,244,226,244,188,129,63,43,1234,106,1340,7.91044776119403
21423,330455705310132,117,145,114,137,120,95,56,43,728,99,827,11.970979443772672
21424,330455705310133,165,209,146,157,91,55,25,11,823,36,859,4.190919674039581
21425,330455705310134,146,164,121,145,90,56,24,16,722,40,762,5.2493438320209975
21426,330455705310135,161,146,105,128,66,55,25,11,661,36,697,5.164992826398852
21427,330455705310136,61,67,91,80,66,69,59,41,434,100,534,18.726591760299627
21428,330455705310137,48,77,59,69,69,40,18,11,362,29,391,7.41687979539642
21429,330455705310138,101,119,102,101,91,68,32,23,582,55,637,8.634222919937205
21430,330455705310140,102,104,69,110,63,30,15,6,478,21,499,4.208416833667335
21431,330455705310141,85,94,77,102,78,63,62,37,499,99,598,16.555183946488295
21432,330455705310142,77,90,84,88,62,51,35,18,452,53,505,10.495049504950495
21433,330455705310143,51,50,49,65,49,27,18,7,291,25,316,7.9113924050632916
21434,330455705310144,122,153,132,136,95,40,33,27,678,60,738,8.130081300813009
21435,330455705310145,59,116,60,57,59,52,23,21,403,44,447,9.843400447427292
21436,330455705310146,107,117,89,105,86,47,22,16,551,38,589,6.451612903225806
21437,330455705310147,100,82,112,79,58,38,19,17,469,36,505,7.128712871287129
21438,330455705310148,96,101,63,58,82,43,24,24,443,48,491,9.775967413441956
21439,330455705310149,58,203,166,162,94,22,1,0,705,1,706,0.141643059490085
21440,330455705310150,160,180,143,143,94,75,26,22,795,48,843,5.693950177935943
21441,330455705310151,88,75,150,148,38,22,15,7,521,22,543,4.051565377532229
21442,330455705310152,82,90,74,67,83,69,48,22,465,70,535,13.08411214953271
21443,330455705310153,27,47,34,33,47,35,37,26,223,63,286,22.027972027972027
21444,330455705310154,22,35,22,31,20,19,5,6,149,11,160,6.875
21445,330455705310155,39,62,44,47,49,30,13,12,271,25,296,8.445945945945946
21446,330455705310156,56,81,60,84,60,44,39,21,385,60,445,13.48314606741573
21447,330455705310157,73,99,115,85,69,56,32,17,497,49,546,8.974358974358974
21448,330455705310158,73,68,94,70,76,42,35,29,423,64,487,13.141683778234086
21449,330455705310159,125,166,112,126,89,38,20,18,656,38,694,5.475504322766571
21450,330455705310160,48,78,44,63,64,46,25,16,343,41,384,10.677083333333334
21451,330455705310161,125,153,109,144,107,70,46,33,708,79,787,10.038119440914867
21452,330455705310162,76,106,125,117,81,58,32,25,563,57,620,9.193548387096774
21453,330455705310163,121,150,142,134,131,79,38,43,757,81,838,9.665871121718377
21454,330455705310164,94,136,107,92,88,36,19,15,553,34,587,5.792163543441227
21455,330455705310165,63,61,77,45,48,33,17,24,327,41,368,11.141304347826088
21456,330455705310166,133,142,125,134,129,97,62,51,760,113,873,12.943871706758305
21457,330455705310167,60,79,56,65,45,28,23,11,333,34,367,9.264305177111716
21458,330455705310168,130,123,137,127,108,59,31,26,684,57,741,7.6923076923076925
21459,330455705310169,130,178,143,135,151,85,68,53,822,121,943,12.831389183457052
21460,330455705310170,47,32,42,29,36,22,14,7,208,21,229,9.170305676855895
21461,330455705310171,228,275,200,224,185,113,49,48,1225,97,1322,7.337367624810892
21462,330455705310172,154,155,195,151,88,81,23,13,824,36,860,4.186046511627907
21463,330455705310173,154,100,147,109,46,20,5,3,576,8,584,1.36986301369863
21464,330455705310174,94,63,94,91,43,14,9,3,399,12,411,2.9197080291970803
21465,330455705310175,85,88,77,102,58,28,14,12,438,26,464,5.603448275862069
21466,330455705310176,67,90,51,99,51,20,10,1,378,11,389,2.827763496143959
21467,330455705310177,109,102,147,97,40,27,12,0,522,12,534,2.247191011235955
21468,330455705310178,86,83,76,85,55,31,10,9,416,19,435,4.367816091954023
21469,330455705310179,63,80,68,73,69,55,39,20,408,59,467,12.633832976445396
21470,330455705310180,62,71,95,64,100,59,32,18,451,50,501,9.980039920159681
21471,330455705310181,17,24,24,19,25,20,23,26,129,49,178,27.528089887640448
21472,330455705310182,107,112,157,90,82,66,27,6,614,33,647,5.1004636785162285
21473,330455705310183,41,49,73,45,49,23,15,12,280,27,307,8.794788273615636
21474,330455705310184,91,111,112,86,60,50,13,8,510,21,531,3.9548022598870056
21475,330455705310185,39,48,46,40,38,16,14,7,227,21,248,8.46774193548387
21476,330455705310186,237,211,176,196,109,88,42,29,1017,71,1088,6.525735294117647
21477,330455705310187,27,34,26,32,24,17,7,6,160,13,173,7.514450867052023
21478,330455705310188,39,47,66,43,43,42,39,20,280,59,339,17.404129793510325
21479,330455705310189,95,112,106,98,89,68,35,27,568,62,630,9.841269841269842
21480,330455705310190,9,17,13,19,21,20,5,9,99,14,113,12.389380530973451
21482,330455705310192,86,57,68,62,55,37,33,16,365,49,414,11.83574879227053
21483,330455705310193,92,88,98,96,62,44,28,12,480,40,520,7.6923076923076925
21484,330455705310194,53,57,50,62,58,50,33,24,330,57,387,14.728682170542635
21485,330455705310195,158,184,154,160,137,97,43,38,890,81,971,8.341915550978372
21486,330455705310196,23,53,46,36,49,39,24,28,246,52,298,17.449664429530202
21487,330455705310197,76,72,97,80,77,73,45,38,475,83,558,14.874551971326165
21488,330455705310198,103,125,94,108,89,83,56,21,602,77,679,11.34020618556701
21489,330455705310199,84,104,97,86,101,67,52,38,539,90,629,14.308426073131956
21490,330455705310200,23,26,28,50,22,46,20,14,195,34,229,14.847161572052402
21491,330455705310201,106,112,97,85,54,48,21,14,502,35,537,6.517690875232774
21492,330455705310202,83,104,99,98,72,55,46,24,511,70,581,12.048192771084338
21493,330455705310203,194,232,200,185,159,101,49,32,1071,81,1152,7.03125
21494,330455705310204,136,133,131,146,83,76,35,28,705,63,768,8.203125
21495,330455705310205,101,112,123,94,104,64,53,26,598,79,677,11.669128508124077
21496,330455705310206,17,30,26,21,30,32,25,27,156,52,208,25.0
21497,330455705310207,154,164,119,135,96,60,23,13,728,36,764,4.712041884816754
21498,330455705310208,26,44,38,39,34,18,5,12,199,17,216,7.87037037037037
21499,330455705310209,115,185,155,180,87,41,22,11,763,33,796,4.1457286432160805
21500,330455705310210,27,14,16,21,14,4,4,5,96,9,105,8.571428571428571
21501,330455705310211,40,43,49,45,52,49,29,7,278,36,314,11.464968152866241
21502,330455705310212,31,42,37,35,25,22,12,3,192,15,207,7.246376811594203
21503,330455705310213,12,17,14,15,14,12,7,4,84,11,95,11.578947368421053
21504,330455705310214,17,13,12,18,6,8,3,1,74,4,78,5.128205128205129
21505,330455705310215,23,17,13,35,10,4,7,0,102,7,109,6.422018348623853
21506,330455705310216,3,1,2,3,0,2,1,0,11,1,12,8.333333333333334
21507,330455705310217,23,27,18,28,10,4,3,0,110,3,113,2.6548672566371683
21508,330455705310218,58,113,94,85,77,50,46,36,477,82,559,14.669051878354203
21509,330455705310219,28,34,29,43,31,25,17,14,190,31,221,14.027149321266968
21510,330455705310220,15,16,21,13,11,9,1,6,85,7,92,7.608695652173913
21511,330455705310221,19,49,32,40,28,14,12,10,182,22,204,10.784313725490197
21512,330455705310222,96,93,84,95,67,51,23,10,486,33,519,6.358381502890174
21513,330455705310223,26,15,14,23,24,6,3,7,108,10,118,8.474576271186441
21514,330455705310224,9,14,5,18,13,6,2,2,65,4,69,5.797101449275362
21515,330455705310225,43,121,102,78,58,27,15,24,429,39,468,8.333333333333334
21516,330455705310226,21,25,8,25,13,8,0,0,100,0,100,0.0
21517,330455705310227,96,101,93,98,47,30,13,7,465,20,485,4.123711340206185
21518,330455705310228,30,38,34,43,29,22,16,11,196,27,223,12.10762331838565
21519,330455705310229,31,35,30,26,27,15,6,11,164,17,181,9.392265193370166
21520,330455705310230,46,48,50,43,38,29,7,7,254,14,268,5.223880597014926
21521,330455705310231,39,38,29,30,16,11,8,2,163,10,173,5.780346820809249
21522,330455705310232,17,15,6,15,11,4,2,0,68,2,70,2.857142857142857
21523,330455705310233,12,13,17,11,4,3,4,1,60,5,65,7.6923076923076925
21524,330455705310234,49,48,45,40,31,11,11,6,224,17,241,7.053941908713693
21525,330455705310235,30,45,34,39,32,27,12,14,207,26,233,11.158798283261802
21526,330455705310236,111,143,127,132,103,77,43,24,693,67,760,8.81578947368421
21527,330455705310237,31,51,70,56,37,15,8,4,260,12,272,4.411764705882353
21528,330455705310238,43,42,30,33,17,11,12,5,176,17,193,8.808290155440414
21529,330455705310239,59,87,88,64,40,28,20,10,366,30,396,7.575757575757576
21530,330455705310240,45,65,54,39,35,13,2,4,251,6,257,2.3346303501945527
21531,330455705310241,42,50,79,62,32,17,6,6,282,12,294,4.081632653061225
21532,330455705310242,148,144,154,149,101,81,60,33,777,93,870,10.689655172413794
21533,330455705310243,160,188,172,168,126,97,38,33,911,71,982,7.2301425661914465
21534,330455705310244,34,69,56,51,45,33,17,15,288,32,320,10.0
21535,330455705310245,74,98,105,70,68,55,17,17,470,34,504,6.746031746031746
21536,330455705310246,18,20,11,17,14,7,6,2,87,8,95,8.421052631578947
21537,330455705310247,22,43,36,43,10,2,11,3,156,14,170,8.235294117647058
21538,330455705310248,94,131,91,100,106,65,34,26,587,60,647,9.273570324574962
21539,330455705310249,166,133,150,229,149,80,42,23,907,65,972,6.68724279835391
21540,330455705310250,80,100,82,86,86,43,33,21,477,54,531,10.169491525423728
21541,330455705310251,32,47,38,47,39,27,21,16,230,37,267,13.857677902621722
21542,330455705310259,50,68,51,59,31,13,3,5,272,8,280,2.857142857142857
21543,330455705310260,133,141,117,132,80,51,11,14,654,25,679,3.681885125184094
21544,330455705320001,41,30,76,67,62,71,48,49,347,97,444,21.846846846846848
21545,330455705320002,56,58,89,86,62,67,53,54,418,107,525,20.38095238095238
21546,330455705320003,63,87,121,121,98,97,73,65,587,138,725,19.03448275862069
21547,330455705320004,48,64,108,103,90,70,64,63,483,127,610,20.81967213114754
21548,330455705320005,81,94,135,132,108,122,78,58,672,136,808,16.831683168316832
21549,330455705320006,44,46,63,90,69,63,41,44,375,85,460,18.47826086956522
21550,330455705320007,64,80,116,104,73,108,59,65,545,124,669,18.53512705530643
21551,330455705320008,39,85,77,73,93,94,35,58,461,93,554,16.787003610108304
21552,330455705320009,51,87,64,77,89,70,42,50,438,92,530,17.358490566037737
21553,330455705320010,50,66,75,89,60,62,30,38,402,68,470,14.46808510638298
21554,330455705320011,87,84,144,101,102,105,69,56,623,125,748,16.711229946524064
21555,330455705320012,65,86,107,108,121,102,48,62,589,110,699,15.736766809728183
21556,330455705320013,30,47,83,59,67,52,27,17,338,44,382,11.518324607329843
21557,330455705320014,39,58,102,80,72,65,42,57,416,99,515,19.223300970873787
21558,330455705320015,53,63,99,80,71,90,50,66,456,116,572,20.27972027972028
21559,330455705320016,30,45,55,51,49,59,31,49,289,80,369,21.680216802168022
21560,330455705320017,44,63,81,69,93,81,47,59,431,106,537,19.73929236499069
21561,330455705320018,44,60,80,58,67,83,55,49,392,104,496,20.967741935483872
21562,330455705320019,87,106,152,114,96,90,50,31,645,81,726,11.15702479338843
21563,330455705320020,49,66,79,88,90,58,43,59,430,102,532,19.172932330827066
21564,330455705320021,75,88,128,123,107,101,64,65,622,129,751,17.177097203728362
21565,330455705320022,90,120,135,107,99,119,49,54,670,103,773,13.32470892626132
21566,330455705320023,63,64,107,95,82,81,59,62,492,121,613,19.73898858075041
21567,330455705320024,50,63,93,94,83,81,77,97,464,174,638,27.272727272727273
21568,330455705320025,49,64,111,119,99,105,54,83,547,137,684,20.029239766081872
21569,330455705320026,49,59,57,61,53,40,40,22,319,62,381,16.27296587926509
21570,330455705320027,57,84,109,121,96,102,62,62,569,124,693,17.893217893217894
21571,330455705320028,126,115,141,101,120,107,63,78,710,141,851,16.56874265569918
21572,330455705320029,63,75,146,109,109,118,37,62,620,99,719,13.769123783031988
21573,330455705320030,49,59,91,99,87,98,63,86,483,149,632,23.575949367088608
21574,330455705320031,23,27,34,42,51,40,37,41,217,78,295,26.440677966101696
21575,330455705320032,21,39,48,52,46,58,34,47,264,81,345,23.47826086956522
21576,330455705320033,56,76,85,82,95,74,55,72,468,127,595,21.34453781512605
21577,330455705320034,115,147,128,173,144,122,78,81,829,159,988,16.09311740890688
21578,330455705320035,67,106,151,122,146,131,114,121,723,235,958,24.53027139874739
21579,330455705320036,34,40,43,65,52,54,42,54,288,96,384,25.0
21580,330455705320037,26,30,30,37,20,18,14,10,161,24,185,12.972972972972974
21581,330455705320038,126,155,119,153,102,79,51,22,734,73,807,9.045848822800496
21582,330455705320039,59,79,108,99,84,111,123,80,540,203,743,27.321668909825032
21583,330455705320040,125,139,138,120,113,47,28,11,682,39,721,5.4091539528432735
21584,330455705320041,58,84,98,87,83,97,100,62,507,162,669,24.2152466367713
21585,330455705320042,39,81,69,90,80,99,57,117,458,174,632,27.531645569620252
21586,330455705320043,58,82,81,109,87,93,63,112,510,175,685,25.547445255474454
21587,330455705320044,51,66,81,97,101,84,46,68,480,114,594,19.19191919191919
21588,330455705320045,30,63,56,54,65,61,40,66,329,106,435,24.367816091954023
21589,330455705320046,55,91,96,123,91,96,82,60,552,142,694,20.461095100864554
21590,330455705320047,61,89,93,68,65,28,21,13,404,34,438,7.762557077625571
21591,330455705320048,236,204,294,214,125,88,36,25,1161,61,1222,4.991816693944354
21592,330455705320049,68,90,105,125,109,104,63,54,601,117,718,16.295264623955433
21593,330455705320050,79,96,129,123,127,97,81,67,651,148,799,18.523153942428035
21594,330455705320051,54,74,94,81,95,92,65,70,490,135,625,21.6
21595,330455705320052,53,90,110,78,104,116,80,106,551,186,737,25.237449118046133
21596,330455705320053,45,81,91,98,92,112,74,77,519,151,670,22.53731343283582
21597,330455705320054,30,53,63,74,55,57,32,34,332,66,398,16.582914572864322
21598,330455705320055,52,98,77,83,85,93,58,60,488,118,606,19.471947194719473
21599,330455705320056,99,108,149,134,108,115,48,68,713,116,829,13.99276236429433
21600,330455705320057,69,79,97,78,81,106,65,54,510,119,629,18.91891891891892
21601,330455705320058,38,65,56,40,44,42,29,18,285,47,332,14.156626506024097
21602,330455705320059,110,127,113,104,89,69,52,24,612,76,688,11.046511627906977
21603,330455705320060,41,83,80,74,104,83,50,55,465,105,570,18.42105263157895
21604,330455705320061,68,96,84,112,115,87,86,92,562,178,740,24.054054054054053
21605,330455705320062,29,22,19,15,5,5,3,1,95,4,99,4.040404040404041
21606,330455705320063,79,83,150,102,88,125,69,63,627,132,759,17.391304347826086
21607,330455705320064,88,105,114,100,94,105,64,61,606,125,731,17.09986320109439
21608,330455705320065,18,22,15,11,25,14,4,9,105,13,118,11.016949152542374
21609,330455705320066,90,95,134,113,91,96,46,58,619,104,723,14.38450899031812
21610,330455705320067,108,109,124,99,105,84,71,44,629,115,744,15.456989247311828
21611,330455705320068,80,103,99,87,80,51,40,32,500,72,572,12.587412587412587
21612,330455705320069,74,107,74,81,79,53,45,25,468,70,538,13.011152416356877
21613,330455705320070,100,141,86,124,105,96,61,37,652,98,750,13.066666666666666
21614,330455705320071,84,132,126,113,137,67,52,55,659,107,766,13.968668407310705
21615,330455705320072,73,114,101,103,85,57,45,17,533,62,595,10.420168067226891
21616,330455705320073,73,115,136,104,112,103,58,45,643,103,746,13.806970509383378
21617,330455705320074,87,100,119,130,116,87,62,67,639,129,768,16.796875
21618,330455705320075,101,128,132,129,121,119,93,80,730,173,903,19.158361018826135
21619,330455705320076,143,155,176,196,143,150,81,87,963,168,1131,14.854111405835544
21620,330455705320077,95,86,131,98,95,133,87,84,638,171,809,21.137206427688504
21621,330455705320078,223,181,142,193,125,87,42,38,951,80,1031,7.759456838021339
21622,330455705320079,40,50,85,81,50,68,35,52,374,87,461,18.872017353579174
21623,330455705320080,30,57,79,67,67,84,76,55,384,131,515,25.436893203883496
21624,330455705320081,63,103,119,113,122,137,108,110,657,218,875,24.914285714285715
21625,330455705320082,76,95,122,103,125,79,90,83,600,173,773,22.38033635187581
21626,330455705320083,71,82,96,107,79,72,58,47,507,105,612,17.15686274509804
21627,330455705320084,74,90,103,112,100,66,69,61,545,130,675,19.25925925925926
21628,330455705320085,49,65,80,61,56,53,34,10,364,44,408,10.784313725490197
21629,330455705320086,114,134,149,133,144,126,103,111,800,214,1014,21.104536489151872
21630,330455705320087,51,70,58,64,77,65,40,48,385,88,473,18.6046511627907
21631,330455705320088,132,148,141,119,106,64,42,14,710,56,766,7.310704960835509
21632,330455705320089,77,97,170,127,65,52,21,5,588,26,614,4.234527687296417
21633,330455705320090,123,157,224,186,148,119,128,94,957,222,1179,18.829516539440203
21634,330455705320091,57,73,62,76,52,65,46,39,385,85,470,18.085106382978722
21635,330455705320092,66,77,101,114,91,101,75,69,550,144,694,20.7492795389049
21636,330455705320093,59,67,95,120,90,102,84,69,533,153,686,22.303206997084548
21637,330455705320094,45,46,89,107,74,83,80,41,444,121,565,21.41592920353982
21638,330455705320095,45,64,114,101,94,85,78,66,503,144,647,22.256568778979908
21639,330455705320096,54,95,102,91,114,113,75,71,569,146,715,20.41958041958042
21640,330455705320097,76,106,106,118,106,102,63,47,614,110,724,15.193370165745856
21641,330455705320098,43,81,87,80,82,81,75,70,454,145,599,24.207011686143574
21642,330455705320099,86,81,133,80,105,93,58,57,578,115,693,16.594516594516595
21643,330455705320100,40,59,53,81,58,68,52,54,359,106,465,22.795698924731184
21644,330455705320101,55,55,92,81,55,84,54,57,422,111,533,20.825515947467167
21645,330455705320102,49,70,116,65,72,94,65,54,466,119,585,20.34188034188034
21646,330455705320103,42,51,65,70,65,66,43,64,359,107,466,22.96137339055794
21647,330455705320104,56,95,100,100,88,87,75,88,526,163,689,23.657474600870827
21648,330455705320105,46,87,86,80,107,78,55,68,484,123,607,20.263591433278417
21649,330455705320106,76,93,101,124,87,74,82,56,555,138,693,19.913419913419915
21650,330455705320107,99,147,159,149,155,128,63,75,837,138,975,14.153846153846153
21651,330455705320108,79,98,117,103,91,74,32,28,562,60,622,9.646302250803858
21652,330455705320109,74,121,132,113,96,99,51,48,635,99,734,13.487738419618529
21653,330455705320110,89,123,110,118,104,101,77,58,645,135,780,17.307692307692307
21654,330455705320111,17,15,29,20,24,32,15,21,137,36,173,20.809248554913296
21655,330455705320112,86,82,110,86,82,82,40,20,528,60,588,10.204081632653061
21656,330455705320113,40,53,100,51,74,74,37,44,392,81,473,17.12473572938689
21657,330455705320114,45,52,75,70,56,69,47,47,367,94,461,20.390455531453362
21658,330455705320115,145,137,185,163,114,123,79,59,867,138,1005,13.73134328358209
21659,330455705320116,72,77,67,108,79,91,71,53,494,124,618,20.06472491909385
21660,330455705320117,168,187,182,168,89,69,47,27,863,74,937,7.897545357524013
21661,330455705320118,104,125,147,115,117,85,72,58,693,130,823,15.795868772782503
21662,330455705320119,101,148,156,143,120,73,28,41,741,69,810,8.518518518518519
21663,330455705320120,119,140,118,97,105,78,33,39,657,72,729,9.876543209876543
21664,330455705320121,280,344,133,222,186,109,42,48,1274,90,1364,6.5982404692082115
21665,330455705320122,69,79,120,85,79,79,55,64,511,119,630,18.88888888888889
21666,330455705320123,79,103,105,111,116,104,72,78,618,150,768,19.53125
21667,330455705320124,127,168,191,252,126,116,109,81,980,190,1170,16.23931623931624
21668,330455705320125,88,119,142,132,115,122,78,87,718,165,883,18.68629671574179
21669,330455705320126,69,97,99,99,88,97,61,80,549,141,690,20.434782608695652
21670,330455705320127,47,57,71,67,79,79,44,49,400,93,493,18.864097363083165
21671,330455705320128,93,124,84,71,65,60,33,30,497,63,560,11.25
21672,330455705320129,96,126,106,110,135,99,49,77,672,126,798,15.789473684210526
21673,330455705320130,121,176,172,165,145,142,108,82,921,190,1111,17.101710171017103
21674,330455705320131,239,246,258,233,210,116,76,59,1302,135,1437,9.394572025052192
21675,330455705320132,193,260,231,209,133,102,43,26,1128,69,1197,5.764411027568922
21676,330455705320133,53,71,89,103,89,84,53,67,489,120,609,19.704433497536947
21677,330455705320134,86,108,160,115,102,105,64,58,676,122,798,15.288220551378446
21678,330455705320135,120,104,152,102,104,62,47,42,644,89,733,12.141882673942701
21679,330455705320136,62,64,75,76,76,63,44,55,416,99,515,19.223300970873787
21680,330455705320137,94,82,151,159,91,103,86,72,680,158,838,18.85441527446301
21681,330455705320138,82,89,106,129,89,70,105,74,565,179,744,24.059139784946236
21682,330455705320139,94,95,172,137,117,82,58,53,697,111,808,13.737623762376238
21683,330455705320140,111,136,126,127,111,102,52,64,713,116,829,13.99276236429433
21684,330455705320141,79,73,104,68,69,57,38,41,450,79,529,14.93383742911153
21685,330455705320142,65,88,83,91,97,68,73,61,492,134,626,21.405750798722046
21686,330455705320143,74,74,101,82,71,75,42,34,477,76,553,13.743218806509946
21687,330455705320144,40,50,18,27,22,11,12,2,168,14,182,7.6923076923076925
21688,330455705320145,59,62,74,75,84,84,56,60,438,116,554,20.938628158844764
21689,330455705320146,33,42,46,35,32,35,7,5,223,12,235,5.1063829787234045
21690,330455705320147,109,93,89,55,50,34,18,12,430,30,460,6.521739130434782
21691,330455705320148,133,149,132,119,95,59,16,15,687,31,718,4.3175487465181055
21692,330455705320149,62,72,85,85,74,75,57,44,453,101,554,18.231046931407942
21693,330455705320150,60,75,97,90,97,106,45,38,525,83,608,13.651315789473685
21694,330455705320151,60,68,86,113,74,83,67,47,484,114,598,19.06354515050167
21695,330455705320152,56,86,89,107,89,103,83,36,530,119,649,18.335901386748844
21696,330455705320153,47,46,73,78,41,52,42,36,337,78,415,18.795180722891565
21697,330455705320154,64,77,91,93,105,63,46,27,493,73,566,12.897526501766784
21698,330455705320155,31,75,71,79,82,104,42,29,442,71,513,13.840155945419104
21699,330455705320156,86,155,159,142,99,108,57,37,749,94,843,11.150652431791222
21700,330455705320157,62,97,88,101,95,45,31,14,488,45,533,8.442776735459661
21701,330455705320158,170,184,135,123,96,53,32,26,761,58,819,7.0818070818070815
21702,330455705320159,75,75,103,114,62,94,69,35,523,104,627,16.586921850079744
21703,330455705320160,50,86,100,122,63,104,57,34,525,91,616,14.772727272727273
21704,330455705320161,56,80,101,106,74,98,51,37,515,88,603,14.593698175787727
21705,330455705320162,62,98,138,130,107,125,78,55,660,133,793,16.77175283732661
21706,330455705320163,27,32,61,60,41,37,40,40,258,80,338,23.668639053254438
21707,330455705320164,69,77,77,71,72,49,28,14,415,42,457,9.190371991247265
21708,330455705320165,48,74,95,90,68,74,62,40,449,102,551,18.511796733212343
21709,330455705320166,56,50,110,80,96,93,44,57,485,101,586,17.235494880546074
21710,330455705320167,29,51,56,55,58,44,36,48,293,84,377,22.281167108753316
21711,330455705320168,52,79,74,77,93,64,42,49,439,91,530,17.169811320754718
21712,330455705320169,62,64,76,104,80,73,41,38,459,79,538,14.684014869888475
21713,330455705320170,65,119,120,125,97,124,92,109,650,201,851,23.6192714453584
21714,330455705320171,29,21,26,32,20,28,14,5,156,19,175,10.857142857142858
21715,330455705320172,9,6,9,10,2,4,2,3,40,5,45,11.11111111111111
21716,330455705320173,33,64,67,40,62,69,46,33,335,79,414,19.082125603864736
21717,330455705320174,140,149,239,161,106,65,36,21,860,57,917,6.2159214830970555
21718,330455705320175,132,165,154,136,112,117,55,67,816,122,938,13.00639658848614
21719,330455705320176,63,71,76,75,93,61,34,55,439,89,528,16.856060606060606
21720,330455705320177,105,123,156,124,109,83,45,37,700,82,782,10.485933503836318
21721,330455705320178,53,56,65,63,61,51,29,18,349,47,396,11.868686868686869
21722,330455705320179,113,140,89,82,89,50,16,20,563,36,599,6.010016694490818
21723,330455705320180,163,165,99,103,78,53,21,14,661,35,696,5.028735632183908
21724,330455705320181,96,140,92,89,68,58,13,12,543,25,568,4.401408450704225
21725,330455705320182,80,86,109,91,62,56,45,18,484,63,547,11.517367458866545
21726,330455705320183,44,70,62,84,78,63,63,77,401,140,541,25.87800369685767
21727,330455705320184,56,56,81,73,61,71,37,23,398,60,458,13.100436681222707
21728,330455705320185,110,155,156,113,104,83,56,24,721,80,801,9.987515605493133
21729,330455705320186,131,146,160,100,102,75,67,41,714,108,822,13.138686131386862
21730,330455705320187,56,77,66,54,55,54,25,30,362,55,417,13.189448441247002
21731,330455705320188,51,53,66,77,79,59,42,69,385,111,496,22.379032258064516
21732,330455705320189,51,60,72,89,61,47,39,64,380,103,483,21.32505175983437
21733,330455705320190,59,83,93,100,110,73,94,57,518,151,669,22.57100149476831
21734,330455705320191,144,148,231,263,160,168,64,36,1114,100,1214,8.237232289950576
21735,330455705320192,67,98,102,95,95,77,56,59,534,115,649,17.719568567026194
21736,330455705320193,37,60,70,63,67,53,46,67,350,113,463,24.406047516198704
21737,330455705320194,48,60,72,81,77,72,50,44,410,94,504,18.650793650793652
21738,330455705320195,130,157,110,123,71,60,30,13,651,43,694,6.195965417867435
21739,330455705320196,54,69,57,59,64,51,37,30,354,67,421,15.914489311163896
21740,330455705320197,211,197,185,186,115,65,34,12,959,46,1005,4.577114427860696
21741,330455705320198,133,135,86,91,65,35,13,6,545,19,564,3.368794326241135
21742,330455705320199,23,38,31,42,40,28,22,14,202,36,238,15.126050420168067
21743,330455705320200,34,57,64,74,62,56,35,16,347,51,398,12.814070351758794
21744,330455705320201,113,65,110,100,34,19,3,3,441,6,447,1.342281879194631
21745,330455705320202,118,100,114,80,65,55,20,11,532,31,563,5.506216696269982
21746,330455705320203,33,52,27,48,33,39,25,24,232,49,281,17.437722419928825
21747,330455705320204,18,28,31,18,22,14,10,3,131,13,144,9.027777777777779
21748,330455705320207,401,235,225,213,105,60,20,8,1239,28,1267,2.2099447513812156
21749,330455705320208,459,343,187,289,144,87,25,9,1509,34,1543,2.20349967595593
21750,330455705320209,423,283,181,232,128,50,19,5,1297,24,1321,1.8168054504163513
21751,330455705330001,64,86,77,83,66,47,16,25,423,41,464,8.836206896551724
21752,330455705330002,77,88,117,99,79,42,14,11,502,25,527,4.743833017077799
21753,330455705330003,65,96,152,116,97,54,24,15,580,39,619,6.30048465266559
21754,330455705330004,83,119,155,161,95,46,29,24,659,53,712,7.443820224719101
21755,330455705330005,101,87,122,159,87,74,29,9,630,38,668,5.688622754491018
21756,330455705330006,128,138,206,191,102,75,46,14,840,60,900,6.666666666666667
21757,330455705330007,93,83,132,126,69,42,25,17,545,42,587,7.155025553662692
21758,330455705330008,152,177,244,202,134,106,50,30,1015,80,1095,7.30593607305936
21759,330455705330009,126,133,227,216,152,79,33,26,933,59,992,5.94758064516129
21760,330455705330010,132,122,202,144,91,62,41,15,753,56,809,6.9221260815822
21761,330455705330011,103,106,152,124,90,82,27,28,657,55,712,7.724719101123595
21762,330455705330012,34,40,133,96,38,33,22,8,374,30,404,7.425742574257426
21763,330455705330013,136,153,172,155,106,66,38,12,788,50,838,5.966587112171838
21764,330455705330014,209,163,216,162,96,80,29,22,926,51,977,5.220061412487206
21765,330455705330015,242,250,328,257,162,112,49,42,1351,91,1442,6.310679611650485
21766,330455705330016,14,15,30,24,29,13,8,4,125,12,137,8.75912408759124
21767,330455705330017,84,89,121,73,74,42,19,15,483,34,517,6.576402321083172
21768,330455705330018,98,117,143,86,58,38,18,8,540,26,566,4.593639575971731
21769,330455705330019,180,169,344,179,109,75,39,31,1056,70,1126,6.216696269982238
21770,330455705330020,182,197,422,311,138,130,57,38,1380,95,1475,6.440677966101695
21771,330455705330021,144,137,189,147,92,59,34,22,768,56,824,6.796116504854369
21772,330455705330022,135,139,190,148,87,65,26,14,764,40,804,4.975124378109452
21773,330455705330023,137,119,213,183,111,99,50,32,862,82,944,8.686440677966102
21774,330455705330024,115,107,140,120,89,57,34,22,628,56,684,8.187134502923977
21775,330455705330025,133,138,216,164,112,100,64,45,863,109,972,11.213991769547325
21776,330455705330026,182,171,246,147,105,85,35,20,936,55,991,5.549949545913219
21777,330455705330027,226,235,257,209,128,111,54,23,1166,77,1243,6.1946902654867255
21778,330455705330028,99,116,208,129,105,61,36,29,718,65,783,8.301404853128991
21779,330455705330029,129,88,187,141,60,51,25,4,656,29,685,4.233576642335766
21780,330455705330030,319,337,510,380,264,110,35,4,1920,39,1959,1.9908116385911179
21781,330455705330031,278,293,402,281,177,100,38,7,1531,45,1576,2.8553299492385786
21782,330455705330032,135,209,262,177,128,49,25,6,960,31,991,3.1281533804238144
21783,330455705330033,174,180,259,198,109,46,21,4,966,25,991,2.522704339051463
21784,330455705330034,93,95,126,83,48,17,7,1,462,8,470,1.702127659574468
21785,330455705330035,176,207,270,200,137,72,20,6,1062,26,1088,2.389705882352941
21786,330455705330036,73,66,134,89,50,46,21,1,458,22,480,4.583333333333333
21787,330455705330037,158,170,225,167,125,85,50,26,930,76,1006,7.5546719681908545
21788,330455705330038,34,58,65,63,26,26,15,4,272,19,291,6.529209621993127
21789,330455705330039,123,104,165,112,75,63,13,4,642,17,659,2.579666160849772
21790,330455705330040,110,120,146,103,68,43,15,5,590,20,610,3.278688524590164
21791,330455705330041,200,183,261,227,124,90,46,17,1085,63,1148,5.487804878048781
21792,330455705330042,226,222,279,225,132,90,33,15,1174,48,1222,3.927986906710311
21793,330455705330043,180,188,314,265,180,112,54,50,1239,104,1343,7.743857036485481
21794,330455705330044,94,101,113,100,89,64,27,22,561,49,610,8.032786885245901
21795,330455705330045,140,163,173,183,140,76,44,17,875,61,936,6.517094017094017
21796,330455705330046,149,114,268,191,102,63,41,18,887,59,946,6.236786469344609
21797,330455705330047,135,158,192,146,123,73,25,14,827,39,866,4.503464203233256
21798,330455705330048,100,103,145,96,65,48,13,9,557,22,579,3.7996545768566494
21799,330455705330049,46,47,47,29,35,21,22,8,225,30,255,11.764705882352942
21800,330455705330050,141,154,154,135,119,75,40,27,778,67,845,7.928994082840236
21801,330455705330051,79,86,115,112,81,60,30,17,533,47,580,8.10344827586207
21802,330455705330052,105,104,104,67,70,42,15,5,492,20,512,3.90625
21803,330455705330053,177,225,259,243,130,99,49,22,1133,71,1204,5.897009966777409
21804,330455705330054,132,137,164,130,98,66,32,15,727,47,774,6.072351421188631
21805,330455705330055,129,121,159,111,88,88,34,16,696,50,746,6.702412868632708
21806,330455705330056,307,284,279,246,160,69,35,14,1345,49,1394,3.51506456241033
21807,330455705330057,309,288,319,267,189,124,61,30,1496,91,1587,5.73408947700063
21808,330455705330058,112,131,128,131,81,56,21,18,639,39,678,5.752212389380531
21809,330455705330059,47,55,54,43,44,23,20,8,266,28,294,9.523809523809524
21810,330455705330060,91,108,92,110,78,46,22,22,525,44,569,7.73286467486819
21811,330455705330061,125,154,173,165,115,77,51,17,809,68,877,7.753705815279361
21812,330455705330062,255,228,329,283,199,117,38,29,1411,67,1478,4.533152909336942
21813,330455705330063,465,418,580,449,270,153,77,30,2335,107,2442,4.381654381654382
21814,330455705330064,108,144,196,141,120,59,25,14,768,39,807,4.83271375464684
21815,330455705330065,133,163,157,164,107,78,35,19,802,54,856,6.308411214953271
21816,330455705330066,218,274,265,194,151,113,50,35,1215,85,1300,6.538461538461538
21817,330455705330067,75,103,100,70,58,38,21,9,444,30,474,6.329113924050633
21818,330455705330068,165,161,152,127,75,39,15,7,719,22,741,2.968960863697706
21819,330455705330069,234,233,179,159,91,46,40,12,942,52,994,5.231388329979879
21820,330455705330070,104,107,128,101,79,51,26,14,570,40,610,6.557377049180328
21821,330455705330071,232,249,330,315,190,65,30,22,1381,52,1433,3.628750872295883
21822,330455705330072,168,224,305,225,144,109,65,23,1175,88,1263,6.967537608867775
21823,330455705330073,197,202,304,206,98,69,25,8,1076,33,1109,2.975653742110009
21824,330455705330074,89,90,126,102,68,28,10,5,503,15,518,2.8957528957528957
21825,330455705330075,148,154,217,163,123,79,38,12,884,50,934,5.353319057815845
21826,330455705330076,44,56,63,57,45,30,14,11,295,25,320,7.8125
21827,330455705330077,135,171,180,168,119,81,33,26,854,59,913,6.4622124863088715
21828,330455705330078,62,73,112,97,62,46,20,9,452,29,481,6.029106029106029
21829,330455705330079,168,148,202,176,88,84,33,6,866,39,905,4.30939226519337
21830,330455705330080,49,35,30,35,17,14,12,3,180,15,195,7.6923076923076925
21831,330455705340001,172,229,227,235,163,129,78,52,1155,130,1285,10.116731517509727
21832,330455705340002,117,159,171,107,85,74,43,29,713,72,785,9.171974522292993
21833,330455705340003,151,201,192,167,119,100,56,43,930,99,1029,9.620991253644315
21834,330455705340004,86,80,84,46,66,41,22,17,403,39,442,8.823529411764707
21835,330455705340005,93,117,106,95,90,42,22,19,543,41,584,7.02054794520548
21836,330455705340006,124,194,145,85,134,103,39,16,785,55,840,6.5476190476190474
21837,330455705340007,167,160,156,125,102,77,47,26,787,73,860,8.488372093023257
21838,330455705340008,98,105,133,115,81,66,35,24,598,59,657,8.980213089802131
21839,330455705340009,77,287,395,341,458,257,116,15,1815,131,1946,6.731757451181911
21840,330455705340010,253,254,347,312,110,87,49,11,1363,60,1423,4.2164441321152495
21841,330455705340011,145,240,204,280,151,81,53,33,1101,86,1187,7.245155855096883
21842,330455705340012,122,132,168,111,103,82,42,34,718,76,794,9.571788413098236
21843,330455705340013,228,170,210,221,125,85,35,15,1039,50,1089,4.591368227731864
21844,330455705340014,84,128,127,97,56,53,26,25,545,51,596,8.557046979865772
21845,330455705340015,127,151,151,137,107,85,45,39,758,84,842,9.97624703087886
21846,330455705340016,93,131,113,103,69,81,37,20,590,57,647,8.809891808346213
21847,330455705340017,61,60,60,46,42,26,22,23,295,45,340,13.235294117647058
21848,330455705340018,95,115,98,100,73,67,36,22,548,58,606,9.570957095709572
21849,330455705340019,127,130,120,124,67,84,42,31,652,73,725,10.068965517241379
21850,330455705340020,105,135,139,114,81,92,35,22,666,57,723,7.8838174273858925
21851,330455705340021,143,147,138,98,95,65,36,37,686,73,759,9.617918313570488
21852,330455705340022,90,96,118,106,60,46,23,3,516,26,542,4.797047970479705
21853,330455705340023,151,179,147,130,94,59,42,21,760,63,823,7.654921020656136
21854,330455705340024,109,126,140,109,89,73,62,41,646,103,749,13.751668891855807
21855,330455705340025,86,87,100,76,62,33,26,21,444,47,491,9.572301425661914
21856,330455705340026,105,114,96,80,63,45,23,19,503,42,545,7.706422018348624
21857,330455705340027,126,141,180,153,130,94,54,42,824,96,920,10.434782608695652
21858,330455705340028,86,135,145,80,105,86,41,29,637,70,707,9.900990099009901
21859,330455705340029,177,175,234,187,141,114,71,50,1028,121,1149,10.530896431679722
21860,330455705340030,139,158,182,158,115,80,59,33,832,92,924,9.956709956709958
21861,330455705340031,80,91,127,104,73,42,23,23,517,46,563,8.170515097690942
21862,330455705340032,77,89,152,106,94,81,44,34,599,78,677,11.521418020679468
21863,330455705340033,54,75,84,74,67,41,25,25,395,50,445,11.235955056179776
21864,330455705340034,93,88,94,92,57,55,24,12,479,36,515,6.990291262135922
21865,330455705340035,88,107,135,114,62,57,36,13,563,49,612,8.006535947712418
21866,330455705340036,98,109,116,71,50,32,20,7,476,27,503,5.36779324055666
21867,330455705340037,218,199,290,204,132,92,53,13,1135,66,1201,5.495420482930891
21868,330455705340038,75,111,93,103,96,67,54,53,545,107,652,16.411042944785276
21869,330455705340039,73,81,111,92,123,70,43,50,550,93,643,14.463452566096423
21870,330455705340040,83,117,109,144,88,78,55,42,619,97,716,13.547486033519553
21871,330455705340041,147,147,142,117,110,72,22,11,735,33,768,4.296875
21872,330455705340042,20,16,24,16,11,10,3,2,97,5,102,4.901960784313726
21873,330455705340043,151,145,207,147,95,88,37,19,833,56,889,6.299212598425197
21874,330455705340044,68,61,91,56,45,40,28,7,361,35,396,8.83838383838384
21875,330455705340045,38,43,52,30,34,11,13,0,208,13,221,5.882352941176471
21876,330455705340046,123,126,140,125,85,98,59,40,697,99,796,12.43718592964824
21877,330455705340047,60,77,86,68,47,39,17,11,377,28,405,6.91358024691358
21878,330455705340048,92,72,59,83,63,41,24,23,410,47,457,10.284463894967177
21879,330455705340049,57,68,71,92,67,43,29,25,398,54,452,11.946902654867257
21880,330455705340050,106,108,152,127,91,73,32,16,657,48,705,6.808510638297872
21881,330455705340051,121,137,119,118,94,63,36,20,652,56,708,7.909604519774011
21882,330455705340052,42,65,87,52,58,53,28,19,357,47,404,11.633663366336634
21883,330455705350001,119,155,165,120,95,63,29,19,717,48,765,6.2745098039215685
21884,330455705350002,124,147,151,141,93,73,39,27,729,66,795,8.30188679245283
21885,330455705350003,211,230,199,201,132,89,64,45,1062,109,1171,9.308283518360376
21886,330455705350004,197,178,186,272,181,77,34,25,1091,59,1150,5.130434782608695
21887,330455705350005,297,363,353,293,211,102,98,43,1619,141,1760,8.011363636363637
21888,330455705350006,129,148,167,147,102,98,46,31,791,77,868,8.870967741935484
21889,330455705350007,144,155,129,167,80,78,61,23,753,84,837,10.03584229390681
21890,330455705350008,131,144,153,102,90,43,32,20,663,52,715,7.2727272727272725
21891,330455705350009,127,147,225,180,100,68,37,27,847,64,911,7.025246981339188
21892,330455705350010,144,190,230,148,89,73,36,21,874,57,931,6.122448979591836
21893,330455705350011,56,77,82,64,52,61,30,26,392,56,448,12.5
21894,330455705350012,82,96,106,102,70,51,38,13,507,51,558,9.13978494623656
21895,330455705350013,79,83,102,103,74,50,33,27,491,60,551,10.88929219600726
21896,330455705350014,160,158,140,109,93,46,35,13,706,48,754,6.36604774535809
21897,330455705350015,138,169,248,190,153,169,94,57,1067,151,1218,12.397372742200329
21898,330455705350016,164,194,263,172,162,115,64,25,1070,89,1159,7.679033649698016
21899,330455705350017,87,94,130,105,128,83,69,60,627,129,756,17.063492063492063
21900,330455705350018,106,145,148,139,159,147,102,100,844,202,1046,19.311663479923517
21901,330455705350019,244,239,354,352,238,174,110,74,1601,184,1785,10.30812324929972
21902,330455705350020,50,51,77,57,41,46,31,21,322,52,374,13.903743315508022
21903,330455705350021,263,299,271,239,209,118,70,42,1399,112,1511,7.412309728656519
21904,330455705350022,169,196,200,184,132,69,60,28,950,88,1038,8.477842003853565
21905,330455705350023,192,253,210,213,159,107,32,30,1134,62,1196,5.183946488294314
21906,330455705350024,103,114,112,65,66,36,20,10,496,30,526,5.7034220532319395
21907,330455705350025,189,185,196,169,119,85,70,21,943,91,1034,8.800773694390715
21908,330455705350026,105,119,110,112,82,51,26,16,579,42,621,6.763285024154589
21909,330455705350027,96,98,103,104,74,46,33,8,521,41,562,7.295373665480427
21910,330455705350028,66,96,105,80,88,39,22,15,474,37,511,7.240704500978474
21911,330455705350029,143,160,137,129,91,68,43,18,728,61,789,7.731305449936628
21912,330455705350030,57,65,89,64,55,38,27,17,368,44,412,10.679611650485437
21913,330455705350031,104,124,180,135,135,124,71,74,802,145,947,15.311510031678987
21914,330455705350032,256,260,297,225,234,113,80,71,1385,151,1536,9.830729166666666
21915,330455705350033,67,108,122,103,86,84,69,54,570,123,693,17.748917748917748
21916,330455705350034,111,132,158,125,128,95,57,47,749,104,853,12.192262602579133
21917,330455705350035,151,111,161,149,87,51,25,9,710,34,744,4.56989247311828
21918,330455705350036,132,127,127,146,102,50,35,20,684,55,739,7.442489851150203
21919,330455705350037,143,184,145,120,100,93,53,24,785,77,862,8.932714617169374
21920,330455705350038,96,119,136,102,78,55,30,24,586,54,640,8.4375
21921,330455705350039,182,188,157,139,76,68,28,13,810,41,851,4.81786133960047
21922,330455705350040,207,198,189,186,142,95,39,22,1017,61,1078,5.658627087198516
21923,330455705350041,179,192,165,129,116,65,36,26,846,62,908,6.828193832599119
21924,330455705350042,207,176,199,171,105,80,38,30,938,68,1006,6.759443339960239
21925,330455705350043,101,97,75,71,36,17,15,7,397,22,419,5.250596658711217
21926,330455705350044,73,75,81,72,35,24,14,11,360,25,385,6.4935064935064934
21927,330455705350045,33,34,26,22,19,18,6,4,152,10,162,6.172839506172839
21928,330455705350046,37,36,30,25,24,23,7,10,175,17,192,8.854166666666666
21929,330455705350047,95,110,102,85,81,51,30,18,524,48,572,8.391608391608392
21930,330455705350048,139,150,164,151,96,52,41,25,752,66,818,8.06845965770171
21931,330455705350049,40,69,77,54,49,43,29,18,332,47,379,12.401055408970976
21932,330455705350050,162,210,186,164,126,94,86,39,942,125,1067,11.715089034676664
21933,330455705350051,135,135,190,127,139,75,42,41,801,83,884,9.389140271493213
21934,330455705350052,125,191,191,253,163,117,60,19,1040,79,1119,7.059874888293119
21935,330455705350053,168,176,160,185,139,78,32,29,906,61,967,6.308169596690797
21936,330455705350054,133,121,137,139,90,59,39,16,679,55,734,7.493188010899183
21937,330455705350055,469,486,567,492,478,167,100,15,2659,115,2774,4.14563806777217
21938,330455705350056,243,283,320,260,173,131,64,30,1410,94,1504,6.25
21939,330455705350057,157,184,229,134,118,88,21,25,910,46,956,4.811715481171548
21940,330455705350058,249,250,243,176,148,72,32,7,1138,39,1177,3.3135089209855564
21941,330455705350059,327,404,329,277,208,120,55,23,1665,78,1743,4.475043029259897
21942,330455705350060,168,196,170,140,90,41,28,18,805,46,851,5.405405405405405
21943,330455705350061,190,238,216,156,108,49,50,14,957,64,1021,6.268364348677767
21944,330455705350062,123,118,96,84,40,42,26,6,503,32,535,5.981308411214953
21945,330455705350063,80,88,67,65,34,18,15,12,352,27,379,7.124010554089709
21946,330455705350064,148,146,126,101,81,35,15,7,637,22,659,3.338391502276176
21947,330455705350065,36,27,24,15,8,6,5,4,116,9,125,7.2
21948,330455705350066,213,169,150,134,82,68,23,22,816,45,861,5.2264808362369335
21949,330455705350067,32,67,42,48,53,26,22,13,268,35,303,11.551155115511552
21950,330455705350068,117,135,128,124,91,52,36,27,647,63,710,8.873239436619718
21951,330455705350069,137,167,247,172,149,105,81,45,977,126,1103,11.4233907524932
21952,330455705350070,35,44,46,39,40,28,23,24,232,47,279,16.845878136200717
21953,330455705350071,66,71,73,43,53,27,27,9,333,36,369,9.75609756097561
21954,330455705350072,27,43,54,40,25,25,14,4,214,18,232,7.758620689655173
21955,330455705350073,64,68,56,45,27,27,18,10,287,28,315,8.88888888888889
21956,330455705350074,53,67,36,39,22,12,18,3,229,21,250,8.4
21957,330455705350075,109,109,96,75,57,59,37,14,505,51,556,9.172661870503598
21958,330455705350076,230,218,329,240,167,121,55,26,1305,81,1386,5.8441558441558445
21959,330455705350077,204,243,219,196,143,144,71,33,1149,104,1253,8.300079808459696
21960,330455705350078,107,201,249,265,160,73,30,15,1055,45,1100,4.090909090909091
21961,330455705350079,20,17,10,5,9,3,0,1,64,1,65,1.5384615384615385
21962,330455705350080,170,186,199,157,96,93,42,33,901,75,976,7.684426229508197
21963,330455705350081,204,222,181,155,113,81,50,39,956,89,1045,8.516746411483254
21964,330455705350082,31,26,38,25,31,13,8,6,164,14,178,7.865168539325842
21965,330455705350083,126,193,167,165,127,110,55,39,888,94,982,9.572301425661914
21966,330455705350084,18,23,31,17,25,20,4,11,134,15,149,10.06711409395973
21967,330455705360001,97,83,117,81,82,43,28,22,503,50,553,9.041591320072333
21968,330455705360002,140,162,156,162,106,59,30,34,785,64,849,7.538280329799765
21969,330455705360003,142,205,163,207,132,79,44,33,928,77,1005,7.661691542288557
21970,330455705360004,172,195,235,162,143,83,43,18,990,61,1051,5.803996194100856
21971,330455705360005,42,62,51,43,36,19,9,7,253,16,269,5.947955390334572
21972,330455705360006,79,83,92,69,58,31,12,11,412,23,435,5.287356321839081
21973,330455705360007,95,88,89,82,65,42,21,11,461,32,493,6.490872210953347
21974,330455705360008,116,129,124,114,83,59,36,23,625,59,684,8.625730994152047
21975,330455705360009,104,106,144,137,90,67,34,35,648,69,717,9.623430962343097
21976,330455705360010,147,123,200,180,116,108,59,52,874,111,985,11.269035532994923
21977,330455705360011,85,84,94,78,86,51,24,34,478,58,536,10.82089552238806
21978,330455705360012,107,117,112,91,81,51,35,27,559,62,621,9.98389694041868
21979,330455705360013,89,71,76,61,32,39,17,15,368,32,400,8.0
21980,330455705360014,38,61,30,48,60,18,18,14,255,32,287,11.149825783972126
21981,330455705360015,134,130,149,139,80,60,32,28,692,60,752,7.9787234042553195
21982,330455705360016,120,109,108,94,79,45,21,17,555,38,593,6.408094435075886
21983,330455705360017,14,27,24,26,17,9,14,2,117,16,133,12.030075187969924
21984,330455705360018,206,236,229,201,156,86,55,45,1114,100,1214,8.237232289950576
21985,330455705360019,122,141,153,118,93,47,40,20,674,60,734,8.174386920980927
21986,330455705360020,88,99,107,63,76,41,23,12,474,35,509,6.8762278978389
21987,330455705360021,169,197,168,158,129,58,25,15,879,40,919,4.352557127312296
21988,330455705360022,162,183,177,160,114,94,29,25,890,54,944,5.720338983050848
21989,330455705360023,203,214,215,218,122,77,56,32,1049,88,1137,7.739665787159191
21990,330455705360024,174,197,192,124,122,46,28,25,855,53,908,5.8370044052863435
21991,330455705360025,136,124,138,158,93,72,35,22,721,57,778,7.326478149100257
21992,330455705360026,111,108,122,107,83,61,35,23,592,58,650,8.923076923076923
21993,330455705360027,74,61,97,74,70,49,33,23,425,56,481,11.642411642411643
21994,330455705360028,136,141,210,185,115,77,45,26,864,71,935,7.593582887700535
21995,330455705360029,54,61,63,66,26,21,11,6,291,17,308,5.51948051948052
21996,330455705360030,54,56,53,66,32,21,17,14,282,31,313,9.904153354632587
21997,330455705360031,98,103,123,96,62,53,26,10,535,36,571,6.304728546409807
21998,330455705360032,133,156,147,149,115,55,39,22,755,61,816,7.4754901960784315
21999,330455705360033,170,223,219,195,165,101,53,31,1073,84,1157,7.260155574762316
22000,330455705360034,89,85,93,82,57,44,27,13,450,40,490,8.16326530612245
22001,330455705360036,128,124,211,153,113,56,32,20,785,52,837,6.212664277180406
22002,330455705360037,3,13,16,14,13,7,7,6,66,13,79,16.455696202531644
22003,330455705360038,114,117,137,126,97,75,34,35,666,69,735,9.387755102040817
22004,330455705360039,273,312,222,183,144,92,44,18,1226,62,1288,4.813664596273292
22005,330455705360040,85,108,125,93,63,38,18,22,512,40,552,7.246376811594203
22006,330455705360041,118,113,120,124,79,63,26,18,617,44,661,6.656580937972769
22007,330455705360042,78,90,117,87,69,52,25,23,493,48,541,8.872458410351202
22008,330455705360043,32,50,62,40,48,25,19,13,257,32,289,11.07266435986159
22009,330455705360044,63,67,103,98,73,56,26,17,460,43,503,8.548707753479125
22010,330455705360045,92,92,162,112,92,78,37,16,628,53,681,7.782672540381792
22011,330455705360046,30,26,34,39,26,14,4,14,169,18,187,9.62566844919786
22012,330455705360047,172,164,217,234,140,63,44,27,990,71,1061,6.691800188501413
22013,330455705360048,114,116,133,127,77,56,27,18,623,45,668,6.736526946107785
22014,330455705360049,66,92,79,74,56,59,25,31,426,56,482,11.618257261410788
22015,330455705360050,224,258,186,123,111,58,20,8,960,28,988,2.834008097165992
22016,330455705360051,184,238,160,133,84,58,23,18,857,41,898,4.565701559020044
22017,330455705360052,86,120,114,96,104,77,42,45,597,87,684,12.719298245614034
22018,330455705360053,51,71,76,67,62,53,34,29,380,63,443,14.221218961625283
22019,330455705360054,82,67,93,53,63,45,20,22,403,42,445,9.438202247191011
22020,330455705360055,71,94,124,103,80,60,31,18,532,49,581,8.433734939759036
22021,330455705360056,74,71,119,110,86,68,34,19,528,53,581,9.122203098106713
22022,330455705360057,88,108,162,136,111,72,40,38,677,78,755,10.331125827814569
22023,330455705360058,78,62,100,68,58,26,18,14,392,32,424,7.547169811320755
22024,330455705360059,98,112,130,118,81,63,20,24,602,44,646,6.811145510835913
22025,330455705360060,83,102,134,86,91,58,27,20,554,47,601,7.820299500831947
22026,330455705360061,79,81,93,76,62,45,29,19,436,48,484,9.917355371900827
22027,330455705360062,63,79,83,77,59,56,26,21,417,47,464,10.129310344827585
22028,330455705360063,54,54,71,59,55,46,30,34,339,64,403,15.88089330024814
22029,330455705360064,208,231,250,207,178,140,65,54,1214,119,1333,8.927231807951989
22030,330455705360065,63,73,78,72,74,47,32,29,407,61,468,13.034188034188034
22031,330455705360066,304,441,308,314,366,182,50,20,1915,70,1985,3.526448362720403
22032,330455705360067,175,170,149,161,123,67,42,26,845,68,913,7.447973713033954
22033,330455705360068,116,119,103,113,114,62,27,28,627,55,682,8.064516129032258
22034,330455705360069,63,70,121,114,96,92,39,43,556,82,638,12.852664576802507
22035,330455705360070,53,63,80,89,50,49,20,20,384,40,424,9.433962264150944
22036,330455705360071,67,63,130,126,105,65,41,31,556,72,628,11.464968152866241
22037,330455705360072,139,130,169,151,85,74,50,20,748,70,818,8.557457212713937
22038,330455705360073,65,65,102,83,58,50,24,12,423,36,459,7.8431372549019605
22039,330455705360074,43,36,68,41,32,9,12,0,229,12,241,4.979253112033195
22040,330455705360075,64,64,90,63,52,31,19,18,364,37,401,9.226932668329177
22041,330455705360076,158,165,192,159,104,97,32,34,875,66,941,7.0138150903294365
22042,330455705360077,147,168,181,163,106,79,49,15,844,64,908,7.048458149779735
22043,330455705360078,102,107,109,101,81,59,37,21,559,58,617,9.40032414910859
22044,330455705360079,110,113,130,106,109,76,32,21,644,53,697,7.604017216642755
22045,330455705360080,97,87,115,125,62,59,26,15,545,41,586,6.996587030716723
22046,330455705360081,89,86,134,112,76,60,33,10,557,43,600,7.166666666666667
22047,330455705360082,148,162,205,178,100,76,35,19,869,54,923,5.850487540628386
22048,330455705360083,128,147,216,169,84,75,41,16,819,57,876,6.506849315068493
22049,330455705360084,138,144,169,160,119,62,27,15,792,42,834,5.0359712230215825
22050,330455705360085,136,186,244,199,114,97,49,15,976,64,1040,6.153846153846154
22051,330455705360086,119,132,111,111,89,61,25,17,623,42,665,6.315789473684211
22052,330455705360087,121,141,144,115,79,65,31,24,665,55,720,7.638888888888889
22053,330455705360088,73,99,61,63,38,25,17,5,359,22,381,5.774278215223097
22054,330455705360089,173,204,186,176,145,95,48,57,979,105,1084,9.686346863468634
22055,330455705360090,46,47,50,37,28,18,5,10,226,15,241,6.224066390041494
22056,330455705360091,475,510,538,475,314,187,57,29,2499,86,2585,3.3268858800773695
22057,330455705360092,293,355,345,291,184,106,40,21,1574,61,1635,3.7308868501529053
22058,330455705360093,245,286,249,254,157,101,48,26,1292,74,1366,5.417276720351391
22059,330455705360094,282,323,213,278,168,69,33,21,1333,54,1387,3.8932948810382118
22060,330455705360095,320,343,267,277,190,105,43,23,1502,66,1568,4.209183673469388
22061,330455705360096,191,243,150,152,121,70,23,20,927,43,970,4.43298969072165
22062,330455705360097,166,214,197,177,149,99,54,29,1002,83,1085,7.649769585253456
22063,330455705360098,53,80,61,62,40,23,10,3,319,13,332,3.9156626506024095
22064,330455705360099,113,81,131,98,68,47,27,22,538,49,587,8.347529812606474
22065,330455705360100,94,112,133,109,96,57,28,15,601,43,644,6.6770186335403725
22066,330455705360101,99,127,119,138,90,89,42,26,662,68,730,9.315068493150685
22067,330455705360102,231,190,337,225,161,88,38,15,1232,53,1285,4.124513618677042
22068,330455705360103,187,190,310,252,139,99,38,10,1177,48,1225,3.9183673469387754
22069,330455705360104,151,155,252,180,106,86,34,18,930,52,982,5.295315682281059
22070,330455705360105,102,158,154,99,117,66,33,40,696,73,769,9.492847854356308
22071,330455705360106,95,147,107,109,79,63,33,26,600,59,659,8.952959028831563
22072,330455705360107,192,253,182,218,121,75,38,26,1041,64,1105,5.791855203619909
22073,330455705360108,119,124,130,100,102,50,26,11,625,37,662,5.589123867069486
22074,330455705360109,173,134,166,137,94,62,38,24,766,62,828,7.48792270531401
22075,330455705360110,131,133,173,150,90,56,29,25,733,54,787,6.861499364675985
22076,330455705360111,153,154,156,140,120,71,59,25,794,84,878,9.567198177676538
22077,330455705360112,127,143,174,144,117,88,43,24,793,67,860,7.790697674418604
22078,330455705360113,387,396,538,447,271,140,63,39,2179,102,2281,4.471722928540114
22079,330455705360114,154,170,210,155,95,82,29,16,866,45,911,4.939626783754116
22080,330455705360115,168,148,216,195,110,68,36,23,905,59,964,6.1203319502074685
22081,330455705360116,226,227,258,222,125,87,52,20,1145,72,1217,5.916187345932621
22082,330455705360117,116,111,105,107,67,44,29,17,550,46,596,7.718120805369128
22083,330455705360118,94,86,98,97,67,43,41,21,485,62,547,11.3345521023766
22084,330455705360119,132,163,90,117,85,42,14,8,629,22,651,3.3794162826420893
22085,330455705360120,8,5,12,9,5,1,0,0,40,0,40,0.0
22086,330455705360121,55,48,56,81,53,47,12,8,340,20,360,5.555555555555555
22087,330455705360122,127,158,179,179,106,113,38,35,862,73,935,7.807486631016043
22088,330455705360123,106,103,163,128,92,97,37,16,689,53,742,7.142857142857143
22089,330455705360124,89,85,119,120,100,68,25,11,581,36,617,5.834683954619125
22090,330455705360125,79,92,103,92,64,78,34,12,508,46,554,8.303249097472925
22091,330455705360126,50,59,82,89,68,44,23,13,392,36,428,8.411214953271028
22092,330455705360127,84,70,104,90,82,32,17,7,462,24,486,4.938271604938271
22093,330455705360128,116,84,145,110,46,34,15,8,535,23,558,4.121863799283154
22094,330455705360129,31,56,61,59,41,25,23,3,273,26,299,8.695652173913043
22095,330455705360130,119,128,137,96,88,43,29,25,611,54,665,8.1203007518797
22096,330455705360131,39,33,58,28,24,30,9,6,212,15,227,6.607929515418502
22097,330455705360132,155,245,210,256,144,58,36,7,1068,43,1111,3.8703870387038704
22098,330455705360133,486,474,708,640,326,171,50,17,2805,67,2872,2.332869080779944
22099,330455705360134,127,101,126,120,62,48,26,13,584,39,623,6.260032102728732
22100,330455705360135,112,135,117,104,84,43,25,12,595,37,632,5.8544303797468356
22101,330455705360136,69,98,83,88,69,33,19,13,440,32,472,6.779661016949152
22102,330455705360137,124,124,130,109,97,70,27,32,654,59,713,8.274894810659186
22103,330455705360138,41,40,70,58,37,31,25,10,277,35,312,11.217948717948717
22104,330455705360139,115,122,149,113,93,68,33,25,660,58,718,8.07799442896936
22105,330455705360140,186,215,203,160,99,76,45,29,939,74,1013,7.305034550839092
22106,330455705360141,138,153,135,141,88,57,40,21,712,61,773,7.8913324708926265
22107,330455705360142,109,144,189,133,99,84,31,21,758,52,810,6.419753086419753
22108,330455705360143,163,189,195,176,140,67,40,17,930,57,987,5.775075987841945
22109,330455705360144,66,61,74,53,41,29,13,12,324,25,349,7.163323782234957
22110,330455705360145,71,75,104,83,70,77,37,35,480,72,552,13.043478260869565
22111,330455705360146,25,25,51,44,47,31,20,12,223,32,255,12.549019607843137
22112,330455705360147,17,23,31,31,19,14,15,4,135,19,154,12.337662337662337
22113,330455705360148,15,16,19,38,26,7,7,10,121,17,138,12.318840579710145
22114,330455705360149,56,77,68,41,47,46,23,13,335,36,371,9.703504043126685
22115,330455705360150,76,97,105,94,70,41,28,28,483,56,539,10.38961038961039
22116,330455705360151,90,110,123,86,103,62,37,37,574,74,648,11.419753086419753
22117,330455705360152,86,75,109,96,69,56,25,23,491,48,539,8.905380333951763
22118,330455705360153,56,50,63,70,33,18,14,4,290,18,308,5.8441558441558445
22119,330455705360154,96,145,136,118,107,74,34,40,676,74,750,9.866666666666667
22120,330455705360155,53,68,57,55,63,31,26,10,327,36,363,9.917355371900827
22121,330455705360156,49,54,68,84,52,53,33,29,360,62,422,14.691943127962086
22122,330455705360157,44,51,71,72,56,35,19,14,329,33,362,9.116022099447514
22123,330455705360158,102,123,99,102,63,44,36,6,533,42,575,7.304347826086956
22124,330455705360159,93,55,101,77,60,56,28,15,442,43,485,8.8659793814433
22125,330455705360160,65,94,85,85,87,65,36,36,481,72,553,13.019891500904158
22126,330455705360161,41,75,60,47,53,33,13,22,309,35,344,10.174418604651162
22127,330455705360162,181,178,185,177,127,81,36,17,929,53,982,5.39714867617108
22128,330455705360163,134,150,177,123,118,69,39,18,771,57,828,6.884057971014493
22129,330455705360164,99,88,95,98,60,50,34,22,490,56,546,10.256410256410257
22130,330455705360165,99,83,131,129,68,57,22,11,567,33,600,5.5
22131,330455705360166,118,98,117,85,66,40,31,12,524,43,567,7.583774250440917
22132,330455705360167,137,144,149,159,91,60,27,15,740,42,782,5.370843989769821
22133,330455705360168,51,68,70,70,44,28,20,7,331,27,358,7.5418994413407825
22134,330455705360169,289,245,374,277,189,118,31,13,1492,44,1536,2.8645833333333335
22135,330455705360170,53,76,71,76,45,30,25,10,351,35,386,9.067357512953368
22136,330455705360171,74,94,122,105,67,47,26,4,509,30,539,5.565862708719852
22137,330455705360172,58,72,65,63,51,33,15,16,342,31,373,8.310991957104557
22138,330455705360173,43,38,52,54,31,21,7,20,239,27,266,10.150375939849624
22139,330455705360174,126,185,149,154,132,71,48,50,817,98,915,10.710382513661202
22140,330455705360175,56,86,51,69,58,41,22,15,361,37,398,9.296482412060302
22141,330455705360176,58,35,53,44,28,11,4,7,229,11,240,4.583333333333333
22142,330455705360177,105,74,58,79,42,16,10,4,374,14,388,3.6082474226804124
22143,330455705360178,17,8,21,19,9,10,3,0,84,3,87,3.4482758620689653
22144,330455705360179,3,3,1,1,3,1,1,0,12,1,13,7.6923076923076925
22145,330455705360180,78,103,88,77,90,57,28,19,493,47,540,8.703703703703704
22146,330455705360181,75,59,174,106,42,30,11,5,486,16,502,3.187250996015936
22147,330455705360182,123,121,129,111,71,39,24,9,594,33,627,5.2631578947368425
22148,330455705360183,127,203,203,192,128,70,33,17,923,50,973,5.138746145940391
22149,330455705360184,122,162,156,167,89,40,14,4,736,18,754,2.387267904509284
22150,330455705360185,207,374,289,344,209,70,21,10,1493,31,1524,2.0341207349081363
22151,330455705370001,97,122,68,125,77,39,28,27,528,55,583,9.433962264150944
22152,330455705370003,94,161,62,142,127,9,7,1,595,8,603,1.3266998341625207
22153,330455705370004,75,108,83,68,56,76,58,29,466,87,553,15.732368896925859
22154,330455705370005,142,182,180,154,130,193,115,62,981,177,1158,15.284974093264248
22155,330455705370006,104,162,148,118,100,159,94,51,791,145,936,15.491452991452991
22156,330455705370007,87,121,108,98,78,83,72,27,575,99,674,14.688427299703264
22157,330455705370008,246,225,214,146,144,107,61,36,1082,97,1179,8.227311280746395
22158,330455705370009,98,135,103,112,89,93,72,29,630,101,731,13.816689466484268
22159,330455705370010,70,101,119,92,94,100,56,62,576,118,694,17.002881844380404
22160,330455705370011,158,195,213,203,164,168,95,93,1101,188,1289,14.584949573312645
22161,330455705370012,26,43,54,44,48,45,16,21,260,37,297,12.457912457912458
22162,330455705370013,72,67,94,75,77,74,39,33,459,72,531,13.559322033898304
22163,330455705370015,19,5,11,22,5,2,0,0,64,0,64,0.0
22164,330455705370016,166,35,92,303,35,6,1,1,637,2,639,0.3129890453834116
22165,330455705370017,3,3,12,14,3,2,0,0,37,0,37,0.0
22166,330455705370018,108,151,73,131,165,22,20,10,650,30,680,4.411764705882353
22167,330455705370019,101,121,141,118,96,89,66,37,666,103,769,13.394018205461638
22168,330455705370020,125,164,194,173,122,125,74,51,903,125,1028,12.15953307392996
22169,330455705370021,152,190,208,168,128,149,71,54,995,125,1120,11.160714285714286
22170,330455705370022,119,141,151,149,110,129,65,54,799,119,918,12.962962962962964
22171,330455705370023,18,17,6,24,14,2,1,0,81,1,82,1.2195121951219512
22172,330455705370024,148,32,55,194,21,6,0,0,456,0,456,0.0
22173,330455705370025,72,47,85,181,49,16,1,0,450,1,451,0.22172949002217296
22174,330455705370026,74,80,77,74,79,57,44,34,441,78,519,15.028901734104046
22175,330455705370027,73,127,86,68,71,68,31,32,493,63,556,11.33093525179856
22176,330455705370028,87,112,125,88,101,78,50,39,591,89,680,13.088235294117647
22177,330455705370029,84,105,128,121,106,112,63,61,656,124,780,15.897435897435898
22178,330455705370030,85,131,169,133,143,143,82,71,804,153,957,15.987460815047022
22179,330455705370031,64,96,127,133,101,98,92,69,619,161,780,20.641025641025642
22180,330455705370032,113,125,108,148,108,99,79,57,701,136,837,16.248506571087216
22181,330455705370034,128,176,63,128,238,33,5,12,766,17,783,2.1711366538952745
22182,330455705370035,71,130,84,55,201,32,3,6,573,9,582,1.5463917525773196
22183,330455705370037,100,195,89,140,256,44,6,15,824,21,845,2.485207100591716
22184,330455705370038,92,74,100,124,103,89,55,59,582,114,696,16.379310344827587
22185,330455705370039,71,134,142,144,168,167,113,106,826,219,1045,20.95693779904306
22186,330455705370040,70,126,125,116,141,126,95,65,704,160,864,18.51851851851852
22187,330455705370041,72,81,116,109,103,69,32,19,550,51,601,8.48585690515807
22188,330455705370042,41,48,34,39,32,21,10,6,215,16,231,6.926406926406926
22189,330455705370043,78,125,116,113,140,89,51,57,661,108,769,14.044213263979193
22190,330455705370044,51,59,83,61,77,113,70,79,444,149,593,25.126475548060707
22191,330455705370045,38,65,67,58,82,84,35,52,394,87,481,18.08731808731809
22192,330455705370046,48,41,74,75,61,69,41,60,368,101,469,21.535181236673775
22193,330455705370047,43,86,79,73,94,110,79,101,485,180,665,27.06766917293233
22194,330455705370048,29,45,43,41,45,47,22,16,250,38,288,13.194444444444445
22195,330455705370049,94,165,156,154,195,177,88,98,941,186,1127,16.50399290150843
22196,330455705370051,149,124,164,218,173,113,58,18,941,76,1017,7.472959685349066
22197,330455705370052,100,107,126,178,167,85,36,24,763,60,823,7.290400972053463
22198,330455705370053,80,106,154,115,131,119,88,89,705,177,882,20.068027210884352
22199,330455705370054,200,215,264,212,193,200,89,91,1284,180,1464,12.295081967213115
22200,330455705370055,110,126,142,110,118,99,63,32,705,95,800,11.875
22201,330455705370056,102,141,132,129,129,85,63,50,718,113,831,13.598074608904934
22202,330455705370057,122,136,150,146,124,94,50,42,772,92,864,10.648148148148149
22203,330455705370058,98,134,160,112,122,124,45,36,750,81,831,9.747292418772563
22204,330455705370059,152,198,197,158,158,115,58,38,978,96,1074,8.938547486033519
22205,330455705370060,113,152,174,155,144,130,77,79,868,156,1024,15.234375
22206,330455705370061,147,175,203,180,171,135,102,97,1011,199,1210,16.446280991735538
22207,330455705370062,88,104,133,104,100,130,72,56,659,128,787,16.264294790343076
22208,330455705370063,99,137,144,143,146,148,82,81,817,163,980,16.632653061224488
22209,330455705370064,98,116,149,140,134,111,86,74,748,160,908,17.621145374449338
22210,330455705370065,79,131,125,121,117,139,87,77,712,164,876,18.72146118721461
22211,330455705370066,141,190,215,205,190,168,106,112,1109,218,1327,16.428033157498117
22212,330455705370067,67,108,91,58,90,43,22,21,457,43,500,8.6
22213,330455705370068,101,130,177,149,141,135,56,45,833,101,934,10.81370449678801
22214,330455705370069,109,154,161,126,125,105,66,42,780,108,888,12.162162162162161
22215,330455705370070,49,75,92,76,62,65,46,48,419,94,513,18.323586744639375
22216,330455705370071,94,144,159,132,116,148,73,50,793,123,916,13.427947598253276
22217,330455705370072,68,100,92,112,100,88,63,51,560,114,674,16.91394658753709
22218,330455705370073,115,109,103,102,93,74,23,40,596,63,659,9.559939301972685
22219,330455705370074,50,88,95,82,92,65,58,59,472,117,589,19.864176570458405
22220,330455705370075,110,109,129,115,72,82,46,29,617,75,692,10.83815028901734
22221,330455705370076,106,131,129,132,108,88,71,36,694,107,801,13.358302122347066
22222,330455705370077,76,93,68,108,97,64,33,35,506,68,574,11.846689895470384
22223,330455705370078,130,161,153,125,97,88,69,46,754,115,869,13.233601841196778
22224,330455705370079,153,153,178,114,93,96,42,24,787,66,853,7.737397420867526
22225,330455705370080,69,110,118,104,112,98,59,73,611,132,743,17.765814266487215
22226,330455705370081,80,124,109,96,110,89,67,60,608,127,735,17.27891156462585
22227,330455705370082,130,168,142,145,147,108,68,44,840,112,952,11.764705882352942
22228,330455705370083,143,165,150,144,129,142,55,59,873,114,987,11.55015197568389
22229,330455705370084,113,124,144,154,105,109,76,75,749,151,900,16.77777777777778
22230,330455705370085,34,48,44,36,42,57,31,25,261,56,317,17.665615141955836
22231,330455705370086,47,67,78,70,73,52,56,49,387,105,492,21.341463414634145
22232,330455705370087,56,73,92,84,68,60,54,64,433,118,551,21.415607985480943
22233,330455705370088,54,77,89,74,77,89,61,51,460,112,572,19.58041958041958
22234,330455705370089,107,143,158,144,156,97,98,74,805,172,977,17.60491299897646
22235,330455705370090,79,135,132,121,143,112,107,92,722,199,921,21.606948968512487
22236,330455705370091,94,110,158,115,144,137,98,101,758,199,957,20.794148380355278
22237,330455705370092,77,124,98,129,95,110,86,51,633,137,770,17.792207792207794
22238,330455705370093,64,131,113,96,100,81,38,33,585,71,656,10.823170731707316
22239,330455705370094,114,148,144,123,136,118,58,52,783,110,893,12.318029115341545
22240,330455705370095,22,21,29,15,21,13,9,7,121,16,137,11.678832116788321
22241,330455705370096,63,78,84,97,84,69,49,36,475,85,560,15.178571428571429
22242,330455705370097,124,111,155,107,98,84,65,41,679,106,785,13.503184713375797
22243,330455705370098,59,77,71,87,67,56,55,38,417,93,510,18.235294117647058
22244,330455705370099,131,144,142,144,89,94,68,38,744,106,850,12.470588235294118
22245,330455705370100,171,193,146,156,116,97,57,56,879,113,992,11.391129032258064
22246,330455705370101,93,111,110,87,83,58,48,44,542,92,634,14.511041009463723
22247,330455705370102,146,164,143,132,113,120,59,46,818,105,923,11.375947995666305
22248,330455705370103,17,17,13,19,17,14,4,3,97,7,104,6.730769230769231
22249,330455705370104,105,124,104,109,95,100,68,58,637,126,763,16.513761467889907
22250,330455705370105,56,69,74,72,70,62,43,48,403,91,494,18.42105263157895
22251,330455705370106,162,189,180,149,143,102,66,40,925,106,1031,10.281280310378273
22252,330455705370107,51,45,83,78,44,48,26,24,349,50,399,12.531328320802006
22253,330455705370108,113,108,127,128,83,42,23,9,601,32,633,5.055292259083728
22254,330455705370109,136,162,134,154,101,75,51,24,762,75,837,8.960573476702509
22255,330455705370110,189,177,230,200,154,147,64,39,1097,103,1200,8.583333333333334
22256,330455705370111,134,127,137,143,104,82,58,38,727,96,823,11.664641555285542
22257,330455705370112,96,132,96,90,64,41,13,14,519,27,546,4.945054945054945
22258,330455705370113,33,38,32,35,20,37,15,4,195,19,214,8.878504672897197
22259,330455705370114,158,193,192,179,163,102,76,43,987,119,1106,10.759493670886076
22260,330455705370115,127,140,180,148,149,145,112,119,889,231,1120,20.625
22261,330455705370116,32,40,27,30,16,13,14,10,158,24,182,13.186813186813186
22262,330455705370117,185,217,215,231,164,142,72,63,1154,135,1289,10.47323506594259
22263,330455705370118,237,214,239,208,173,126,61,24,1197,85,1282,6.6302652106084246
22264,330455705370119,52,71,88,70,65,59,29,30,405,59,464,12.71551724137931
22265,330455705370120,138,168,147,171,124,106,76,52,854,128,982,13.034623217922608
22266,330455705370121,71,69,69,60,38,30,17,5,337,22,359,6.128133704735376
22267,330455705370122,84,109,97,83,86,85,43,51,544,94,638,14.733542319749215
22268,330455705370123,47,64,52,56,53,51,47,30,323,77,400,19.25
22269,330455705370124,108,170,147,153,146,109,69,54,833,123,956,12.866108786610878
22270,330455705370125,75,119,119,109,90,122,56,50,634,106,740,14.324324324324325
22271,330455705370126,59,102,123,95,100,103,55,41,582,96,678,14.15929203539823
22272,330455705370127,89,88,137,101,98,100,44,57,613,101,714,14.145658263305322
22273,330455705370128,107,102,143,114,138,124,62,70,728,132,860,15.348837209302326
22274,330455705370129,50,62,56,63,49,63,38,25,343,63,406,15.517241379310345
22275,330455705370130,83,83,97,124,74,86,91,57,547,148,695,21.294964028776977
22276,330455705370131,82,97,96,96,86,80,46,38,537,84,621,13.526570048309178
22277,330455705370132,80,77,113,103,83,88,64,48,544,112,656,17.073170731707318
22278,330455705370133,94,87,89,89,70,71,49,36,500,85,585,14.52991452991453
22279,330455705370134,133,158,206,140,154,166,88,82,957,170,1127,15.084294587400178
22280,330455705370135,86,163,115,104,108,100,53,45,676,98,774,12.661498708010337
22281,330455705370136,81,96,85,89,62,59,30,33,472,63,535,11.77570093457944
22282,330455705370137,129,176,117,113,80,69,43,24,684,67,751,8.921438082556591
22283,330455705370138,117,145,133,105,94,87,47,35,681,82,763,10.747051114023591
22284,330455705370139,70,87,83,57,50,68,39,21,415,60,475,12.631578947368421
22285,330455705370140,177,173,153,116,113,74,36,30,806,66,872,7.568807339449541
22286,330455705370141,66,71,92,84,103,101,63,58,517,121,638,18.96551724137931
22287,330455705370142,38,52,59,51,49,33,22,22,282,44,326,13.496932515337424
22288,330455705370143,49,110,100,127,126,86,76,62,598,138,736,18.75
22289,330455705370144,112,85,125,140,102,105,55,58,669,113,782,14.450127877237852
22290,330455705370145,41,53,57,55,60,61,41,31,327,72,399,18.045112781954888
22291,330455705370146,61,43,64,54,47,53,45,20,322,65,387,16.795865633074936
22292,330455705370147,99,123,143,123,123,123,56,62,734,118,852,13.849765258215962
22293,330455705370148,139,179,204,170,157,136,101,76,985,177,1162,15.232358003442341
22294,330455705370149,66,82,102,92,78,111,61,46,531,107,638,16.771159874608152
22295,330455705370150,74,91,133,126,125,119,74,67,668,141,809,17.428924598269468
22296,330455705370151,60,65,75,84,80,78,46,56,442,102,544,18.75
22297,330455705370152,77,106,135,97,151,131,77,114,697,191,888,21.50900900900901
22298,330455705370153,72,113,129,116,121,131,90,93,682,183,865,21.15606936416185
22299,330455705370154,86,134,141,163,138,122,75,57,784,132,916,14.410480349344978
22300,330455705370155,51,83,87,86,89,91,64,56,487,120,607,19.769357495881383
22301,330455705370156,76,107,100,103,115,87,38,38,588,76,664,11.44578313253012
22302,330455705370157,65,73,66,59,46,36,24,20,345,44,389,11.311053984575835
22303,330455705370158,82,109,134,127,95,150,76,81,697,157,854,18.384074941451992
22304,330455705370159,85,136,168,180,155,166,128,104,890,232,1122,20.67736185383244
22305,330455705370160,74,95,119,113,112,106,71,77,619,148,767,19.295958279009128
22306,330455705370161,66,62,83,71,71,71,49,53,424,102,526,19.39163498098859
22307,330455705370162,24,53,73,40,75,76,36,59,341,95,436,21.788990825688074
22308,330455705370163,78,101,117,110,91,95,62,66,592,128,720,17.77777777777778
22309,330455705370164,83,126,111,122,87,85,56,42,614,98,712,13.764044943820224
22310,330455705370165,89,105,107,122,100,75,43,55,598,98,696,14.080459770114942
22311,330455705370166,56,99,76,90,77,62,56,46,460,102,562,18.14946619217082
22312,330455705370167,63,115,102,93,101,114,66,66,588,132,720,18.333333333333332
22313,330455705370168,84,101,98,105,108,69,75,23,565,98,663,14.781297134238311
22314,330455705370169,68,74,94,113,74,90,66,38,513,104,617,16.85575364667747
22315,330455705370170,53,65,64,76,69,59,50,40,386,90,476,18.907563025210084
22316,330455705370171,70,111,132,118,142,108,87,99,681,186,867,21.453287197231834
22317,330455705370172,34,46,44,58,53,53,31,42,288,73,361,20.221606648199447
22318,330455705370173,43,74,85,65,81,76,66,65,424,131,555,23.603603603603602
22319,330455705370174,65,105,114,108,108,116,57,83,616,140,756,18.51851851851852
22320,330455705370175,85,136,169,132,115,132,93,59,769,152,921,16.503800217155266
22321,330455705370176,130,149,150,159,144,103,69,41,835,110,945,11.640211640211641
22322,330455705370177,291,377,326,254,225,157,67,42,1630,109,1739,6.267970097757332
22323,330455705370178,85,141,122,108,95,80,48,18,631,66,697,9.469153515064562
22324,330455705370179,64,78,103,89,73,57,34,35,464,69,533,12.945590994371482
22325,330455705370180,38,56,49,66,60,36,28,19,305,47,352,13.352272727272727
22326,330455705370181,47,73,76,76,75,65,32,45,412,77,489,15.74642126789366
22327,330455705370182,162,189,192,147,168,129,79,55,987,134,1121,11.953612845673506
22328,330455705370183,154,185,174,165,180,125,76,60,983,136,1119,12.153708668453977
22329,330455705370184,81,84,109,100,111,83,44,50,568,94,662,14.19939577039275
22330,330455705370185,125,139,155,157,159,123,61,60,858,121,979,12.359550561797754
22331,330455705370186,48,95,101,99,118,104,58,69,565,127,692,18.352601156069365
22332,330455705370187,103,147,158,135,131,146,84,73,820,157,977,16.069600818833162
22333,330455705370188,75,73,95,72,61,56,23,24,432,47,479,9.812108559498956
22334,330455705370189,95,149,136,129,132,97,69,64,738,133,871,15.269804822043628
22335,330455705370190,109,146,152,138,144,121,74,57,810,131,941,13.921360255047821
22336,330455705370191,95,134,103,113,135,95,61,54,675,115,790,14.556962025316455
22337,330455705370192,92,103,132,107,90,95,78,52,619,130,749,17.356475300400533
22338,330455705370193,99,134,108,127,93,72,58,34,633,92,725,12.689655172413794
22339,330455705370194,62,79,103,87,67,85,80,41,483,121,604,20.033112582781456
22340,330455705370195,79,97,121,106,96,90,67,38,589,105,694,15.129682997118156
22341,330455705370196,83,86,101,100,94,75,76,44,539,120,659,18.20940819423369
22342,330455705370197,67,74,73,80,70,79,47,47,443,94,537,17.50465549348231
22343,330455705370198,61,78,63,75,76,56,37,34,409,71,480,14.791666666666666
22344,330455705370199,53,72,70,72,61,41,42,40,369,82,451,18.181818181818183
22345,330455705370200,68,115,86,107,80,97,65,46,553,111,664,16.716867469879517
22346,330455705370201,104,129,114,140,121,100,87,81,708,168,876,19.17808219178082
22347,330455705370202,110,162,143,151,148,120,88,80,834,168,1002,16.766467065868262
22348,330455705370203,85,130,142,140,109,104,91,43,710,134,844,15.876777251184834
22349,330455705370204,103,150,146,145,131,111,69,59,786,128,914,14.00437636761488
22350,330455705370205,101,106,145,112,96,132,78,63,692,141,833,16.926770708283314
22351,330455705370206,62,75,98,87,57,69,49,49,448,98,546,17.94871794871795
22352,330455705370207,90,127,128,101,125,85,46,55,656,101,757,13.34214002642008
22353,330455705370208,150,169,185,168,126,114,76,39,912,115,1027,11.197663096397273
22354,330455705370209,104,150,159,141,115,134,92,55,803,147,950,15.473684210526315
22355,330455705370210,120,156,123,140,133,113,65,50,785,115,900,12.777777777777779
22356,330455705370211,154,183,217,224,183,198,118,95,1159,213,1372,15.524781341107872
22357,330455705370212,73,110,113,100,101,68,39,38,565,77,642,11.993769470404985
22358,330455705370213,58,74,79,77,71,69,44,49,428,93,521,17.850287907869482
22359,330455705370214,96,151,148,149,150,133,91,74,827,165,992,16.633064516129032
22360,330455705370215,95,119,129,103,113,112,47,80,671,127,798,15.914786967418546
22361,330455705370216,84,92,126,97,110,122,61,62,631,123,754,16.312997347480106
22362,330455705370217,68,87,116,98,84,72,58,59,525,117,642,18.22429906542056
22363,330455705370218,63,93,103,99,115,117,34,78,590,112,702,15.954415954415955
22364,330455705370219,106,136,161,126,140,117,49,56,786,105,891,11.784511784511784
22365,330455705370220,91,121,124,95,97,79,44,42,607,86,693,12.40981240981241
22366,330455705370221,108,146,128,100,62,59,32,11,603,43,646,6.656346749226006
22367,330455705370222,99,109,107,79,47,45,16,12,486,28,514,5.447470817120623
22368,330455705370223,49,92,83,91,85,58,47,45,458,92,550,16.727272727272727
22369,330455705370224,65,113,122,87,83,68,49,46,538,95,633,15.007898894154819
22370,330455705370225,137,174,181,144,163,121,65,74,920,139,1059,13.125590179414543
22371,330455705370226,93,122,107,104,71,55,42,20,552,62,614,10.09771986970684
22372,330455705370227,111,160,138,123,142,66,38,28,740,66,806,8.188585607940446
22373,330455705370228,130,171,131,163,138,112,49,58,845,107,952,11.239495798319327
22374,330455705370229,88,131,96,91,60,56,18,5,522,23,545,4.220183486238532
22375,330455705370230,96,106,135,132,92,130,71,37,691,108,799,13.516896120150188
22376,330455705370231,129,177,192,161,157,123,59,44,939,103,1042,9.884836852207293
22377,330455705370232,102,111,128,141,102,111,106,37,695,143,838,17.064439140811455
22378,330455705370233,99,148,147,136,135,103,87,48,768,135,903,14.950166112956811
22379,330455705370234,139,178,159,135,133,116,69,42,860,111,971,11.431513903192585
22380,330455705370235,92,155,103,108,91,75,47,28,624,75,699,10.729613733905579
22381,330455705370236,103,121,127,95,74,80,55,24,600,79,679,11.634756995581737
22382,330455705370237,122,140,117,126,96,105,67,38,706,105,811,12.946979038224415
22383,330455705370238,86,101,121,101,87,87,50,34,583,84,667,12.593703148425787
22384,330455705370239,86,96,106,99,113,93,55,30,593,85,678,12.536873156342184
22385,330455705370240,81,127,121,101,110,123,78,65,663,143,806,17.741935483870968
22386,330455705370241,97,103,147,96,105,120,66,77,668,143,811,17.632552404438965
22387,330455705370242,96,120,155,96,131,150,60,80,748,140,888,15.765765765765765
22388,330455705370243,60,91,102,80,93,98,49,46,524,95,619,15.347334410339258
22389,330455705370244,78,95,101,82,80,89,36,31,525,67,592,11.317567567567568
22390,330455705370245,80,102,97,82,84,73,42,28,518,70,588,11.904761904761905
22391,330455705370246,163,157,197,156,193,116,79,59,982,138,1120,12.321428571428571
22392,330455705370247,32,40,32,30,23,17,8,5,174,13,187,6.951871657754011
22393,330455705370248,63,106,112,86,86,118,54,62,571,116,687,16.885007278020378
22394,330455705370249,72,99,111,94,100,121,63,72,597,135,732,18.442622950819672
22395,330455705370250,108,120,116,94,92,84,31,24,614,55,669,8.221225710014947
22396,330455705370251,91,97,106,69,59,54,27,15,476,42,518,8.108108108108109
22397,330455705370252,65,93,88,90,76,59,35,30,471,65,536,12.126865671641792
22398,330455705370253,49,77,85,78,82,84,68,50,455,118,573,20.593368237347295
22399,330455705370254,61,83,84,65,86,54,31,21,433,52,485,10.721649484536082
22400,330455705370255,76,139,124,93,128,88,47,52,648,99,747,13.25301204819277
22401,330455705370256,165,198,190,196,193,126,63,67,1068,130,1198,10.851419031719532
22402,330455705370257,122,127,157,123,128,98,52,50,755,102,857,11.90198366394399
22403,330455705370258,98,111,165,148,99,152,59,28,773,87,860,10.116279069767442
22404,330455705370259,107,110,125,109,86,92,38,40,629,78,707,11.032531824611032
22405,330455705370260,157,198,173,189,176,142,73,67,1035,140,1175,11.914893617021276
22406,330455705370261,86,97,100,94,65,54,31,19,496,50,546,9.157509157509157
22407,330455705370262,108,120,138,184,151,122,60,47,823,107,930,11.505376344086022
22408,330455705370263,80,70,101,89,64,64,38,28,468,66,534,12.359550561797754
22409,330455705370264,58,66,105,73,100,71,30,29,473,59,532,11.090225563909774
22410,330455705370265,88,114,120,112,118,82,37,24,634,61,695,8.776978417266188
22411,330455705370266,61,87,96,73,86,80,49,49,483,98,581,16.867469879518072
22412,330455705370267,75,91,94,76,89,85,45,43,510,88,598,14.715719063545151
22413,330455705370268,133,125,127,159,108,89,82,36,741,118,859,13.736903376018626
22414,330455705370269,164,130,151,93,83,61,21,18,682,39,721,5.4091539528432735
22415,330455705370270,136,163,146,145,141,112,63,64,843,127,970,13.092783505154639
22416,330455705370271,81,106,112,79,63,65,51,15,506,66,572,11.538461538461538
22417,330455705370272,1,0,3,1,1,3,0,0,9,0,9,0.0
22418,330455705370273,137,228,141,158,181,74,70,44,919,114,1033,11.035818005808325
22419,330455705370274,94,132,137,110,78,86,42,33,637,75,712,10.53370786516854
22420,330455705370275,48,72,85,83,61,68,64,22,417,86,503,17.09741550695825
22421,330455705370276,83,119,127,85,96,56,28,22,566,50,616,8.116883116883116
22422,330455705370277,64,64,101,102,88,67,16,18,486,34,520,6.538461538461538
22423,330455705370278,13,17,18,26,37,38,9,23,149,32,181,17.679558011049725
22424,330455705370279,116,131,139,202,166,87,57,36,841,93,934,9.957173447537473
22425,330455705370280,109,150,118,149,134,120,59,35,780,94,874,10.755148741418765
22426,330455705370281,75,77,88,95,83,56,16,15,474,31,505,6.138613861386139
22427,330455705370282,51,63,38,48,39,29,18,12,268,30,298,10.06711409395973
22428,330455705370283,22,27,35,31,16,15,16,5,146,21,167,12.574850299401197
22429,330455705370284,194,195,121,151,86,34,21,4,781,25,806,3.101736972704715
22430,330455705370285,67,75,52,82,58,45,39,21,379,60,439,13.66742596810934
22431,330455705370286,90,131,108,99,83,58,16,23,569,39,608,6.4144736842105265
22432,330455705370287,95,146,108,100,101,59,32,30,609,62,671,9.23994038748137
22433,330455705370288,148,174,152,162,143,107,45,38,886,83,969,8.565531475748195
22434,330455705370289,61,53,65,54,49,45,12,14,327,26,353,7.36543909348442
22435,330455705370290,83,80,99,101,73,56,32,34,492,66,558,11.827956989247312
22436,330455705370291,226,194,156,142,80,60,23,17,858,40,898,4.4543429844097995
22437,330455705370292,153,161,171,111,90,65,33,22,751,55,806,6.823821339950372
22438,330455705370293,54,60,52,48,50,46,24,24,310,48,358,13.40782122905028
22439,330455705370294,83,95,77,83,59,50,25,34,447,59,506,11.660079051383399
22440,330455705370295,55,57,57,72,48,53,28,33,342,61,403,15.136476426799007
22441,330455705370296,43,44,57,52,52,30,42,12,278,54,332,16.265060240963855
22442,330455705370297,81,90,105,103,123,83,64,54,585,118,703,16.78520625889047
22443,330455705370298,96,146,154,122,142,117,69,51,777,120,897,13.377926421404682
22444,330455705370299,44,56,61,60,66,50,30,35,337,65,402,16.16915422885572
22445,330455705370300,40,57,57,52,57,44,22,39,307,61,368,16.57608695652174
22446,330455705370301,65,91,76,80,85,61,33,33,458,66,524,12.595419847328245
22447,330455705370302,29,49,60,56,68,40,47,34,302,81,383,21.148825065274153
22448,330455705370303,55,60,78,69,82,55,40,52,399,92,491,18.73727087576375
22449,330455705370304,57,74,81,68,87,70,48,32,437,80,517,15.473887814313347
22450,330455705370305,75,93,109,96,85,62,59,43,520,102,622,16.39871382636656
22451,330455705370306,62,89,75,82,105,62,31,55,475,86,561,15.329768270944742
22452,330455705370307,60,60,65,67,84,52,22,29,388,51,439,11.617312072892938
22453,330455705370308,81,105,99,92,75,63,22,18,515,40,555,7.207207207207207
22454,330455705370309,32,39,46,35,30,36,20,6,218,26,244,10.655737704918034
22455,330455705370310,88,125,126,92,119,105,51,53,655,104,759,13.70223978919631
22456,330455705370311,51,38,56,66,43,42,23,9,296,32,328,9.75609756097561
22457,330455705370312,54,61,83,75,63,71,43,34,407,77,484,15.909090909090908
22458,330455705370313,58,83,61,56,73,74,30,38,405,68,473,14.376321353065538
22459,330455705370314,54,66,75,91,80,61,45,36,427,81,508,15.94488188976378
22460,330455705370315,43,69,52,66,74,62,39,32,366,71,437,16.247139588100687
22461,330455705370316,48,73,75,48,86,87,29,37,417,66,483,13.664596273291925
22462,330455705370317,46,73,94,63,79,68,49,53,423,102,525,19.428571428571427
22463,330455705370318,89,118,120,103,90,98,39,32,618,71,689,10.304789550072568
22464,330455705370319,94,87,97,90,70,46,17,11,484,28,512,5.46875
22465,330455705370320,52,76,75,74,64,47,32,41,388,73,461,15.835140997830802
22466,330455705370321,56,64,75,59,75,45,30,32,374,62,436,14.220183486238533
22467,330455705370322,80,95,103,70,78,65,34,31,491,65,556,11.690647482014388
22468,330455705370323,157,183,184,128,130,58,31,18,840,49,889,5.511811023622047
22469,330455705370324,95,108,91,98,87,57,34,32,536,66,602,10.96345514950166
22470,330455705370325,53,54,52,41,33,13,4,3,246,7,253,2.766798418972332
22471,330455705370326,92,95,82,74,55,49,16,12,447,28,475,5.894736842105263
22472,330455705370327,130,145,133,112,119,106,53,35,745,88,833,10.56422569027611
22473,330455705370328,95,150,121,148,157,105,42,23,776,65,841,7.728894173602853
22474,330455705370329,127,139,143,125,118,98,42,25,750,67,817,8.200734394124847
22475,330455705370330,22,48,36,44,35,30,14,15,215,29,244,11.885245901639344
22476,330455705370331,91,139,98,114,140,70,35,31,652,66,718,9.192200557103064
22477,330455705370332,48,46,56,65,51,53,40,28,319,68,387,17.57105943152455
22478,330455705370333,56,77,116,83,52,99,75,48,483,123,606,20.297029702970296
22479,330455705370334,110,127,141,128,95,84,52,19,685,71,756,9.39153439153439
22480,330455705370335,53,79,71,75,78,83,27,28,439,55,494,11.133603238866396
22481,330455705370336,36,64,61,57,78,42,42,42,338,84,422,19.90521327014218
22482,330455705370337,74,61,115,82,70,85,37,39,487,76,563,13.49911190053286
22483,330455705370338,110,113,118,106,101,67,42,30,615,72,687,10.480349344978166
22484,330455705370339,76,109,93,85,60,62,24,33,485,57,542,10.51660516605166
22485,330455705370340,39,54,45,49,54,43,30,25,284,55,339,16.224188790560472
22486,330455705370341,35,34,31,26,26,15,9,10,167,19,186,10.21505376344086
22487,330455705370342,100,159,132,118,102,61,40,38,672,78,750,10.4
22488,330455705370343,38,46,59,58,56,28,32,31,285,63,348,18.103448275862068
22489,330455705370344,57,58,104,112,59,80,59,47,470,106,576,18.40277777777778
22490,330455705370345,87,85,92,89,72,71,30,28,496,58,554,10.469314079422382
22491,330455705370346,61,76,104,93,83,66,42,27,483,69,552,12.5
22492,330455705370347,46,67,67,54,70,46,26,40,350,66,416,15.865384615384615
22493,330455705370348,54,74,61,89,69,61,47,25,408,72,480,15.0
22494,330455705370349,48,77,85,91,80,66,37,29,447,66,513,12.865497076023392
22495,330455705370350,58,93,106,60,61,56,40,24,434,64,498,12.85140562248996
22496,330455705370351,60,69,66,68,61,49,29,33,373,62,435,14.25287356321839
22497,330455705370352,167,181,123,115,100,67,29,15,753,44,797,5.520702634880803
22498,330455705370359,7,6,5,7,4,0,1,1,29,2,31,6.451612903225806
22499,330455705370360,70,87,103,71,68,68,34,10,467,44,511,8.610567514677104
22500,330455705370361,100,77,72,68,47,32,12,6,396,18,414,4.3478260869565215
22501,330455705370362,47,74,63,63,58,52,28,26,357,54,411,13.138686131386862
22502,330455705370363,65,80,75,77,54,29,13,4,380,17,397,4.282115869017632
22503,330455705370364,51,40,54,26,20,22,8,5,213,13,226,5.752212389380531
22504,330455705370365,32,29,22,24,11,9,3,4,127,7,134,5.223880597014926
22505,330455705370366,48,54,57,66,49,43,40,28,317,68,385,17.662337662337663
22506,330455705380001,216,223,251,172,174,95,65,58,1131,123,1254,9.808612440191387
22507,330455705380002,205,210,202,158,167,99,51,48,1041,99,1140,8.68421052631579
22508,330455705380003,103,161,153,115,140,110,43,62,782,105,887,11.837655016910936
22509,330455705380004,129,138,148,117,145,85,59,44,762,103,865,11.907514450867051
22510,330455705380005,118,127,152,117,113,77,33,45,704,78,782,9.974424552429667
22511,330455705380006,152,174,164,148,153,67,60,43,858,103,961,10.718002081165453
22512,330455705380007,197,225,199,163,166,108,50,64,1058,114,1172,9.726962457337883
22513,330455705380008,158,178,133,158,144,90,59,58,861,117,978,11.963190184049079
22514,330455705380009,170,181,187,127,149,77,57,41,891,98,989,9.908998988877654
22515,330455705380010,160,178,161,121,154,87,44,56,861,100,961,10.40582726326743
22516,330455705380011,115,137,128,116,108,69,42,38,673,80,753,10.624169986719787
22517,330455705380012,186,189,148,141,131,84,31,44,879,75,954,7.861635220125786
22518,330455705380013,156,186,135,125,107,88,32,35,797,67,864,7.75462962962963
22519,330455705380014,137,175,125,114,98,57,33,35,706,68,774,8.785529715762275
22520,330455705380015,149,188,164,137,124,91,49,50,853,99,952,10.399159663865547
22521,330455705380016,76,106,131,116,100,72,55,46,601,101,702,14.387464387464387
22522,330455705380017,84,93,106,95,79,76,32,36,533,68,601,11.314475873544094
22523,330455705380018,151,201,179,130,159,111,43,19,931,62,993,6.243705941591138
22524,330455705380019,151,178,161,130,119,83,23,10,822,33,855,3.8596491228070176
22525,330455705380020,128,184,177,139,122,107,71,56,857,127,984,12.90650406504065
22526,330455705380021,129,99,91,62,35,13,5,2,429,7,436,1.6055045871559632
22527,330455705380022,141,173,120,108,92,62,47,23,696,70,766,9.138381201044387
22528,330455705380023,141,165,195,189,133,100,43,33,923,76,999,7.607607607607608
22529,330455705380024,1,5,3,3,5,2,0,1,19,1,20,5.0
22530,330455705380025,151,182,185,123,156,73,43,50,870,93,963,9.657320872274143
22531,330455705380026,108,118,124,101,82,54,34,30,587,64,651,9.831029185867896
22532,330455705380027,148,180,174,130,145,100,55,45,877,100,977,10.235414534288639
22533,330455705380028,173,178,162,130,159,96,39,36,898,75,973,7.708119218910586
22534,330455705380029,162,171,173,167,147,111,113,63,931,176,1107,15.898825654923217
22535,330455705380030,100,135,134,142,118,98,68,56,727,124,851,14.571092831962398
22536,330455705380031,62,106,77,46,74,40,13,20,405,33,438,7.534246575342466
22537,330455705380032,140,180,152,152,113,83,43,59,820,102,922,11.062906724511931
22538,330455705380033,122,153,126,110,99,67,40,54,677,94,771,12.19195849546044
22539,330455705380034,177,215,181,171,213,131,71,56,1088,127,1215,10.452674897119342
22540,330455705380035,101,128,107,113,72,48,55,34,569,89,658,13.525835866261398
22541,330455705380036,160,211,148,168,127,92,61,50,906,111,1017,10.914454277286136
22542,330455705380037,115,162,147,172,119,85,66,26,800,92,892,10.31390134529148
22543,330455705380038,136,127,151,191,154,90,80,26,849,106,955,11.099476439790577
22544,330455705380039,116,134,98,83,66,46,29,15,543,44,587,7.4957410562180575
22545,330455705380040,19,16,27,15,9,5,7,2,91,9,100,9.0
22546,330455705380041,91,107,109,111,80,74,55,49,572,104,676,15.384615384615385
22547,330455705380042,90,144,107,131,103,85,68,46,660,114,774,14.728682170542635
22548,330455705380043,106,109,117,101,116,89,69,79,638,148,786,18.829516539440203
22549,330455705380044,18,34,22,24,20,13,3,5,131,8,139,5.755395683453237
22550,330455705380045,95,83,88,74,45,23,7,6,408,13,421,3.0878859857482186
22551,330455705390001,89,63,90,95,67,68,39,40,472,79,551,14.337568058076226
22552,330455705390002,28,56,66,56,61,63,41,49,330,90,420,21.428571428571427
22553,330455705390003,32,61,68,39,50,82,39,41,332,80,412,19.41747572815534
22554,330455705390004,120,139,145,95,137,104,49,67,740,116,856,13.551401869158878
22555,330455705390005,49,77,66,75,71,57,36,44,395,80,475,16.842105263157894
22556,330455705390006,106,138,239,89,62,45,22,17,679,39,718,5.43175487465181
22557,330455705390007,65,54,56,58,52,47,32,33,332,65,397,16.3727959697733
22558,330455705390008,56,64,66,55,51,62,30,48,354,78,432,18.055555555555557
22559,330455705390009,23,56,125,23,9,11,2,2,247,4,251,1.593625498007968
22560,330455705390010,77,99,103,77,89,69,35,39,514,74,588,12.585034013605442
22561,330455705390011,57,76,78,61,85,82,51,40,439,91,530,17.169811320754718
22562,330455705390012,72,104,93,74,91,59,34,22,493,56,549,10.200364298724955
22563,330455705390013,49,71,137,84,67,67,37,26,475,63,538,11.71003717472119
22564,330455705390014,36,54,54,49,46,45,24,18,284,42,326,12.883435582822086
22565,330455705390015,95,184,171,99,52,33,26,16,634,42,676,6.21301775147929
22566,330455705390016,105,109,104,87,77,72,50,52,554,102,656,15.548780487804878
22567,330455705390017,71,95,102,78,90,80,45,58,516,103,619,16.63974151857835
22568,330455705390018,73,64,94,56,55,52,21,19,394,40,434,9.216589861751151
22569,330455705390019,79,90,83,101,89,76,53,64,518,117,635,18.4251968503937
22570,330455705390020,113,163,143,124,140,130,80,75,813,155,968,16.012396694214875
22571,330455705390021,121,139,111,133,110,87,47,48,701,95,796,11.93467336683417
22572,330455705390022,73,101,95,87,75,55,38,27,486,65,551,11.796733212341199
22573,330455705390023,108,128,104,111,88,88,55,56,627,111,738,15.040650406504065
22574,330455705390024,106,149,144,104,128,79,69,66,710,135,845,15.976331360946746
22575,330455705390025,71,88,73,74,82,54,36,44,442,80,522,15.32567049808429
22576,330455705390026,43,67,51,45,55,35,30,17,296,47,343,13.70262390670554
22577,330455705390027,94,117,107,120,123,86,60,77,647,137,784,17.474489795918366
22578,330455705390028,138,136,123,103,45,57,36,10,602,46,648,7.098765432098766
22579,330455705390029,60,130,104,83,102,88,54,48,567,102,669,15.246636771300448
22580,330455705390030,131,150,166,164,138,124,75,74,873,149,1022,14.579256360078277
22581,330455705390031,23,77,103,54,34,15,16,8,306,24,330,7.2727272727272725
22582,330455705390032,60,95,119,104,118,115,92,67,611,159,770,20.649350649350648
22583,330455705390033,85,129,121,139,130,123,64,51,727,115,842,13.657957244655583
22584,330455705390034,119,113,148,58,41,46,19,11,525,30,555,5.405405405405405
22585,330455705390035,94,141,116,110,104,111,73,54,676,127,803,15.81569115815691
22586,330455705390036,62,108,126,99,99,95,79,69,589,148,737,20.081411126187245
22587,330455705390037,71,100,98,95,114,74,75,61,552,136,688,19.767441860465116
22588,330455705390038,30,37,28,39,25,18,25,26,177,51,228,22.36842105263158
22589,330455705390039,52,58,86,79,58,66,59,62,399,121,520,23.26923076923077
22590,330455705390040,66,92,76,86,66,38,49,26,424,75,499,15.030060120240481
22591,330455705390041,101,135,149,112,126,115,72,69,738,141,879,16.040955631399317
22592,330455705390042,75,91,77,106,77,76,53,69,502,122,624,19.55128205128205
22593,330455705390043,247,244,204,165,103,86,40,13,1049,53,1102,4.809437386569873
22594,330455705390044,139,143,156,126,122,87,68,51,773,119,892,13.340807174887892
22595,330455705390045,16,21,26,24,22,18,16,13,127,29,156,18.58974358974359
22596,330455705390046,78,76,102,82,58,42,16,18,438,34,472,7.203389830508475
22597,330455705390047,64,69,87,73,52,67,47,35,412,82,494,16.59919028340081
22598,330455705390048,45,35,69,47,51,66,26,23,313,49,362,13.535911602209945
22599,330455705390049,49,63,81,85,70,65,38,34,413,72,485,14.845360824742269
22600,330455705390050,59,68,68,57,58,55,38,38,365,76,441,17.233560090702948
22601,330455705390051,61,71,101,119,87,79,59,96,518,155,673,23.031203566121842
22602,330455705390052,99,140,134,130,116,108,89,78,727,167,894,18.680089485458613
22603,330455705390053,97,137,143,103,128,113,92,91,721,183,904,20.243362831858406
22604,330455705390054,146,191,240,242,189,151,111,110,1159,221,1380,16.014492753623188
22605,330455705390055,0,0,14,19,16,3,0,0,52,0,52,0.0
22606,330455705390056,55,70,91,122,87,78,57,52,503,109,612,17.81045751633987
22607,330455705390057,133,143,93,116,69,61,32,27,615,59,674,8.753709198813056
22608,330455705390058,78,136,100,122,108,116,62,68,660,130,790,16.455696202531644
22609,330455705390059,72,79,89,79,66,99,48,36,484,84,568,14.788732394366198
22610,330455705390060,46,51,55,74,52,58,45,31,336,76,412,18.446601941747574
22611,330455705390061,65,92,78,98,59,64,55,38,456,93,549,16.939890710382514
22612,330455705390062,65,106,98,95,81,74,42,24,519,66,585,11.282051282051283
22613,330455705390063,72,77,67,62,54,40,25,17,372,42,414,10.144927536231885
22614,330455705390064,74,87,58,87,92,57,35,38,455,73,528,13.825757575757576
22615,330455705390065,35,85,121,129,57,46,69,45,473,114,587,19.420783645655877
22616,330455705390066,38,57,85,65,66,82,35,29,393,64,457,14.00437636761488
22617,330455705390067,50,73,81,85,85,76,62,43,450,105,555,18.91891891891892
22618,330455705390068,62,101,114,97,107,87,69,60,568,129,697,18.507890961262554
22619,330455705390069,51,57,56,60,42,41,28,36,307,64,371,17.250673854447438
22620,330455705390070,133,117,111,86,63,61,16,13,571,29,600,4.833333333333333
22621,330455705390071,82,112,117,60,72,51,26,19,494,45,539,8.348794063079778
22622,330455705390072,126,148,271,118,59,34,26,20,756,46,802,5.7356608478802995
22623,330455705390073,133,133,129,124,90,62,45,20,671,65,736,8.831521739130435
22624,330455705390074,143,203,187,125,104,63,46,24,825,70,895,7.82122905027933
22625,330455705390075,218,219,212,165,131,84,37,33,1029,70,1099,6.369426751592357
22626,330455705390076,33,115,158,100,71,41,43,12,518,55,573,9.598603839441536
22627,330455705390077,184,181,162,147,114,78,27,27,866,54,920,5.869565217391305
22628,330455705390078,104,226,288,119,84,64,35,35,885,70,955,7.329842931937173
22629,330455705390079,105,119,111,101,94,60,37,17,590,54,644,8.385093167701863
22630,330455705390080,60,86,79,74,69,54,44,43,422,87,509,17.092337917485267
22631,330455705390081,71,90,75,107,70,76,47,57,489,104,593,17.537942664418214
22632,330455705390082,38,60,52,70,50,48,43,27,318,70,388,18.04123711340206
22633,330455705390083,47,36,46,51,37,31,29,34,248,63,311,20.257234726688104
22634,330455705390084,85,89,111,110,108,81,77,60,584,137,721,19.00138696255201
22635,330455705390085,94,135,122,98,103,87,53,40,639,93,732,12.704918032786885
22636,330455705390086,64,56,76,52,36,37,22,14,321,36,357,10.084033613445378
22637,330455705390087,138,230,250,148,129,93,53,32,988,85,1073,7.921714818266542
22638,330455705390088,59,70,83,62,58,39,28,26,371,54,425,12.705882352941176
22639,330455705390089,38,70,61,41,56,44,29,26,310,55,365,15.068493150684931
22640,330455705390090,92,110,116,93,72,77,48,42,560,90,650,13.846153846153847
22641,330455705390091,67,86,109,94,74,66,68,56,496,124,620,20.0
22642,330455705390092,90,114,103,104,130,74,64,43,615,107,722,14.81994459833795
22643,330455705390093,89,94,98,82,97,78,42,38,538,80,618,12.944983818770227
22644,330455705390094,40,61,65,94,79,58,84,78,397,162,559,28.980322003577818
22645,330455705390095,44,41,48,65,44,28,38,41,270,79,349,22.636103151862464
22646,330455705390096,57,104,64,70,65,54,42,40,414,82,496,16.532258064516128
22647,330455705390097,70,95,87,72,98,78,41,65,500,106,606,17.49174917491749
22648,330455705390098,82,101,90,103,80,81,47,36,537,83,620,13.387096774193548
22649,330455705390099,54,60,51,71,62,52,26,33,350,59,409,14.425427872860636
22650,330455705390100,51,57,45,56,82,45,39,25,336,64,400,16.0
22651,330455705390101,102,133,111,123,113,96,69,60,678,129,807,15.985130111524164
22652,330455705390102,106,140,151,128,109,110,62,56,744,118,862,13.689095127610209
22653,330455705390103,84,98,125,94,103,69,39,23,573,62,635,9.763779527559056
22654,330455705390104,141,180,129,116,123,73,38,31,762,69,831,8.303249097472925
22655,330455705390105,172,325,361,271,182,93,55,39,1404,94,1498,6.275033377837116
22656,330455705390106,93,103,108,104,87,81,51,29,576,80,656,12.195121951219512
22657,330455705390107,153,158,119,92,67,59,38,25,648,63,711,8.860759493670885
22658,330455705390108,148,209,181,128,109,96,59,43,871,102,973,10.483042137718396
22659,330455705390109,156,171,131,113,99,93,42,34,763,76,839,9.058402860548272
22660,330455705390110,80,157,110,65,54,40,27,12,506,39,545,7.155963302752293
22661,330455705390111,121,165,221,108,63,46,20,18,724,38,762,4.986876640419948
22662,330455705390112,112,200,192,121,79,58,39,4,762,43,805,5.341614906832298
22663,330455705390113,68,101,97,55,49,37,23,20,407,43,450,9.555555555555555
22664,330455705390114,17,31,18,25,20,10,6,5,121,11,132,8.333333333333334
22665,330455705390115,120,234,181,79,85,75,36,26,774,62,836,7.416267942583732
22666,330455705390116,63,82,85,85,69,73,42,26,457,68,525,12.952380952380953
22667,330455705390117,47,70,76,68,79,59,36,34,399,70,469,14.925373134328359
22668,330455705390118,60,82,75,75,75,58,37,33,425,70,495,14.141414141414142
22669,330455705390119,79,74,70,96,99,79,55,34,497,89,586,15.187713310580206
22670,330455705390120,108,120,117,107,112,92,55,58,656,113,769,14.694408322496749
22671,330455705390121,45,89,62,71,50,73,30,17,390,47,437,10.755148741418765
22672,330455705390122,62,99,75,90,63,58,44,25,447,69,516,13.372093023255815
22673,330455705390123,65,71,79,51,71,50,32,42,387,74,461,16.052060737527114
22674,330455705390124,45,89,69,59,63,44,41,25,369,66,435,15.172413793103448
22675,330455705390125,61,82,102,60,90,81,52,46,476,98,574,17.073170731707318
22676,330455705390126,129,119,132,109,99,78,58,42,666,100,766,13.054830287206267
22677,330455705390127,37,54,56,45,56,55,30,44,303,74,377,19.628647214854112
22678,330455705390128,62,75,77,75,61,57,39,36,407,75,482,15.560165975103734
22679,330455705390129,67,92,85,97,77,87,60,34,505,94,599,15.692821368948247
22680,330455705390130,116,113,124,94,87,91,56,36,625,92,717,12.831241283124129
22681,330455705390131,82,104,87,77,87,95,54,46,532,100,632,15.822784810126583
22682,330455705390132,64,82,86,75,80,67,43,19,454,62,516,12.015503875968992
22683,330455705390133,66,69,89,82,70,79,48,44,455,92,547,16.819012797074954
22684,330455705390134,77,69,100,56,68,70,38,36,440,74,514,14.396887159533074
22685,330455705390135,102,132,148,119,112,127,64,71,740,135,875,15.428571428571429
22686,330455705390136,71,97,118,105,109,71,51,51,571,102,673,15.156017830609212
22687,330455705390137,76,110,90,74,67,55,34,26,472,60,532,11.278195488721805
22688,330455705390138,75,114,91,89,100,62,35,37,531,72,603,11.940298507462687
22689,330455705390139,41,53,72,37,44,37,23,19,284,42,326,12.883435582822086
22690,330455705390140,99,110,114,84,97,66,41,39,570,80,650,12.307692307692308
22691,330455705390141,118,136,118,122,101,91,44,35,686,79,765,10.326797385620916
22692,330455705390142,171,207,201,212,154,95,71,28,1040,99,1139,8.691834942932397
22693,330455705390143,132,149,141,115,106,103,62,36,746,98,844,11.611374407582938
22694,330455705390144,106,140,149,111,120,86,48,35,712,83,795,10.440251572327044
22695,330455705390145,210,294,203,187,163,90,43,40,1147,83,1230,6.747967479674797
22696,330455705390146,42,66,67,96,74,78,38,29,423,67,490,13.673469387755102
22697,330455705390147,73,106,94,114,77,54,36,36,518,72,590,12.203389830508474
22698,330455705390148,32,33,58,43,53,55,28,28,274,56,330,16.96969696969697
22699,330455705390149,55,48,46,66,66,48,64,43,329,107,436,24.541284403669724
22700,330455705390150,37,50,37,56,47,41,41,17,268,58,326,17.791411042944784
22701,330455705390151,49,74,85,81,87,65,42,52,441,94,535,17.570093457943926
22702,330455705390152,64,75,103,95,79,79,44,31,495,75,570,13.157894736842104
22703,330455705390153,17,57,84,109,38,37,18,20,342,38,380,10.0
22704,330455705390154,35,47,47,65,53,44,43,39,291,82,373,21.98391420911528
22705,330455705390155,35,73,88,61,78,64,32,38,399,70,469,14.925373134328359
22706,330455705390156,40,33,48,48,48,32,24,27,249,51,300,17.0
22707,330455705390157,30,42,57,91,66,64,49,38,350,87,437,19.908466819221967
22708,330455705390158,69,88,303,141,66,77,21,12,744,33,777,4.2471042471042475
22709,330455705390159,134,197,233,88,109,62,37,19,823,56,879,6.370875995449374
22710,330455705390160,76,101,142,98,104,115,50,59,636,109,745,14.630872483221477
22711,330455705390161,50,67,61,70,70,52,33,35,370,68,438,15.525114155251142
22712,330455705390162,57,58,71,137,84,52,22,28,459,50,509,9.82318271119843
22713,330455705390163,59,99,106,92,95,105,46,74,556,120,676,17.75147928994083
22714,330455705390164,57,97,145,92,103,134,52,74,628,126,754,16.71087533156499
22715,330455705390165,14,47,49,31,47,46,24,34,234,58,292,19.863013698630137
22716,330455705390166,31,42,49,44,44,36,33,28,246,61,307,19.86970684039088
22717,330455705390167,36,57,61,63,68,74,35,41,359,76,435,17.471264367816094
22718,330455705390168,37,63,85,68,65,59,22,30,377,52,429,12.121212121212121
22719,330455705390169,58,63,65,62,68,68,37,32,384,69,453,15.2317880794702
22720,330455705390170,62,57,83,68,83,58,39,32,411,71,482,14.730290456431534
22721,330455705390171,48,96,89,83,97,83,40,53,496,93,589,15.789473684210526
22722,330455705390172,54,58,86,61,89,73,44,53,421,97,518,18.725868725868725
22723,330455705390173,75,81,103,105,92,78,62,56,534,118,652,18.098159509202453
22724,330455705390174,53,116,112,72,74,47,41,39,474,80,554,14.440433212996389
22725,330455705390175,77,141,203,82,71,53,18,21,627,39,666,5.8558558558558556
22726,330455705390176,16,28,21,30,18,17,5,4,130,9,139,6.474820143884892
22727,330455705390177,64,78,114,78,105,66,41,48,505,89,594,14.983164983164983
22728,330455705390178,38,35,74,77,61,46,30,39,331,69,400,17.25
22729,330455705390179,37,63,75,73,85,83,43,42,416,85,501,16.96606786427146
22730,330455705390180,61,80,92,71,68,67,38,36,439,74,513,14.42495126705653
22731,330455705390181,40,47,69,83,85,45,29,38,369,67,436,15.36697247706422
22732,330455705390182,27,35,59,39,53,42,29,38,255,67,322,20.80745341614907
22733,330455705390183,49,70,92,66,90,97,47,69,464,116,580,20.0
22734,330455705390184,122,152,147,128,124,98,60,70,771,130,901,14.428412874583795
22735,330455705390185,46,67,82,73,89,63,44,46,420,90,510,17.647058823529413
22736,330455705390186,68,102,90,83,103,81,44,46,527,90,617,14.586709886547812
22737,330455705390187,45,56,61,60,61,58,32,41,341,73,414,17.632850241545892
22738,330455705390188,125,142,127,154,155,118,48,54,821,102,923,11.05092091007584
22739,330455705390189,50,64,73,59,89,64,37,64,399,101,500,20.2
22740,330455705390190,44,73,72,64,67,65,30,36,385,66,451,14.634146341463415
22741,330455705390191,74,88,66,98,90,71,33,40,487,73,560,13.035714285714286
22742,330455705390192,39,51,42,58,57,49,36,32,296,68,364,18.681318681318682
22743,330455705390193,46,66,98,59,94,92,61,64,455,125,580,21.551724137931036
22744,330455705390194,36,45,58,36,55,44,25,35,274,60,334,17.964071856287426
22745,330455705390195,62,77,110,72,83,94,49,46,498,95,593,16.020236087689714
22746,330455705390196,86,133,131,105,139,101,47,59,695,106,801,13.233458177278402
22747,330455705390197,108,111,128,103,101,104,53,46,655,99,754,13.12997347480106
22748,330455705390198,253,338,530,270,198,148,61,31,1737,92,1829,5.030071077091307
22749,330455705390199,72,90,265,113,81,50,38,24,671,62,733,8.458390177353342
22750,330455705390200,145,153,281,112,90,49,31,17,830,48,878,5.466970387243736
22751,330455705390201,138,196,156,113,115,60,44,23,778,67,845,7.928994082840236
22752,330455705390202,113,118,99,101,70,40,29,25,541,54,595,9.07563025210084
22753,330455705390203,193,237,167,169,140,78,22,21,984,43,1027,4.186952288218111
22754,330455705390204,137,184,105,109,51,35,26,9,621,35,656,5.335365853658536
22755,330455705390205,197,179,164,150,109,60,27,15,859,42,901,4.661487236403995
22756,330455705390206,167,253,232,189,170,95,43,35,1106,78,1184,6.587837837837838
22757,330455705390207,247,266,223,167,145,66,26,28,1114,54,1168,4.623287671232877
22758,330455705390208,173,180,104,117,69,41,25,12,684,37,721,5.1317614424410545
22759,330455705390209,38,66,75,64,54,37,27,17,334,44,378,11.640211640211641
22760,330455705390210,62,72,62,73,70,43,40,47,382,87,469,18.550106609808104
22761,330455705390211,83,114,104,77,59,55,28,24,492,52,544,9.558823529411764
22762,330455705390212,45,48,44,56,42,42,34,27,277,61,338,18.047337278106507
22763,330455705390213,40,85,86,100,63,58,25,35,432,60,492,12.195121951219512
22764,330455705390214,47,57,67,66,61,62,41,45,360,86,446,19.282511210762333
22765,330455705390215,65,116,111,78,56,41,21,21,467,42,509,8.25147347740668
22766,330455705390216,59,54,66,66,61,40,43,38,346,81,427,18.969555035128806
22767,330455705390217,47,47,44,58,54,26,25,21,276,46,322,14.285714285714286
22768,330455705390218,50,59,65,48,60,48,33,29,330,62,392,15.816326530612244
22769,330455705390219,56,49,55,60,47,48,31,13,315,44,359,12.256267409470752
22770,330455705390220,52,75,133,50,71,43,14,17,424,31,455,6.813186813186813
22771,330455705390221,86,112,78,70,77,47,17,18,470,35,505,6.930693069306931
22772,330455705390222,83,105,80,87,49,54,24,13,458,37,495,7.474747474747475
22773,330455705390223,48,80,79,68,63,53,39,36,391,75,466,16.09442060085837
22774,330455705390224,74,69,62,46,44,20,9,15,315,24,339,7.079646017699115
22775,330455705390225,38,61,126,40,13,19,16,8,297,24,321,7.4766355140186915
22776,330455705390226,3,16,8,3,10,5,7,1,45,8,53,15.09433962264151
22777,330455705390227,11,22,34,15,17,21,14,5,120,19,139,13.66906474820144
22778,330460705000001,71,106,99,76,109,98,66,69,559,135,694,19.45244956772334
22779,330460705000002,62,98,93,84,85,74,45,49,496,94,590,15.932203389830509
22780,330460705000003,180,191,194,192,194,157,77,93,1108,170,1278,13.302034428794991
22781,330460705000004,160,183,143,145,126,104,61,71,861,132,993,13.293051359516616
22782,330460705000005,62,81,94,100,73,103,58,61,513,119,632,18.829113924050635
22783,330460705000006,17,27,19,20,22,26,15,9,131,24,155,15.483870967741936
22784,330460705000007,45,63,46,57,42,48,39,24,301,63,364,17.307692307692307
22785,330460705000008,45,67,47,40,48,41,35,27,288,62,350,17.714285714285715
22786,330460705000009,38,40,30,24,32,33,10,14,197,24,221,10.85972850678733
22787,330460705000011,26,28,34,31,36,35,19,24,190,43,233,18.454935622317596
22788,330460705000012,50,66,65,89,78,48,33,28,396,61,457,13.347921225382931
22789,330460710000001,10,6,3,11,2,3,1,3,35,4,39,10.256410256410257
22790,330460710000002,60,59,55,47,45,42,23,19,308,42,350,12.0
22791,330460710000003,77,89,67,75,60,52,27,22,420,49,469,10.447761194029852
22792,330460710000004,56,84,50,71,78,61,41,34,400,75,475,15.789473684210526
22795,330460720000001,31,35,28,21,29,14,13,21,158,34,192,17.708333333333332
22796,330460720000002,86,118,82,78,85,64,51,38,513,89,602,14.784053156146179
22799,330460720000005,32,57,29,32,26,25,15,4,201,19,220,8.636363636363637
22800,330460720000006,68,64,43,61,45,42,29,15,323,44,367,11.989100817438691
22801,330460720000007,24,36,22,22,26,30,9,10,160,19,179,10.614525139664805
22802,330460725000001,11,13,19,12,15,5,8,8,75,16,91,17.582417582417584
22805,330460730000001,78,123,97,104,97,93,67,72,592,139,731,19.01504787961696
22806,330460730000002,26,37,25,32,25,28,13,12,173,25,198,12.626262626262626
22807,330470605000001,68,88,95,85,120,92,63,80,548,143,691,20.69464544138929
22808,330470605000002,0,0,0,0,3,7,13,41,10,54,64,84.375
22809,330470605000003,55,81,73,84,102,82,65,76,477,141,618,22.815533980582526
22810,330470605000004,47,73,84,79,74,58,55,62,415,117,532,21.992481203007518
22811,330470605000005,66,93,99,114,103,81,97,82,556,179,735,24.35374149659864
22812,330470605000006,33,64,44,64,72,78,55,56,355,111,466,23.819742489270386
22813,330470605000007,117,137,153,154,136,129,69,80,826,149,975,15.282051282051283
22814,330470605000008,81,104,125,89,124,85,70,59,608,129,737,17.5033921302578
22815,330470605000009,60,74,88,85,101,85,58,80,493,138,631,21.870047543581617
22816,330470605000010,140,143,164,166,128,86,64,41,827,105,932,11.266094420600858
22817,330470605000011,81,105,108,79,99,102,72,77,574,149,723,20.608575380359614
22818,330470605000012,58,77,56,65,66,67,59,32,389,91,480,18.958333333333332
22819,330470605000013,124,146,148,176,152,128,79,71,874,150,1024,14.6484375
22820,330470605000014,146,184,174,178,165,135,70,67,982,137,1119,12.243074173369079
22821,330470605000015,51,88,102,81,78,72,58,28,472,86,558,15.412186379928315
22822,330470605000016,134,122,152,125,136,102,69,56,771,125,896,13.950892857142858
22823,330470605000017,101,101,113,112,98,71,57,41,596,98,694,14.121037463976945
22824,330470605000018,128,193,174,175,136,137,73,62,943,135,1078,12.523191094619666
22825,330470605000019,95,138,126,155,150,106,76,68,770,144,914,15.75492341356674
22826,330470605000020,108,107,104,127,159,118,71,67,723,138,861,16.027874564459932
22827,330470605000021,100,99,120,114,111,90,61,51,634,112,746,15.013404825737265
22828,330470605000022,129,155,157,150,128,106,81,61,825,142,967,14.68459152016546
22829,330470605000023,62,87,81,78,67,49,44,33,424,77,501,15.369261477045908
22830,330470605000024,124,165,130,133,111,84,65,51,747,116,863,13.441483198146003
22831,330470605000025,197,225,239,210,177,125,67,81,1173,148,1321,11.203633610900832
22832,330470605000026,153,169,146,145,115,104,45,45,832,90,922,9.761388286334057
22833,330470605000027,87,101,106,104,113,76,60,45,587,105,692,15.173410404624278
22834,330470605000028,118,155,151,158,135,108,87,58,825,145,970,14.948453608247423
22835,330470605000029,26,26,27,28,22,27,22,10,156,32,188,17.02127659574468
22836,330470605000030,49,59,57,58,48,42,38,20,313,58,371,15.633423180592992
22837,330470605000031,39,53,40,41,49,27,28,16,249,44,293,15.017064846416382
22838,330470605000032,16,28,27,29,30,13,18,7,143,25,168,14.880952380952381
22839,330470605000033,111,136,132,152,125,78,50,34,734,84,818,10.268948655256724
22840,330470605000034,102,111,135,100,102,86,50,45,636,95,731,12.995896032831737
22841,330470615000001,34,49,29,33,37,21,12,17,203,29,232,12.5
22842,330470615000002,18,26,17,24,28,13,12,14,126,26,152,17.105263157894736
22843,330470615000003,23,32,18,30,31,19,20,14,153,34,187,18.181818181818183
22844,330470617000001,102,84,93,95,71,73,45,33,518,78,596,13.087248322147651
22845,330470617000002,12,14,7,15,11,6,6,4,65,10,75,13.333333333333334
22846,330470620000001,32,46,55,48,52,42,34,39,275,73,348,20.977011494252874
22847,330470620000002,10,8,17,13,16,9,15,14,73,29,102,28.431372549019606
22848,330470620000003,21,30,33,19,22,44,13,17,169,30,199,15.075376884422111
22849,330470625000001,96,120,110,122,100,96,71,52,644,123,767,16.03650586701434
22850,330470625000002,4,14,6,11,8,7,3,4,50,7,57,12.280701754385966
22851,330470625000003,15,41,14,28,34,30,20,19,162,39,201,19.402985074626866
22852,330470625000004,16,24,14,27,31,14,15,19,126,34,160,21.25
22853,330470630000001,107,139,137,137,130,114,58,70,764,128,892,14.349775784753364
22854,330470630000002,41,80,56,52,74,60,51,68,363,119,482,24.688796680497926
22855,330470630000003,54,63,63,65,51,43,38,35,339,73,412,17.718446601941746
22856,330470630000004,54,84,59,50,54,37,37,38,338,75,413,18.159806295399516
22857,330470635000001,43,55,59,34,47,48,21,26,286,47,333,14.114114114114114
22858,330470635000002,107,145,119,136,102,61,52,27,670,79,749,10.54739652870494
22859,330470635000003,138,145,143,128,126,67,44,27,747,71,818,8.679706601466993
22860,330470635000004,96,151,121,102,121,56,35,28,647,63,710,8.873239436619718
22861,330470635000005,133,132,130,105,112,62,51,41,674,92,766,12.010443864229766
22862,330470635000006,5,5,4,2,2,4,1,0,22,1,23,4.3478260869565215
22863,330470635000007,30,43,32,34,38,31,21,17,208,38,246,15.447154471544716
22864,330470635000008,130,123,117,119,100,74,40,21,663,61,724,8.425414364640885
22865,330470640000001,125,128,112,116,97,81,72,49,659,121,780,15.512820512820513
22866,330470640000002,42,49,47,44,50,46,52,25,278,77,355,21.690140845070424
22867,330470640000003,4,2,8,3,3,9,11,4,29,15,44,34.09090909090909
22868,330470640000004,11,29,10,16,20,15,6,9,101,15,116,12.931034482758621
22869,330470650000001,82,93,110,114,116,54,59,51,569,110,679,16.200294550810014
22870,330470650000002,37,53,42,60,49,31,19,22,272,41,313,13.099041533546325
22871,330470650000003,60,77,73,100,81,61,38,46,452,84,536,15.671641791044776
22872,330470650000004,86,112,113,117,75,83,49,37,586,86,672,12.797619047619047
22873,330470650000005,148,170,204,178,166,99,55,46,965,101,1066,9.47467166979362
22874,330470650000006,49,72,47,57,41,45,21,14,311,35,346,10.115606936416185
22875,330470650000007,66,86,69,91,67,55,55,39,434,94,528,17.803030303030305
22876,330470650000008,17,44,32,31,57,33,32,22,214,54,268,20.149253731343283
22877,330470650000009,123,139,189,172,130,99,62,49,852,111,963,11.526479750778817
22878,330475505000001,115,134,124,134,96,64,30,40,667,70,737,9.49796472184532
22879,330475505000002,140,144,126,154,104,59,51,30,727,81,808,10.024752475247524
22880,330475505000003,118,126,162,137,116,96,68,42,755,110,865,12.716763005780347
22881,330475505000004,128,170,161,153,144,86,54,29,842,83,925,8.972972972972974
22883,330475505000006,26,35,28,22,18,11,14,5,140,19,159,11.949685534591195
22884,330475505000007,20,19,19,22,15,21,15,9,116,24,140,17.142857142857142
22885,330475505000008,12,17,12,15,21,16,2,7,93,9,102,8.823529411764707
22886,330475505000009,12,20,7,22,15,14,9,5,90,14,104,13.461538461538462
22887,330475505000010,15,20,15,20,20,16,13,7,106,20,126,15.873015873015873
22888,330475505000011,25,22,25,22,21,25,15,5,140,20,160,12.5
22889,330475505000012,8,15,17,8,14,11,10,1,73,11,84,13.095238095238095
22890,330475505000013,11,15,16,6,11,17,13,5,76,18,94,19.148936170212767
22891,330475505000014,14,8,15,10,6,9,11,4,62,15,77,19.48051948051948
22892,330475505000015,94,126,112,121,96,58,51,43,607,94,701,13.40941512125535
22893,330475505000016,25,50,32,36,32,16,14,9,191,23,214,10.74766355140187
22894,330475505000017,96,95,109,106,96,75,59,40,577,99,676,14.644970414201184
22895,330475505000018,69,107,75,80,66,41,27,20,438,47,485,9.690721649484535
22896,330475505000019,11,8,19,5,13,13,6,4,69,10,79,12.658227848101266
22897,330475505000020,7,13,6,8,15,7,10,3,56,13,69,18.840579710144926
22898,330475505000021,85,99,82,92,82,53,34,37,493,71,564,12.588652482269504
22899,330475505000022,68,70,82,56,49,49,21,5,374,26,400,6.5
22900,330475505000023,70,94,100,91,76,38,23,31,469,54,523,10.325047801147228
22901,330475505000024,50,56,53,57,43,44,15,20,303,35,338,10.355029585798816
22902,330475505000025,134,189,162,138,142,81,63,46,846,109,955,11.413612565445026
22903,330475505000026,32,55,72,52,37,23,16,7,271,23,294,7.8231292517006805
22904,330475505000027,136,135,104,127,74,63,59,33,639,92,731,12.585499316005471
22905,330475505000028,65,81,78,81,51,48,30,20,404,50,454,11.013215859030836
22906,330475505000029,101,123,115,93,64,56,63,38,552,101,653,15.46707503828484
22907,330475505000030,62,83,78,59,55,46,18,16,383,34,417,8.15347721822542
22908,330475505000031,90,83,80,71,64,40,21,21,428,42,470,8.936170212765957
22910,330475505000033,31,40,32,31,36,32,11,11,202,22,224,9.821428571428571
22911,330475505000034,69,80,58,55,56,59,25,17,377,42,419,10.023866348448687
22912,330475505000035,113,109,117,98,84,61,35,38,582,73,655,11.145038167938932
22913,330475505000036,38,62,47,43,32,25,18,18,247,36,283,12.720848056537102
22914,330475505000037,186,201,188,191,141,121,74,49,1028,123,1151,10.686359687228498
22915,330475505000038,101,89,102,88,85,61,28,24,526,52,578,8.996539792387543
22916,330475505000039,90,115,91,73,76,38,28,20,483,48,531,9.03954802259887
22917,330475505000040,14,14,13,12,13,8,0,4,74,4,78,5.128205128205129
22918,330475505000041,49,61,39,60,35,27,16,22,271,38,309,12.297734627831716
22919,330475505000042,14,27,13,7,15,13,14,8,89,22,111,19.81981981981982
22920,330475505000043,26,26,25,22,29,24,10,5,152,15,167,8.982035928143713
22921,330475505000044,90,99,59,63,48,58,33,18,417,51,468,10.897435897435898
22922,330475505000045,18,18,18,16,13,6,10,4,89,14,103,13.592233009708737
22923,330475505000046,42,39,73,56,42,29,28,9,281,37,318,11.635220125786164
22924,330475505000047,33,58,49,44,27,30,12,17,241,29,270,10.74074074074074
22925,330475505000048,107,150,129,103,94,63,34,23,646,57,703,8.108108108108109
22926,330475505000049,54,94,72,75,57,30,15,10,382,25,407,6.142506142506143
22927,330475505000050,16,15,23,18,23,21,13,9,116,22,138,15.942028985507246
22928,330475505000051,8,19,7,13,12,10,6,4,69,10,79,12.658227848101266
22929,330475505000052,114,76,100,76,58,48,20,24,472,44,516,8.527131782945736
22930,330475505000053,98,120,84,88,67,71,38,41,528,79,607,13.014827018121911
22931,330475505000054,82,100,91,67,61,44,22,16,445,38,483,7.867494824016563
22932,330475510000001,66,66,72,59,56,55,22,33,374,55,429,12.820512820512821
22933,330475510000002,15,45,25,32,18,24,25,12,159,37,196,18.877551020408163
22934,330475510000003,148,171,131,130,128,63,58,55,771,113,884,12.782805429864254
22935,330475510000004,35,68,49,45,65,57,25,30,319,55,374,14.705882352941176
22936,330475510000005,114,131,121,104,95,89,35,42,654,77,731,10.533515731874145
22937,330475510000006,80,100,96,92,86,78,37,54,532,91,623,14.606741573033707
22938,330475510000007,53,80,60,66,71,38,43,40,368,83,451,18.403547671840354
22939,330475510000008,87,104,91,89,92,73,46,57,536,103,639,16.118935837245697
22940,330475510000009,46,67,45,47,38,41,12,27,284,39,323,12.074303405572756
22941,330475510000010,95,127,114,114,95,79,50,33,624,83,707,11.73974540311174
22942,330475510000011,40,31,47,39,37,25,26,13,219,39,258,15.116279069767442
22943,330475510000012,7,9,18,8,11,17,13,10,70,23,93,24.731182795698924
22944,330475510000013,38,54,60,43,40,33,24,30,268,54,322,16.770186335403725
22945,330475510000014,32,43,42,31,40,22,24,16,210,40,250,16.0
22946,330475510000015,4,9,7,9,12,10,10,4,51,14,65,21.53846153846154
22947,330475510000016,54,67,61,50,38,40,23,22,310,45,355,12.67605633802817
22948,330475510000017,67,104,84,85,75,57,46,43,472,89,561,15.864527629233512
22949,330475510000018,86,96,66,74,54,35,35,20,411,55,466,11.802575107296137
22950,330475510000019,126,143,103,113,96,59,45,50,640,95,735,12.92517006802721
22951,330475510000020,100,113,101,95,83,68,62,38,560,100,660,15.151515151515152
22952,330475510000021,18,33,29,13,29,16,14,11,138,25,163,15.337423312883436
22953,330475510000022,65,66,63,46,53,58,28,32,351,60,411,14.598540145985401
22954,330475510000023,95,125,65,75,71,15,34,26,446,60,506,11.857707509881424
22955,330475510000024,13,20,16,12,10,13,8,10,84,18,102,17.647058823529413
22956,330475510000025,77,88,109,54,59,54,34,32,441,66,507,13.017751479289942
22957,330475510000026,38,44,28,36,26,18,11,7,190,18,208,8.653846153846153
22958,330475510000027,37,42,24,32,28,28,20,12,191,32,223,14.349775784753364
22959,330475510000028,27,39,26,38,34,16,8,13,180,21,201,10.447761194029852
22960,330475510000029,11,17,11,15,22,19,6,7,95,13,108,12.037037037037036
22961,330475510000030,32,31,42,27,35,26,11,13,193,24,217,11.059907834101383
22962,330475510000031,108,128,104,87,85,63,35,24,575,59,634,9.305993690851736
22963,330475515000001,106,101,69,81,57,58,27,39,472,66,538,12.267657992565056
22964,330475515000002,83,101,81,88,55,54,45,45,462,90,552,16.304347826086957
22965,330475515000003,157,220,123,132,122,90,57,63,844,120,964,12.448132780082988
22966,330475515000004,82,127,98,89,91,79,55,36,566,91,657,13.850837138508371
22967,330475515000005,39,52,47,36,44,46,23,25,264,48,312,15.384615384615385
22968,330475515000006,93,121,123,118,120,93,58,46,668,104,772,13.471502590673575
22969,330475515000007,58,81,69,57,80,46,31,34,391,65,456,14.25438596491228
22970,330475515000008,68,74,76,58,44,36,23,21,356,44,400,11.0
22971,330475515000009,40,62,48,37,38,22,32,26,247,58,305,19.016393442622952
22972,330475515000010,48,62,57,31,36,26,17,13,260,30,290,10.344827586206897
22973,330475515000011,65,99,104,106,82,85,54,33,541,87,628,13.853503184713375
22974,330475515000012,60,57,66,53,50,62,32,22,348,54,402,13.432835820895523
22975,330475515000013,13,21,14,10,23,16,6,2,97,8,105,7.619047619047619
22976,330475515000014,17,28,21,14,19,9,5,7,108,12,120,10.0
22977,330475515000015,39,42,48,28,28,41,11,22,226,33,259,12.741312741312742
22978,330475515000016,13,20,11,15,23,16,5,9,98,14,112,12.5
22979,330475515000017,20,31,21,26,19,17,16,17,134,33,167,19.760479041916167
22980,330475515000018,21,19,20,22,21,15,7,7,118,14,132,10.606060606060606
22981,330475515000019,47,73,74,66,86,39,18,26,385,44,429,10.256410256410257
22982,330475515000020,38,55,36,49,66,45,19,21,289,40,329,12.158054711246201
22983,330480505000001,50,63,69,56,64,52,56,57,354,113,467,24.197002141327623
22984,330480505000002,32,61,61,54,85,58,43,67,351,110,461,23.86117136659436
22985,330480505000003,58,70,84,83,65,54,66,90,414,156,570,27.36842105263158
22986,330480505000004,117,135,136,136,156,121,82,65,801,147,948,15.50632911392405
22987,330480505000005,62,89,109,71,73,104,66,68,508,134,642,20.87227414330218
22988,330480505000006,127,180,176,154,169,98,73,60,904,133,1037,12.825458052073289
22989,330480505000007,109,123,123,123,129,90,65,60,697,125,822,15.206812652068127
22990,330480505000008,161,191,121,131,86,71,37,25,761,62,823,7.533414337788578
22991,330480505000009,66,95,72,81,63,41,42,23,418,65,483,13.457556935817806
22992,330480505000010,126,142,141,139,114,104,70,52,766,122,888,13.73873873873874
22993,330480505000011,112,146,115,135,115,67,47,33,690,80,770,10.38961038961039
22994,330480505000012,74,116,100,87,101,71,40,55,549,95,644,14.751552795031056
22995,330480505000013,86,94,100,73,102,75,49,41,530,90,620,14.516129032258064
22996,330480505000014,67,86,89,84,81,56,52,35,463,87,550,15.818181818181818
22997,330480505000015,62,80,91,74,79,66,45,34,452,79,531,14.87758945386064
22998,330480505000016,108,117,93,123,114,67,66,63,622,129,751,17.177097203728362
22999,330480505000017,84,90,107,102,82,54,38,31,519,69,588,11.73469387755102
23000,330480505000018,82,82,94,84,87,61,89,41,490,130,620,20.967741935483872
23001,330480505000019,68,75,110,70,80,76,70,63,479,133,612,21.73202614379085
23002,330480505000020,119,132,153,132,138,113,54,54,787,108,895,12.067039106145252
23003,330480505000021,93,117,107,121,97,63,79,75,598,154,752,20.47872340425532
23004,330480505000022,80,95,116,86,91,83,46,50,551,96,647,14.837712519319938
23005,330480505000023,95,105,133,123,102,88,45,41,646,86,732,11.748633879781421
23006,330480505000024,64,87,81,79,96,65,43,37,472,80,552,14.492753623188406
23007,330480505000025,39,73,50,67,50,46,31,45,325,76,401,18.952618453865338
23008,330480505000026,25,35,47,43,48,48,34,17,246,51,297,17.171717171717173
23009,330480505000027,40,47,54,46,33,39,19,31,259,50,309,16.181229773462782
23010,330480505000028,47,74,53,58,68,55,42,26,355,68,423,16.07565011820331
23011,330480505000029,11,16,17,17,22,16,19,7,99,26,125,20.8
23012,330480505000030,9,22,15,15,19,10,10,5,90,15,105,14.285714285714286
23013,330480505000031,5,8,5,7,6,8,5,2,39,7,46,15.217391304347826
23014,330480505000032,6,4,7,6,6,5,3,3,34,6,40,15.0
23015,330480505000033,37,46,35,38,26,28,7,11,210,18,228,7.894736842105263
23016,330480505000034,44,68,47,60,51,44,36,23,314,59,373,15.817694369973191
23017,330480505000036,42,73,72,54,59,74,38,86,374,124,498,24.899598393574298
23018,330480505000037,94,116,100,77,65,45,26,32,497,58,555,10.45045045045045
23019,330480505000038,81,90,90,70,76,63,29,38,470,67,537,12.476722532588454
23020,330480505000039,87,105,134,108,73,75,28,35,582,63,645,9.767441860465116
23021,330480505000040,141,156,153,141,150,81,48,42,822,90,912,9.868421052631579
23022,330480505000041,115,121,133,140,93,81,57,50,683,107,790,13.544303797468354
23023,330480505000042,69,76,112,67,99,71,57,46,494,103,597,17.252931323283082
23024,330480510000001,22,51,18,45,34,26,29,29,196,58,254,22.834645669291337
23025,330480510000002,60,75,60,79,57,39,49,31,370,80,450,17.77777777777778
23026,330480510000003,52,72,45,63,43,57,39,22,332,61,393,15.521628498727736
23027,330480510000004,46,99,52,59,66,63,33,32,385,65,450,14.444444444444445
23029,330480510000006,22,49,19,35,42,29,29,21,196,50,246,20.32520325203252
23030,330480510000007,48,64,40,44,35,27,33,21,258,54,312,17.307692307692307
23032,330480515000001,47,57,53,57,53,46,37,45,313,82,395,20.759493670886076
23033,330480515000002,100,125,129,112,129,95,65,52,690,117,807,14.49814126394052
23034,330480515000003,47,54,51,41,52,43,10,14,288,24,312,7.6923076923076925
23035,330480515000004,73,73,65,78,78,61,51,33,428,84,512,16.40625
23036,330480515000005,16,19,23,16,18,23,11,17,115,28,143,19.58041958041958
23037,330480515000006,42,62,50,54,59,54,44,52,321,96,417,23.02158273381295
23038,330480515000007,54,62,58,43,64,43,41,26,324,67,391,17.135549872122763
23039,330480515000008,19,25,22,24,33,18,11,14,141,25,166,15.060240963855422
23040,330480520000001,105,159,132,156,130,102,69,48,784,117,901,12.985571587125417
23041,330480520000002,97,103,113,101,102,85,64,56,601,120,721,16.643550624133148
23042,330480520000003,76,65,82,82,69,69,44,43,443,87,530,16.41509433962264
23043,330480520000004,93,107,126,107,103,83,54,35,619,89,708,12.570621468926554
23044,330480520000005,46,68,87,78,71,62,56,67,412,123,535,22.990654205607477
23045,330480520000006,4,2,1,6,3,0,1,2,16,3,19,15.789473684210526
23046,330480520000007,39,41,39,29,33,24,16,16,205,32,237,13.50210970464135
23047,330480520000008,16,22,26,17,19,16,12,14,116,26,142,18.309859154929576
23048,330480520000009,38,32,42,35,38,33,36,27,218,63,281,22.419928825622776
23049,330480520000010,24,40,35,39,37,28,26,15,203,41,244,16.80327868852459
23050,330480520000011,15,26,28,22,34,35,29,17,160,46,206,22.33009708737864
23051,330480520000012,14,28,20,19,16,19,12,10,116,22,138,15.942028985507246
23052,330480520000013,90,92,72,102,65,51,30,36,472,66,538,12.267657992565056
23053,330480520000014,81,115,100,114,118,74,46,48,602,94,696,13.505747126436782
23054,330480525000001,60,75,74,61,70,61,38,78,401,116,517,22.437137330754354
23055,330480525000002,74,83,79,88,71,52,50,51,447,101,548,18.43065693430657
23056,330480525000003,14,21,10,10,23,15,10,13,93,23,116,19.82758620689655
23057,330480525000004,9,10,9,5,9,8,5,7,50,12,62,19.35483870967742
23058,330480525000005,19,47,48,27,50,25,21,15,216,36,252,14.285714285714286
23059,330480525000006,33,44,28,35,44,38,26,20,222,46,268,17.16417910447761
23060,330480525000007,16,24,19,18,19,12,13,14,108,27,135,20.0
23061,330480525000008,23,37,18,38,46,40,29,20,202,49,251,19.52191235059761
23062,330480525000009,9,20,21,21,22,33,20,22,126,42,168,25.0
23063,330480525000010,48,75,86,71,67,75,60,60,422,120,542,22.14022140221402
23064,330490405000001,55,85,76,103,88,82,47,62,489,109,598,18.22742474916388
23065,330490405000002,134,180,172,164,168,127,78,62,945,140,1085,12.903225806451612
23066,330490405000003,73,74,87,67,76,60,27,31,437,58,495,11.717171717171718
23067,330490405000004,66,80,89,97,80,81,57,28,493,85,578,14.705882352941176
23068,330490405000005,55,58,53,62,70,58,34,28,356,62,418,14.832535885167465
23069,330490405000006,38,56,62,87,68,58,28,27,369,55,424,12.971698113207546
23070,330490405000007,68,89,104,99,75,87,54,66,522,120,642,18.69158878504673
23071,330490405000008,57,100,92,78,89,88,45,60,504,105,609,17.24137931034483
23072,330490405000009,72,72,94,110,97,93,48,36,538,84,622,13.504823151125402
23073,330490405000010,56,65,74,70,91,68,45,45,424,90,514,17.509727626459146
23074,330490405000011,77,115,122,152,112,137,107,53,715,160,875,18.285714285714285
23075,330490405000012,80,105,98,135,109,120,70,56,647,126,773,16.30012936610608
23076,330490405000013,88,133,142,147,156,146,78,76,812,154,966,15.942028985507246
23077,330490405000014,56,68,74,71,84,44,23,22,397,45,442,10.180995475113122
23078,330490405000015,3,4,6,7,2,3,3,2,25,5,30,16.666666666666668
23079,330490405000016,53,68,72,69,70,54,41,22,386,63,449,14.031180400890868
23080,330490405000017,30,53,58,41,75,54,32,55,311,87,398,21.85929648241206
23081,330490405000018,59,51,85,75,59,63,30,26,392,56,448,12.5
23082,330490405000019,36,40,66,66,47,55,41,41,310,82,392,20.918367346938776
23083,330490405000020,0,0,0,0,0,0,0,50,0,50,50,100.0
23084,330490405000021,49,54,66,75,66,48,34,23,358,57,415,13.734939759036145
23085,330490405000022,42,53,77,104,68,109,84,38,453,122,575,21.217391304347824
23086,330490405000023,40,77,106,95,95,67,46,33,480,79,559,14.132379248658319
23087,330490405000024,44,83,75,94,88,91,50,46,475,96,571,16.81260945709282
23088,330490405000025,111,181,172,134,230,104,42,26,932,68,1000,6.8
23089,330490405000026,115,174,178,152,200,117,33,32,936,65,1001,6.4935064935064934
23090,330490405000027,49,116,117,95,183,80,31,17,640,48,688,6.976744186046512
23091,330490405000028,76,90,153,154,96,85,39,36,654,75,729,10.2880658436214
23092,330490405000029,96,109,141,129,151,124,78,60,750,138,888,15.54054054054054
23093,330490405000030,89,112,105,121,130,86,88,62,643,150,793,18.915510718789406
23094,330490405000031,39,55,78,74,69,52,45,25,367,70,437,16.018306636155607
23095,330490405000032,94,108,147,134,117,97,55,36,697,91,788,11.548223350253807
23096,330490405000033,40,40,75,50,47,39,19,14,291,33,324,10.185185185185185
23097,330490405000034,44,64,64,70,49,47,27,20,338,47,385,12.207792207792208
23098,330490405000035,151,200,211,199,148,124,47,56,1033,103,1136,9.066901408450704
23099,330490405000036,95,143,106,101,96,80,44,43,621,87,708,12.288135593220339
23100,330490405000037,105,108,120,118,99,97,53,39,647,92,739,12.449255751014885
23101,330490405000038,32,49,36,46,37,32,19,5,232,24,256,9.375
23102,330490405000039,68,111,95,108,83,76,40,38,541,78,619,12.60096930533118
23103,330490405000040,21,31,72,36,43,54,17,12,257,29,286,10.13986013986014
23104,330490405000041,71,125,158,124,150,120,96,105,748,201,949,21.180189673340358
23105,330490405000042,1,0,0,0,0,5,61,111,6,172,178,96.62921348314607
23106,330490405000043,59,81,105,127,68,107,81,57,547,138,685,20.145985401459853
23107,330490405000044,45,84,103,115,100,103,80,53,550,133,683,19.472913616398245
23108,330490405000045,59,60,67,69,67,41,32,33,363,65,428,15.186915887850468
23109,330490405000046,98,131,147,179,149,122,85,73,826,158,984,16.056910569105693
23110,330490405000047,55,48,75,49,48,59,33,42,334,75,409,18.337408312958434
23111,330490405000048,29,55,68,62,50,55,32,26,319,58,377,15.384615384615385
23112,330490405000049,68,111,101,129,122,95,54,34,626,88,714,12.324929971988796
23113,330490405000050,44,34,64,53,63,45,43,42,303,85,388,21.90721649484536
23114,330490405000051,16,10,32,13,18,15,9,17,104,26,130,20.0
23115,330490405000052,49,67,103,83,86,62,49,51,450,100,550,18.181818181818183
23116,330490405000053,26,66,43,57,50,65,32,30,307,62,369,16.802168021680217
23117,330490405000054,54,84,90,87,85,78,50,60,478,110,588,18.707482993197278
23118,330490405000055,42,50,74,80,73,54,48,47,373,95,468,20.299145299145298
23119,330490405000056,24,44,73,43,58,47,40,46,289,86,375,22.933333333333334
23120,330490405000057,71,86,136,85,100,98,58,67,576,125,701,17.83166904422254
23121,330490405000058,93,109,155,129,158,115,91,63,759,154,913,16.867469879518072
23122,330490405000059,76,95,100,94,99,64,59,37,528,96,624,15.384615384615385
23123,330490405000060,119,125,202,144,108,109,78,32,807,110,917,11.995637949836423
23124,330490405000061,79,100,100,103,120,97,75,46,599,121,720,16.805555555555557
23125,330490405000062,57,70,105,74,85,65,35,52,456,87,543,16.022099447513813
23126,330490405000063,41,53,53,49,65,53,32,27,314,59,373,15.817694369973191
23127,330490405000064,60,76,92,89,87,89,37,37,493,74,567,13.051146384479718
23128,330490405000065,105,143,142,158,123,135,96,59,806,155,961,16.129032258064516
23129,330490405000066,37,85,55,70,75,54,26,41,376,67,443,15.124153498871332
23130,330490405000067,115,115,138,140,108,86,23,18,702,41,743,5.518169582772543
23131,330490405000068,56,66,130,100,109,109,75,44,570,119,689,17.271407837445572
23132,330490405000069,39,66,86,61,92,82,48,70,426,118,544,21.691176470588236
23133,330490405000070,92,139,190,182,158,159,99,81,920,180,1100,16.363636363636363
23134,330490405000071,34,44,50,46,63,53,26,30,290,56,346,16.184971098265898
23135,330490405000072,74,98,113,108,96,97,50,46,586,96,682,14.07624633431085
23136,330490405000073,78,110,134,80,98,74,46,21,574,67,641,10.45241809672387
23137,330490405000074,69,86,79,110,85,74,41,28,503,69,572,12.062937062937063
23138,330490405000075,65,77,104,108,95,105,71,67,554,138,692,19.942196531791907
23139,330490405000076,44,83,106,114,103,96,53,51,546,104,650,16.0
23140,330490405000077,53,92,97,113,145,98,87,86,598,173,771,22.438391699092087
23141,330490405000078,67,91,89,104,82,73,50,39,506,89,595,14.957983193277311
23142,330490405000079,82,91,122,101,103,80,41,43,579,84,663,12.669683257918551
23143,330490405000080,67,96,103,98,106,82,38,50,552,88,640,13.75
23144,330490405000081,94,99,101,121,120,98,83,54,633,137,770,17.792207792207794
23145,330490405000082,84,91,95,91,94,70,40,37,525,77,602,12.790697674418604
23146,330490405000083,43,60,70,53,69,56,32,22,351,54,405,13.333333333333334
23147,330490405000084,35,50,46,50,51,45,21,25,277,46,323,14.241486068111454
23148,330490405000085,64,72,69,83,76,73,45,34,437,79,516,15.310077519379846
23149,330490405000086,31,45,55,58,59,47,33,28,295,61,356,17.134831460674157
23150,330490405000087,40,60,59,59,67,62,38,34,347,72,419,17.183770883054894
23151,330490405000088,36,63,62,57,60,39,36,24,317,60,377,15.915119363395226
23152,330490405000089,113,138,151,141,133,128,73,85,804,158,962,16.424116424116423
23153,330490405000090,101,96,102,94,101,85,53,30,579,83,662,12.537764350453172
23154,330490405000091,43,81,54,60,65,40,37,20,343,57,400,14.25
23155,330490405000092,70,100,100,98,93,86,29,28,547,57,604,9.437086092715232
23156,330490405000093,85,118,104,82,84,78,28,24,551,52,603,8.623548922056385
23157,330490405000094,110,130,131,125,107,86,44,25,689,69,758,9.102902374670185
23158,330490405000095,16,28,26,21,21,14,3,6,126,9,135,6.666666666666667
23159,330490405000096,70,131,114,93,92,98,56,33,598,89,687,12.954876273653566
23160,330490405000097,60,86,84,90,89,87,55,44,496,99,595,16.638655462184875
23161,330490405000098,60,110,113,99,115,107,59,58,604,117,721,16.22746185852982
23162,330490405000099,17,33,38,46,41,39,21,14,214,35,249,14.056224899598394
23163,330490405000100,40,68,72,82,71,69,50,48,402,98,500,19.6
23164,330490405000101,99,130,118,148,161,132,69,71,788,140,928,15.086206896551724
23165,330490405000102,56,70,76,103,72,68,46,41,445,87,532,16.353383458646615
23166,330490405000103,29,74,80,75,92,79,49,29,429,78,507,15.384615384615385
23167,330490405000104,65,74,76,89,77,71,35,39,452,74,526,14.068441064638783
23168,330490405000105,89,116,108,99,108,84,58,41,604,99,703,14.082503556187767
23169,330490405000106,115,140,144,120,125,78,49,43,722,92,814,11.302211302211303
23170,330490405000107,61,66,64,60,58,46,32,27,355,59,414,14.251207729468598
23171,330490405000108,72,126,82,100,79,67,34,16,526,50,576,8.680555555555555
23172,330490405000109,120,151,144,121,114,77,47,43,727,90,817,11.015911872705018
23173,330490405000110,167,181,183,173,145,125,68,48,974,116,1090,10.642201834862385
23174,330490405000111,86,104,103,92,105,96,33,52,586,85,671,12.667660208643815
23175,330490405000112,97,116,112,120,101,96,43,21,642,64,706,9.06515580736544
23176,330490405000113,51,71,84,72,71,46,34,20,395,54,449,12.026726057906458
23177,330490405000114,88,122,100,105,114,62,37,25,591,62,653,9.494640122511486
23178,330490405000115,89,118,107,107,112,81,53,35,614,88,702,12.535612535612536
23179,330490405000116,121,117,132,128,119,87,54,45,704,99,803,12.32876712328767
23180,330490405000117,145,187,199,152,161,123,63,47,967,110,1077,10.21355617455896
23181,330490405000118,68,105,79,77,74,49,22,18,452,40,492,8.130081300813009
23182,330490405000119,69,100,92,91,79,58,33,26,489,59,548,10.766423357664234
23183,330490405000120,146,165,160,137,149,105,50,33,862,83,945,8.783068783068783
23184,330490405000121,94,123,100,129,96,69,52,29,611,81,692,11.705202312138729
23185,330490405000122,57,76,89,71,69,72,38,40,434,78,512,15.234375
23186,330490405000123,89,114,124,132,102,95,42,54,656,96,752,12.76595744680851
23187,330490405000124,66,114,81,95,73,73,29,28,502,57,559,10.196779964221825
23188,330490405000125,85,97,90,92,81,54,31,18,499,49,548,8.941605839416058
23189,330490405000126,117,140,118,145,96,84,48,27,700,75,775,9.67741935483871
23190,330490405000127,77,105,88,82,78,42,27,20,472,47,519,9.05587668593449
23191,330490405000128,61,60,86,85,78,80,45,37,450,82,532,15.413533834586467
23192,330490405000129,58,104,113,101,88,78,40,18,542,58,600,9.666666666666666
23193,330490405000130,92,99,146,138,119,102,57,42,696,99,795,12.452830188679245
23194,330490405000131,58,89,92,98,80,80,36,42,497,78,575,13.565217391304348
23195,330490405000132,123,148,114,161,105,88,56,43,739,99,838,11.813842482100238
23196,330490405000133,55,65,66,57,59,36,25,18,338,43,381,11.286089238845145
23197,330490405000134,126,164,141,140,148,95,43,35,814,78,892,8.74439461883408
23198,330490405000135,91,118,100,123,49,40,20,13,521,33,554,5.956678700361011
23199,330490405000136,74,80,80,84,102,68,29,24,488,53,541,9.796672828096119
23200,330490405000137,65,118,123,105,92,84,51,32,587,83,670,12.388059701492537
23201,330490405000138,64,85,88,76,75,54,33,13,442,46,488,9.426229508196721
23202,330490405000139,81,97,91,78,72,60,48,24,479,72,551,13.067150635208712
23203,330490405000140,112,97,105,111,86,64,40,29,575,69,644,10.714285714285714
23204,330490405000141,69,68,81,78,97,46,44,26,439,70,509,13.7524557956778
23205,330490405000142,97,175,117,165,156,55,50,25,765,75,840,8.928571428571429
23206,330490405000143,61,68,92,73,62,49,36,24,405,60,465,12.903225806451612
23207,330490405000144,45,53,58,62,50,42,32,35,310,67,377,17.77188328912467
23208,330490405000145,141,161,170,162,124,111,78,37,869,115,984,11.6869918699187
23209,330490405000146,113,128,126,114,138,102,58,42,721,100,821,12.180267965895249
23210,330490405000147,108,148,126,108,125,72,35,31,687,66,753,8.764940239043824
23211,330490405000148,84,83,65,60,48,36,17,12,376,29,405,7.160493827160494
23212,330490405000149,79,107,100,88,110,66,26,40,550,66,616,10.714285714285714
23213,330490405000150,69,94,116,92,101,86,38,28,558,66,624,10.576923076923077
23214,330490405000151,118,142,148,146,132,109,63,44,795,107,902,11.862527716186253
23215,330490405000152,158,182,168,180,146,101,67,36,935,103,1038,9.922928709055876
23216,330490405000153,98,136,106,134,105,63,31,14,642,45,687,6.550218340611353
23217,330490405000154,18,30,18,18,27,22,10,6,133,16,149,10.738255033557047
23218,330490405000155,14,17,8,6,6,5,1,0,56,1,57,1.7543859649122806
23219,330490405000156,49,44,43,43,41,43,22,12,263,34,297,11.447811447811448
23220,330490405000157,37,42,42,30,36,29,24,13,216,37,253,14.624505928853756
23221,330490405000158,27,28,24,23,23,23,13,12,148,25,173,14.45086705202312
23222,330490405000159,66,83,63,82,38,40,22,9,372,31,403,7.6923076923076925
23223,330490405000160,34,34,28,26,21,13,8,7,156,15,171,8.771929824561404
23224,330490405000161,71,87,73,85,75,39,29,17,430,46,476,9.663865546218487
23225,330490405000162,50,73,45,61,36,31,19,10,296,29,325,8.923076923076923
23226,330490405000163,26,41,27,33,29,16,15,9,172,24,196,12.244897959183673
23227,330490405000164,99,107,132,103,127,109,54,38,677,92,769,11.963589076723016
23228,330490405000165,90,110,114,91,92,79,29,35,576,64,640,10.0
23229,330490405000166,51,88,63,65,67,58,36,27,392,63,455,13.846153846153847
23230,330490405000167,5,7,4,5,6,3,2,1,30,3,33,9.090909090909092
23231,330490405000168,96,100,109,76,74,61,26,21,516,47,563,8.348134991119005
23232,330490405000169,132,160,135,143,118,86,45,35,774,80,854,9.36768149882904
23233,330490405000170,84,97,81,95,73,57,28,26,487,54,541,9.981515711645102
23234,330490405000171,75,91,82,61,67,53,22,20,429,42,471,8.9171974522293
23235,330490405000172,125,170,126,110,93,66,34,24,690,58,748,7.754010695187166
23237,330490405000174,38,56,46,48,34,22,16,16,244,32,276,11.594202898550725
23238,330490405000175,69,117,85,94,73,46,26,18,484,44,528,8.333333333333334
23239,330490405000176,135,150,183,138,100,99,55,20,805,75,880,8.522727272727273
23240,330490405000177,153,162,141,134,103,66,39,15,759,54,813,6.642066420664206
23241,330490405000178,122,149,119,122,104,109,49,31,725,80,805,9.937888198757763
23242,330490405000179,125,163,126,93,97,63,40,19,667,59,726,8.1267217630854
23243,330490405000180,152,180,164,147,102,74,42,27,819,69,888,7.77027027027027
23244,330490405000181,150,172,153,114,105,79,34,21,773,55,828,6.642512077294686
23245,330490405000182,68,96,93,73,66,52,15,13,448,28,476,5.882352941176471
23246,330490405000183,45,67,61,49,38,28,29,8,288,37,325,11.384615384615385
23247,330490405000184,151,171,167,153,108,90,44,20,840,64,904,7.079646017699115
23248,330490405000185,116,143,133,122,112,75,42,12,701,54,755,7.152317880794702
23249,330490405000186,77,107,80,84,76,55,43,21,479,64,543,11.786372007366483
23250,330490405000187,65,85,82,83,84,47,35,26,446,61,507,12.03155818540434
23251,330490405000188,100,141,117,151,105,83,47,30,697,77,774,9.948320413436692
23252,330490405000189,79,96,98,81,72,64,31,19,490,50,540,9.25925925925926
23253,330490405000190,49,60,68,59,51,32,17,17,319,34,353,9.63172804532578
23254,330490405000191,108,135,144,130,119,99,50,36,735,86,821,10.475030450669914
23255,330490405000192,54,115,71,67,75,61,31,27,443,58,501,11.57684630738523
23256,330490405000193,93,136,109,132,121,76,36,37,667,73,740,9.864864864864865
23257,330490405000194,135,123,136,134,107,87,53,31,722,84,806,10.421836228287841
23258,330490405000195,67,77,92,82,60,56,37,24,434,61,495,12.323232323232324
23259,330490405000196,66,67,66,66,51,37,23,14,353,37,390,9.487179487179487
23260,330490405000197,109,124,120,110,97,60,49,39,620,88,708,12.429378531073446
23261,330490405000198,82,115,91,86,91,64,38,24,529,62,591,10.490693739424703
23262,330490405000199,70,87,74,81,56,41,34,7,409,41,450,9.11111111111111
23263,330490405000200,53,80,58,63,52,45,21,13,351,34,385,8.831168831168831
23264,330490405000201,98,86,106,102,78,82,50,28,552,78,630,12.380952380952381
23265,330490405000202,73,96,102,103,72,50,51,30,496,81,577,14.038128249566725
23266,330490405000203,90,106,97,106,92,52,50,26,543,76,619,12.277867528271406
23267,330490405000204,113,175,121,137,137,97,51,43,780,94,874,10.755148741418765
23268,330490405000205,83,147,109,144,126,67,58,36,676,94,770,12.207792207792208
23269,330490405000206,90,100,138,152,116,88,36,26,684,62,746,8.310991957104557
23270,330490405000207,77,91,107,112,88,68,58,41,543,99,642,15.42056074766355
23271,330490405000208,52,88,107,146,68,87,50,28,548,78,626,12.460063897763579
23272,330490405000209,53,100,66,89,99,56,24,20,463,44,507,8.678500986193294
23273,330490405000210,43,77,116,64,73,62,31,27,435,58,493,11.764705882352942
23274,330490405000211,92,89,163,97,87,68,55,22,596,77,673,11.441307578008916
23275,330490405000212,126,174,138,143,117,113,57,50,811,107,918,11.655773420479303
23276,330490405000213,75,84,103,59,77,46,28,15,444,43,487,8.829568788501026
23277,330490405000214,81,101,111,97,70,63,29,14,523,43,566,7.597173144876325
23278,330490405000215,102,131,131,149,100,102,65,36,715,101,816,12.377450980392156
23279,330490405000216,85,101,86,120,76,63,66,32,531,98,629,15.580286168521463
23280,330490405000217,95,94,79,105,74,62,45,33,509,78,587,13.287904599659285
23281,330490405000218,79,79,90,72,70,61,30,14,451,44,495,8.88888888888889
23282,330490405000219,126,142,186,189,146,115,60,34,904,94,998,9.418837675350701
23283,330490405000220,87,112,139,101,121,92,35,50,652,85,737,11.533242876526458
23284,330490405000221,35,61,66,58,56,47,43,26,323,69,392,17.602040816326532
23285,330490405000222,129,111,152,142,123,91,52,32,748,84,832,10.096153846153847
23286,330490405000223,67,96,84,90,91,43,39,28,471,67,538,12.453531598513012
23287,330490405000224,69,62,98,77,67,62,34,21,435,55,490,11.224489795918368
23288,330490405000225,97,116,108,135,107,107,52,29,670,81,751,10.785619174434087
23289,330490405000226,128,131,141,154,122,124,83,55,800,138,938,14.712153518123667
23290,330490405000227,87,96,118,92,96,87,31,39,576,70,646,10.8359133126935
23291,330490405000228,68,145,106,89,101,110,35,45,619,80,699,11.444921316165951
23292,330490405000229,71,57,84,58,60,47,14,17,377,31,408,7.598039215686274
23293,330490405000230,124,123,192,128,119,91,47,33,777,80,857,9.334889148191365
23294,330490405000231,88,123,116,98,100,79,39,31,604,70,674,10.385756676557863
23295,330490405000232,72,94,105,111,93,65,40,30,540,70,610,11.475409836065573
23296,330490405000233,51,76,68,51,68,47,22,27,361,49,410,11.951219512195122
23297,330490405000234,128,154,156,166,164,110,53,49,878,102,980,10.408163265306122
23298,330490405000235,104,111,125,137,141,76,39,52,694,91,785,11.59235668789809
23299,330490405000236,107,152,119,182,148,87,58,50,795,108,903,11.960132890365449
23300,330490405000237,123,187,167,144,113,90,77,34,824,111,935,11.871657754010695
23301,330490405000238,121,125,183,147,135,109,72,67,820,139,959,14.494264859228362
23302,330490405000239,110,160,97,157,159,46,14,10,729,24,753,3.187250996015936
23303,330490405000240,75,56,107,60,114,63,57,18,475,75,550,13.636363636363637
23304,330490405000241,42,55,44,58,57,23,20,16,279,36,315,11.428571428571429
23305,330490405000242,97,139,133,135,138,115,62,48,757,110,867,12.687427912341407
23306,330490405000243,86,128,123,117,101,110,61,42,665,103,768,13.411458333333334
23307,330490405000244,106,124,136,132,95,96,38,24,689,62,751,8.255659121171771
23308,330490405000245,145,147,139,154,139,117,78,52,841,130,971,13.388259526261585
23309,330490405000246,114,94,150,128,113,114,48,56,713,104,817,12.729498164014688
23310,330490405000247,69,105,107,101,64,72,55,35,518,90,608,14.802631578947368
23311,330490405000248,49,82,52,56,64,40,20,7,343,27,370,7.297297297297297
23312,330490405000249,115,128,122,156,121,84,56,38,726,94,820,11.463414634146341
23313,330490405000250,19,28,35,24,27,36,22,9,169,31,200,15.5
23314,330490405000251,62,79,94,89,66,92,35,29,482,64,546,11.72161172161172
23315,330490405000252,89,119,119,129,125,102,67,49,683,116,799,14.518147684605758
23316,330490405000253,87,118,166,135,127,113,71,55,746,126,872,14.44954128440367
23317,330490405000254,103,129,175,147,130,125,62,53,809,115,924,12.445887445887445
23318,330490405000255,44,47,76,63,55,55,37,32,340,69,409,16.87041564792176
23319,330490405000256,49,86,117,105,101,94,39,28,552,67,619,10.823909531502423
23320,330490405000257,62,83,116,109,83,79,37,32,532,69,601,11.480865224625624
23321,330490405000258,47,59,62,59,59,61,39,20,347,59,406,14.532019704433498
23322,330490405000259,69,96,110,126,102,105,45,50,608,95,703,13.513513513513514
23323,330490405000260,58,63,87,76,109,82,31,25,475,56,531,10.546139359698682
23324,330490405000261,51,67,86,70,78,68,38,33,420,71,491,14.460285132382893
23325,330490405000262,96,95,100,127,115,103,58,39,636,97,733,13.233287858117325
23326,330490405000263,112,129,167,169,113,108,55,28,798,83,881,9.421112372304199
23327,330490405000264,60,66,79,107,96,85,47,49,493,96,589,16.298811544991512
23328,330490405000265,44,42,79,68,60,56,40,26,349,66,415,15.903614457831326
23329,330490405000266,99,129,175,128,120,88,65,21,739,86,825,10.424242424242424
23330,330490405000267,150,186,198,219,166,142,89,60,1061,149,1210,12.314049586776859
23331,330490405000268,142,144,149,160,104,61,54,16,760,70,830,8.433734939759036
23332,330490405000269,68,91,79,101,87,61,44,25,487,69,556,12.410071942446043
23333,330490405000270,84,114,137,113,148,91,48,41,687,89,776,11.469072164948454
23334,330490405000271,75,85,110,127,116,84,49,43,597,92,689,13.352685050798259
23335,330490405000272,76,86,110,116,85,67,55,29,540,84,624,13.461538461538462
23336,330490405000273,86,122,149,109,122,85,62,45,673,107,780,13.717948717948717
23337,330490405000274,94,119,105,122,94,90,43,32,624,75,699,10.729613733905579
23338,330490405000275,77,84,87,109,91,71,48,27,519,75,594,12.626262626262626
23339,330490405000276,90,108,91,110,102,73,62,44,574,106,680,15.588235294117647
23340,330490405000277,92,151,150,155,169,96,72,70,813,142,955,14.86910994764398
23341,330490405000278,134,157,175,152,191,105,48,33,914,81,995,8.140703517587939
23342,330490405000279,71,95,116,84,111,109,45,28,586,73,659,11.077389984825492
23343,330490405000280,75,97,80,87,112,72,48,33,523,81,604,13.410596026490067
23344,330490405000281,103,116,160,119,135,113,49,57,746,106,852,12.44131455399061
23345,330490405000282,53,76,85,83,106,89,51,48,492,99,591,16.751269035532996
23346,330490405000283,103,118,134,134,122,107,84,50,718,134,852,15.727699530516432
23347,330490405000284,79,63,115,104,90,72,50,36,523,86,609,14.12151067323481
23348,330490405000285,64,82,94,87,88,77,48,43,492,91,583,15.608919382504288
23349,330490405000286,51,78,87,62,93,68,57,48,439,105,544,19.301470588235293
23350,330490405000287,64,79,115,100,96,101,59,49,555,108,663,16.289592760180994
23351,330490405000288,77,73,105,125,84,80,48,44,544,92,636,14.465408805031446
23352,330490405000289,40,88,81,85,104,87,43,27,485,70,555,12.612612612612613
23353,330490405000290,77,99,131,109,112,113,68,60,641,128,769,16.644993498049416
23354,330490405000291,66,86,105,111,107,89,63,92,564,155,719,21.557719054242003
23355,330490405000292,115,134,199,146,149,146,81,51,889,132,1021,12.928501469147895
23356,330490405000293,81,105,115,97,85,73,33,41,556,74,630,11.746031746031745
23357,330490405000294,53,69,74,79,68,56,43,33,399,76,475,16.0
23358,330490405000295,45,74,80,60,99,71,61,42,429,103,532,19.360902255639097
23359,330490405000296,65,91,80,93,84,75,50,35,488,85,573,14.834205933682373
23360,330490405000297,106,109,138,149,137,91,66,43,730,109,839,12.991656734207389
23361,330490405000298,61,90,108,102,88,108,59,45,557,104,661,15.733736762481088
23362,330490405000299,48,81,84,87,93,75,86,46,468,132,600,22.0
23363,330490405000300,64,65,105,82,66,80,45,48,462,93,555,16.756756756756758
23364,330490405000301,5,5,12,9,13,6,8,6,50,14,64,21.875
23365,330490405000302,50,62,99,85,89,75,42,38,460,80,540,14.814814814814815
23366,330490405000303,46,67,63,90,86,64,36,35,416,71,487,14.57905544147844
23367,330490405000304,45,61,90,72,71,68,44,28,407,72,479,15.031315240083508
23368,330490405000305,55,46,109,70,72,104,60,41,456,101,557,18.132854578096946
23369,330490405000306,89,98,117,110,119,104,75,54,637,129,766,16.840731070496084
23370,330490405000307,62,94,113,82,86,83,44,42,520,86,606,14.191419141914192
23371,330490405000308,73,74,78,81,80,70,35,22,456,57,513,11.11111111111111
23372,330490405000309,4,9,8,11,11,9,7,6,52,13,65,20.0
23373,330490405000310,33,57,81,65,49,49,30,31,334,61,395,15.443037974683545
23374,330490405000311,9,11,11,9,10,11,3,3,61,6,67,8.955223880597014
23375,330490405000312,21,17,19,30,13,11,16,3,111,19,130,14.615384615384615
23376,330490405000313,73,48,129,155,56,25,13,13,486,26,512,5.078125
23377,330490405000314,87,117,117,151,163,71,38,15,706,53,759,6.982872200263505
23378,330490405000315,42,52,72,51,60,52,34,11,329,45,374,12.032085561497325
23379,330490405000316,86,89,134,106,96,81,40,23,592,63,655,9.618320610687023
23380,330490405000317,66,115,112,85,100,97,38,19,575,57,632,9.018987341772151
23381,330490405000318,44,97,139,101,90,63,53,15,534,68,602,11.295681063122924
23382,330490405000319,57,120,129,120,109,67,28,14,602,42,644,6.521739130434782
23383,330490405000320,30,55,50,53,44,59,33,38,291,71,362,19.613259668508288
23384,330490405000321,29,30,45,42,55,40,27,24,241,51,292,17.465753424657535
23385,330490405000322,10,23,55,36,20,4,3,0,148,3,151,1.9867549668874172
23386,330490405000323,72,119,115,137,131,117,57,41,691,98,789,12.420785804816223
23387,330490405000324,46,86,110,86,112,97,60,33,537,93,630,14.761904761904763
23388,330490405000325,62,92,141,95,124,104,65,39,618,104,722,14.404432132963988
23389,330490405000326,50,101,131,114,113,89,60,57,598,117,715,16.363636363636363
23390,330490405000327,54,80,84,79,93,83,49,57,473,106,579,18.307426597582037
23391,330490405000328,19,23,38,37,39,36,32,24,192,56,248,22.580645161290324
23392,330490405000329,73,77,77,105,41,63,36,29,436,65,501,12.974051896207586
23393,330490405000330,85,98,162,99,105,95,34,52,644,86,730,11.780821917808218
23394,330490405000331,60,60,78,81,59,56,46,34,394,80,474,16.877637130801688
23395,330490405000332,21,39,46,40,44,29,22,17,219,39,258,15.116279069767442
23396,330490405000333,102,113,146,162,117,117,72,64,757,136,893,15.22956326987682
23397,330490405000334,84,137,141,148,155,106,72,27,771,99,870,11.379310344827585
23398,330490405000335,119,149,191,194,155,166,94,63,974,157,1131,13.881520778072503
23399,330490405000336,26,43,27,31,33,19,7,9,179,16,195,8.205128205128204
23400,330490405000337,74,86,105,123,115,82,50,28,585,78,663,11.764705882352942
23401,330490405000338,42,57,64,60,57,42,32,30,322,62,384,16.145833333333332
23402,330490405000339,76,109,90,131,104,62,38,20,572,58,630,9.206349206349206
23403,330490405000340,102,122,141,205,183,132,72,57,885,129,1014,12.721893491124261
23404,330490405000341,51,65,70,70,90,61,38,32,407,70,477,14.675052410901468
23405,330490405000342,48,62,68,58,78,75,39,80,389,119,508,23.4251968503937
23406,330490405000343,79,98,84,119,122,75,45,31,577,76,653,11.638591117917304
23407,330490405000344,80,107,125,125,124,88,86,60,649,146,795,18.364779874213838
23408,330490405000345,117,94,142,162,111,127,68,51,753,119,872,13.646788990825687
23409,330490405000346,45,88,88,101,104,90,48,34,516,82,598,13.7123745819398
23410,330490405000347,54,70,73,76,81,70,44,40,424,84,508,16.53543307086614
23411,330490405000348,56,84,107,88,86,103,56,44,524,100,624,16.025641025641026
23412,330490405000349,59,88,118,97,100,114,73,42,576,115,691,16.642547033285094
23413,330490405000350,51,58,76,52,77,65,36,23,379,59,438,13.470319634703197
23414,330490405000351,57,83,124,78,94,101,54,25,537,79,616,12.824675324675324
23415,330490405000352,57,54,104,74,73,44,27,18,406,45,451,9.977827050997783
23416,330490405000353,41,57,75,77,44,62,40,19,356,59,415,14.216867469879517
23417,330490405000354,51,52,76,69,68,60,21,17,376,38,414,9.178743961352657
23418,330490405000355,43,75,55,68,56,50,32,19,347,51,398,12.814070351758794
23419,330490405000356,58,89,83,140,76,72,48,19,518,67,585,11.452991452991453
23420,330490405000357,84,105,114,109,95,76,57,30,583,87,670,12.985074626865671
23421,330490405000358,118,156,156,161,205,92,55,30,888,85,973,8.735868448098664
23422,330490405000359,70,64,89,100,68,46,19,13,437,32,469,6.823027718550106
23423,330490405000360,91,117,139,128,120,122,75,42,717,117,834,14.028776978417266
23424,330490405000361,71,86,118,123,101,91,63,39,590,102,692,14.739884393063583
23425,330490405000362,111,154,149,161,133,92,53,43,800,96,896,10.714285714285714
23426,330490405000363,58,63,103,96,101,98,50,68,519,118,637,18.524332810047095
23427,330490405000364,70,70,127,94,84,95,51,26,540,77,617,12.479740680713128
23428,330490405000365,52,77,107,83,82,99,57,35,500,92,592,15.54054054054054
23429,330490405000366,31,21,42,43,33,39,19,13,209,32,241,13.278008298755188
23430,330490405000367,66,68,120,164,113,97,63,50,628,113,741,15.24966261808367
23431,330490405000368,43,36,62,66,57,47,31,27,311,58,369,15.718157181571815
23432,330490405000369,92,105,152,143,118,115,51,41,725,92,817,11.260709914320685
23433,330490405000370,29,71,45,61,57,47,21,23,310,44,354,12.429378531073446
23434,330490405000371,35,85,69,76,76,78,34,29,419,63,482,13.070539419087137
23435,330490405000372,77,93,107,114,117,73,51,29,581,80,661,12.10287443267776
23436,330490405000373,91,151,181,145,111,75,38,28,754,66,820,8.048780487804878
23437,330490405000374,53,82,85,59,59,60,26,19,398,45,443,10.15801354401806
23438,330490405000375,63,90,85,88,72,74,32,13,472,45,517,8.704061895551257
23439,330490405000376,63,96,79,71,88,54,41,29,451,70,521,13.435700575815739
23440,330490405000377,81,113,117,129,114,98,72,61,652,133,785,16.94267515923567
23441,330490405000378,100,147,152,163,173,132,92,63,867,155,1022,15.166340508806263
23442,330490405000379,109,123,136,120,134,101,57,42,723,99,822,12.043795620437956
23443,330490405000380,63,115,92,108,102,82,35,26,562,61,623,9.791332263242376
23444,330490405000381,70,45,72,64,37,21,12,4,309,16,325,4.923076923076923
23445,330490405000382,61,78,114,95,115,109,52,58,572,110,682,16.129032258064516
23446,330490405000383,59,70,64,81,79,76,41,30,429,71,500,14.2
23447,330490405000384,56,112,170,103,126,120,60,44,687,104,791,13.147914032869785
23448,330490405000385,45,46,57,56,38,37,14,8,279,22,301,7.308970099667774
23449,330490405000386,31,31,47,61,33,16,10,2,219,12,231,5.194805194805195
23450,330490405000387,115,123,166,137,96,64,35,18,701,53,754,7.029177718832892
23451,330490405000388,76,88,109,99,78,61,38,34,511,72,583,12.34991423670669
23452,330490405000389,131,152,177,153,136,87,69,44,836,113,949,11.9072708113804
23453,330490405000390,93,147,138,140,179,114,45,29,811,74,885,8.361581920903955
23454,330490405000391,31,43,66,27,43,44,17,10,254,27,281,9.608540925266905
23455,330490405000392,88,125,177,144,150,165,63,41,849,104,953,10.912906610703043
23456,330490405000393,56,72,109,94,48,67,42,16,446,58,504,11.507936507936508
23457,330490405000394,43,47,58,44,48,35,22,4,275,26,301,8.637873754152825
23458,330490405000395,100,103,124,129,128,86,45,43,670,88,758,11.609498680738787
23459,330490405000396,61,118,114,93,126,80,45,31,592,76,668,11.377245508982035
23460,330490405000397,36,67,83,67,68,60,30,44,381,74,455,16.263736263736263
23461,330490405000398,124,163,178,154,191,126,86,67,936,153,1089,14.049586776859504
23462,330490405000399,59,73,70,94,77,60,37,41,433,78,511,15.264187866927593
23463,330490405000400,51,48,53,54,57,57,41,40,320,81,401,20.199501246882793
23464,330490405000401,101,131,119,120,165,88,75,56,724,131,855,15.321637426900585
23465,330490405000402,100,131,117,122,123,82,68,35,675,103,778,13.239074550128535
23466,330490405000403,73,110,100,119,94,69,41,20,565,61,626,9.744408945686901
23467,330490405000404,118,165,162,154,154,110,57,51,863,108,971,11.122554067971164
23468,330490405000405,95,126,142,124,114,89,47,26,690,73,763,9.567496723460026
23469,330490405000406,124,156,154,164,146,87,60,38,831,98,929,10.54897739504844
23470,330490405000407,53,86,81,99,80,84,60,34,483,94,577,16.291161178509533
23471,330490405000408,32,30,39,43,42,40,34,35,226,69,295,23.389830508474578
23472,330490405000409,94,128,147,140,153,134,90,53,796,143,939,15.228966986155484
23473,330490405000410,135,164,205,182,194,135,56,28,1015,84,1099,7.643312101910828
23474,330490405000411,118,153,176,197,152,134,59,36,930,95,1025,9.268292682926829
23475,330490405000412,56,77,101,86,79,85,48,38,484,86,570,15.087719298245615
23476,330490405000413,99,119,141,152,102,107,59,28,720,87,807,10.780669144981413
23477,330490405000414,154,192,124,165,133,63,54,34,831,88,919,9.57562568008705
23478,330490405000415,184,275,205,199,188,129,52,32,1180,84,1264,6.6455696202531644
23479,330490405000416,87,138,141,132,102,69,38,18,669,56,725,7.724137931034483
23480,330490405000417,76,113,121,88,106,77,40,34,581,74,655,11.297709923664122
23481,330490405000418,103,186,135,137,124,83,47,39,768,86,854,10.070257611241217
23482,330490405000419,182,211,203,186,200,147,73,57,1129,130,1259,10.325655281969818
23483,330490405000420,76,112,96,90,97,64,31,33,535,64,599,10.684474123539232
23484,330490405000421,120,113,160,160,116,94,60,45,763,105,868,12.096774193548388
23485,330490405000422,133,131,181,169,168,138,76,54,920,130,1050,12.380952380952381
23486,330490405000423,66,74,96,128,98,67,57,43,529,100,629,15.89825119236884
23487,330490405000424,118,136,139,163,140,98,66,51,794,117,911,12.843029637760702
23488,330490405000425,159,183,182,227,165,149,85,52,1065,137,1202,11.397670549084859
23489,330490405000426,59,62,80,91,62,53,50,38,407,88,495,17.77777777777778
23490,330490405000427,71,91,92,106,83,91,52,46,534,98,632,15.50632911392405
23491,330490405000428,52,73,81,69,97,65,28,24,437,52,489,10.633946830265849
23492,330490405000429,70,83,99,79,89,52,49,36,472,85,557,15.26032315978456
23493,330490405000430,96,163,123,121,145,83,61,48,731,109,840,12.976190476190476
23494,330490405000431,60,72,67,58,61,32,23,18,350,41,391,10.485933503836318
23495,330490405000432,155,237,127,197,131,94,81,42,941,123,1064,11.56015037593985
23496,330490405000433,115,126,148,135,120,102,54,40,746,94,840,11.19047619047619
23497,330490405000434,24,23,38,35,29,26,21,19,175,40,215,18.6046511627907
23498,330490405000435,157,193,141,154,146,91,43,38,882,81,963,8.411214953271028
23499,330490405000436,104,154,97,119,121,58,53,25,653,78,731,10.6703146374829
23500,330490405000437,77,102,102,114,95,94,55,62,584,117,701,16.690442225392296
23501,330490405000438,63,80,81,76,62,63,45,17,425,62,487,12.731006160164272
23502,330490405000439,110,110,138,128,108,82,43,19,676,62,738,8.401084010840108
23503,330490405000440,56,91,80,92,79,76,58,62,474,120,594,20.2020202020202
23504,330490405000441,30,25,41,33,32,25,13,10,186,23,209,11.004784688995215
23505,330490405000442,111,158,141,172,146,133,76,51,861,127,988,12.854251012145749
23506,330490405000443,113,155,156,179,146,119,98,60,868,158,1026,15.399610136452242
23507,330490405000444,76,80,104,97,95,84,48,36,536,84,620,13.548387096774194
23508,330490405000445,98,126,163,169,132,132,96,52,820,148,968,15.289256198347108
23509,330490405000446,108,120,139,128,127,113,54,54,735,108,843,12.811387900355871
23510,330490405000447,61,77,108,105,103,75,55,40,529,95,624,15.224358974358974
23511,330490405000448,78,127,109,165,155,107,63,60,741,123,864,14.23611111111111
23512,330490405000449,46,75,114,95,97,92,71,39,519,110,629,17.488076311605724
23513,330490405000450,26,58,63,50,64,70,36,39,331,75,406,18.472906403940886
23514,330490405000451,98,86,103,81,125,99,47,38,592,85,677,12.555391432791728
23515,330490405000452,77,110,162,151,82,68,45,43,650,88,738,11.924119241192411
23516,330490405000453,119,163,240,156,135,95,57,40,908,97,1005,9.651741293532337
23517,330490405000454,106,143,149,194,115,51,47,27,758,74,832,8.89423076923077
23518,330490405000455,80,126,86,129,90,51,36,39,562,75,637,11.773940345368917
23519,330490405000456,165,201,244,181,191,166,72,64,1148,136,1284,10.59190031152648
23520,330490405000457,18,15,24,24,20,13,12,8,114,20,134,14.925373134328359
23521,330490405000458,38,49,51,50,47,30,15,12,265,27,292,9.246575342465754
23522,330490405000459,5,7,6,6,11,10,6,4,45,10,55,18.181818181818183
23523,330490405000460,61,101,90,98,89,83,51,37,522,88,610,14.426229508196721
23524,330490405000461,24,24,26,32,27,24,15,10,157,25,182,13.736263736263735
23525,330490405000462,21,34,51,26,35,40,19,25,207,44,251,17.529880478087648
23526,330490405000463,41,74,80,68,64,59,25,24,386,49,435,11.264367816091953
23527,330490405000464,104,148,131,142,128,123,47,43,776,90,866,10.392609699769054
23528,330490405000465,30,64,52,65,67,41,31,36,319,67,386,17.357512953367877
23529,330490405000466,84,103,97,105,84,81,66,58,554,124,678,18.289085545722713
23530,330490405000467,29,59,54,35,35,24,15,14,236,29,265,10.943396226415095
23531,330490405000468,13,14,17,19,12,16,11,11,91,22,113,19.469026548672566
23532,330490405000469,2,3,8,4,6,4,3,5,27,8,35,22.857142857142858
23533,330490405000470,9,2,9,9,2,13,6,16,44,22,66,33.333333333333336
23534,330490405000471,11,8,18,18,15,17,15,17,87,32,119,26.89075630252101
23535,330490405000472,12,32,25,25,23,21,14,5,138,19,157,12.101910828025478
23536,330490405000473,15,15,26,27,11,21,12,12,115,24,139,17.26618705035971
23537,330490405000474,18,18,17,22,20,12,12,9,107,21,128,16.40625
23538,330490405000475,34,72,61,101,62,57,32,30,387,62,449,13.808463251670378
23539,330490405000476,6,15,12,12,16,17,5,11,78,16,94,17.02127659574468
23540,330490405000477,19,50,59,45,54,67,34,27,294,61,355,17.183098591549296
23541,330490405000478,0,5,0,1,3,5,1,4,14,5,19,26.31578947368421
23542,330490405000479,20,22,41,26,39,27,18,23,175,41,216,18.98148148148148
23545,330490405000482,33,56,72,75,85,50,46,34,371,80,451,17.738359201773836
23546,330490405000483,21,18,27,24,17,27,15,8,134,23,157,14.64968152866242
23547,330490405000484,10,20,30,24,26,28,5,4,138,9,147,6.122448979591836
23548,330490405000485,19,37,38,21,34,17,8,16,166,24,190,12.631578947368421
23549,330490405000486,11,19,20,12,16,7,1,2,85,3,88,3.409090909090909
23550,330490405000487,14,22,28,29,31,25,18,16,149,34,183,18.579234972677597
23551,330490405000488,7,8,12,14,10,10,7,4,61,11,72,15.277777777777779
23552,330490405000489,7,10,11,7,13,10,6,9,58,15,73,20.54794520547945
23553,330490405000490,2,5,8,5,6,4,1,3,30,4,34,11.764705882352942
23554,330490405000491,18,21,24,10,23,10,5,7,106,12,118,10.169491525423728
23555,330490405000492,48,44,51,62,55,40,27,21,300,48,348,13.793103448275861
23556,330490405000493,3,4,3,5,8,4,4,1,27,5,32,15.625
23557,330490405000494,3,5,6,2,5,10,2,4,31,6,37,16.216216216216218
23558,330490405000495,21,27,56,36,36,44,31,17,220,48,268,17.91044776119403
23559,330490405000496,11,14,13,17,14,13,11,2,82,13,95,13.68421052631579
23560,330490405000497,12,17,16,28,12,13,14,2,98,16,114,14.035087719298245
23561,330490405000498,9,10,22,16,15,22,9,5,94,14,108,12.962962962962964
23562,330490405000499,7,9,13,13,10,8,6,2,60,8,68,11.764705882352942
23563,330490405000500,44,75,73,68,65,50,22,10,375,32,407,7.862407862407863
23564,330490405000501,61,76,79,82,66,69,36,12,433,48,481,9.97920997920998
23565,330490405000502,58,65,88,84,86,95,63,61,476,124,600,20.666666666666668
23566,330490405000503,7,10,22,21,12,18,9,5,90,14,104,13.461538461538462
23567,330490405000504,41,54,47,73,41,33,21,11,289,32,321,9.968847352024921
23568,330490405000505,7,12,2,14,3,1,4,3,39,7,46,15.217391304347826
23569,330490405000506,9,11,15,11,9,4,4,2,59,6,65,9.23076923076923
23570,330490405000507,78,117,132,113,92,104,40,40,636,80,716,11.1731843575419
23571,330490405000508,15,22,32,21,28,24,11,13,142,24,166,14.457831325301205
23572,330490405000509,23,32,31,45,21,30,19,12,182,31,213,14.553990610328638
23573,330490405000510,8,19,16,12,20,16,1,8,91,9,100,9.0
23574,330490405000511,3,6,3,8,3,9,1,3,32,4,36,11.11111111111111
23575,330490405000512,13,14,18,12,8,10,7,4,75,11,86,12.790697674418604
23576,330490405000513,2,10,7,5,7,8,3,2,39,5,44,11.363636363636363
23577,330490405000514,83,77,107,104,112,79,38,33,562,71,633,11.216429699842022
23578,330490405000515,2,5,7,6,6,6,7,4,32,11,43,25.58139534883721
23579,330490405000516,7,14,13,8,21,5,10,7,68,17,85,20.0
23580,330490405000517,6,11,7,4,7,10,6,2,45,8,53,15.09433962264151
23581,330490405000518,15,14,18,16,14,13,10,5,90,15,105,14.285714285714286
23582,330490405000519,7,11,13,10,19,12,10,8,72,18,90,20.0
23583,330490405000520,40,62,58,42,52,40,22,14,294,36,330,10.909090909090908
23584,330490405000521,20,26,25,24,25,19,20,6,139,26,165,15.757575757575758
23585,330490405000522,73,79,96,77,64,46,40,29,435,69,504,13.69047619047619
23586,330490405000523,59,82,80,89,67,36,22,17,413,39,452,8.628318584070797
23588,330490405000525,14,28,18,27,23,17,8,11,127,19,146,13.013698630136986
23589,330490405000526,131,142,126,132,87,48,24,12,666,36,702,5.128205128205129
23590,330490405000527,44,49,46,34,28,16,18,6,217,24,241,9.95850622406639
23591,330490405000528,6,10,12,7,5,7,10,5,47,15,62,24.193548387096776
23592,330490405000529,3,17,6,12,6,9,2,4,53,6,59,10.169491525423728
23593,330490405000530,2,2,10,2,1,8,1,2,25,3,28,10.714285714285714
23594,330490405000531,17,26,25,27,20,12,12,4,127,16,143,11.188811188811188
23595,330490405000532,2,2,3,1,5,6,2,1,19,3,22,13.636363636363637
23596,330490405000533,22,34,24,30,21,28,9,10,159,19,178,10.674157303370787
23597,330490405000534,6,16,7,13,9,5,4,8,56,12,68,17.647058823529413
23598,330490405000535,34,37,41,39,38,25,17,15,214,32,246,13.008130081300813
23599,330490405000536,9,10,7,14,9,2,8,4,51,12,63,19.047619047619047
23600,330490405000537,3,3,10,4,3,9,1,0,32,1,33,3.0303030303030303
23601,330490405000538,68,70,78,72,57,41,18,15,386,33,419,7.875894988066825
23602,330490405000539,11,7,6,18,9,12,7,4,63,11,74,14.864864864864865
23603,330490405000540,2,4,7,6,1,4,5,2,24,7,31,22.580645161290324
23604,330490405000541,14,14,28,20,14,17,11,3,107,14,121,11.570247933884298
23605,330490405000542,15,12,18,17,14,15,6,2,91,8,99,8.080808080808081
23606,330490405000543,5,15,6,9,10,6,8,1,51,9,60,15.0
23607,330490405000544,10,8,9,8,11,11,2,1,57,3,60,5.0
23608,330490405000545,13,23,24,14,19,22,10,8,115,18,133,13.533834586466165
23609,330490405000546,19,24,26,27,34,22,7,5,152,12,164,7.317073170731708
23610,330490405000547,14,22,27,28,21,26,17,16,138,33,171,19.29824561403509
23611,330490405000548,7,9,9,5,10,11,9,4,51,13,64,20.3125
23612,330490405000549,39,57,62,60,56,56,25,17,330,42,372,11.290322580645162
23613,330490405000550,18,19,23,37,30,9,12,7,136,19,155,12.258064516129032
23614,330490405000551,13,21,33,27,17,23,14,6,134,20,154,12.987012987012987
23615,330490405000552,8,16,7,9,11,7,7,3,58,10,68,14.705882352941176
23616,330490405000553,11,11,14,7,12,9,6,5,64,11,75,14.666666666666666
23617,330490405000554,82,109,81,90,80,45,24,19,487,43,530,8.11320754716981
23618,330490405000555,5,15,9,7,17,9,9,4,62,13,75,17.333333333333332
23619,330490405000556,60,70,95,73,102,50,36,30,450,66,516,12.790697674418604
23621,330490405000558,25,42,25,39,46,20,14,12,197,26,223,11.659192825112108
23622,330490405000559,43,50,76,73,59,34,34,26,335,60,395,15.189873417721518
23623,330490405000560,16,37,24,33,28,26,15,12,164,27,191,14.136125654450261
23624,330490405000561,35,54,59,58,45,42,28,28,293,56,349,16.045845272206304
23625,330490405000562,4,7,11,9,11,10,5,5,52,10,62,16.129032258064516
23626,330490405000563,41,31,43,82,47,36,29,16,280,45,325,13.846153846153847
23627,330490405000564,52,54,72,77,65,83,42,33,403,75,478,15.690376569037657
23628,330490405000565,46,61,63,73,55,67,37,24,365,61,426,14.31924882629108
23629,330490405000566,68,99,102,90,63,54,25,16,476,41,517,7.93036750483559
23630,330490405000567,19,40,27,29,37,18,14,8,170,22,192,11.458333333333334
23632,330490405000569,60,79,88,67,81,45,45,23,420,68,488,13.934426229508198
23633,330490405000570,56,70,74,95,90,50,35,25,435,60,495,12.121212121212121
23634,330490405000571,10,27,17,22,15,8,3,3,99,6,105,5.714285714285714
23636,330490405000573,83,82,90,107,73,52,24,20,487,44,531,8.286252354048964
23637,330490405000574,4,7,10,6,10,5,5,3,42,8,50,16.0
23638,330490405000575,51,82,67,91,68,69,21,26,428,47,475,9.894736842105264
23639,330490405000576,56,81,76,79,68,48,27,20,408,47,455,10.32967032967033
23640,330490405000577,0,8,6,8,10,6,3,6,38,9,47,19.148936170212767
23641,330490405000578,10,7,7,10,12,5,0,0,51,0,51,0.0
23642,330490405000579,94,108,106,86,90,47,37,20,531,57,588,9.693877551020408
23643,330490405000580,129,125,217,91,128,49,73,9,739,82,821,9.987819732034104
23644,330490405000581,23,25,25,35,14,18,4,9,140,13,153,8.49673202614379
23645,330490405000582,14,37,21,23,34,15,15,13,144,28,172,16.27906976744186
23646,330490405000583,51,52,56,79,63,28,15,2,329,17,346,4.913294797687861
23647,330490405000584,20,25,12,23,36,20,11,2,136,13,149,8.724832214765101
23648,330490405000585,22,25,24,31,16,23,10,6,141,16,157,10.19108280254777
23649,330490405000586,11,20,9,8,13,5,12,1,66,13,79,16.455696202531644
23650,330490405000587,16,14,10,18,21,7,9,2,86,11,97,11.34020618556701
23651,330490405000588,22,52,30,21,40,14,9,10,179,19,198,9.595959595959595
23652,330490405000589,15,16,22,13,21,19,9,7,106,16,122,13.114754098360656
23653,330490405000590,40,40,63,77,54,39,35,10,313,45,358,12.569832402234637
23655,330490405000592,78,112,103,84,88,70,37,20,535,57,592,9.628378378378379
23656,330490405000593,13,8,19,6,10,11,10,3,67,13,80,16.25
23657,330490405000594,7,9,21,9,7,15,6,2,68,8,76,10.526315789473685
23658,330490405000595,60,85,77,59,70,56,25,20,407,45,452,9.955752212389381
23659,330490405000596,3,1,6,2,4,3,0,0,19,0,19,0.0
23660,330490405000598,21,15,19,14,24,11,6,9,104,15,119,12.605042016806722
23661,330490405000599,11,10,16,9,16,8,6,8,70,14,84,16.666666666666668
23662,330490405000600,73,81,70,75,87,37,27,23,423,50,473,10.570824524312897
23663,330490405000601,85,115,79,106,99,53,45,26,537,71,608,11.677631578947368
23664,330490405000602,6,8,17,6,18,20,18,15,75,33,108,30.555555555555557
23665,330490405000603,2,8,5,2,4,4,4,2,25,6,31,19.35483870967742
23666,330490405000604,5,11,8,7,13,10,5,1,54,6,60,10.0
23667,330490405000605,69,98,102,113,97,73,30,38,552,68,620,10.96774193548387
23668,330490405000606,8,16,26,21,14,10,1,2,95,3,98,3.061224489795918
23669,330490405000607,32,28,42,34,24,25,10,15,185,25,210,11.904761904761905
23670,330490405000608,19,31,28,27,34,11,12,12,150,24,174,13.793103448275861
23671,330490405000609,50,48,62,49,45,32,17,14,286,31,317,9.779179810725552
23672,330490405000610,8,2,13,5,5,4,4,2,37,6,43,13.953488372093023
23673,330490405000611,0,3,5,6,0,0,2,3,14,5,19,26.31578947368421
23674,330490405000612,36,54,85,80,78,66,35,18,399,53,452,11.725663716814159
23675,330490405000614,40,56,62,51,81,50,16,39,340,55,395,13.924050632911392
23676,330490405000615,59,88,77,68,58,31,16,21,381,37,418,8.851674641148325
23677,330490405000616,2,6,3,3,10,7,8,7,31,15,46,32.608695652173914
23678,330490405000617,19,29,48,40,48,39,33,14,223,47,270,17.40740740740741
23679,330490405000618,5,1,5,5,1,6,5,3,23,8,31,25.806451612903224
23680,330490405000619,60,100,98,90,99,83,52,40,530,92,622,14.790996784565916
23681,330490405000620,3,7,6,8,7,2,4,0,33,4,37,10.81081081081081
23682,330490405000621,49,49,67,64,44,33,13,10,306,23,329,6.990881458966565
23683,330490405000622,34,47,32,28,27,19,4,5,187,9,196,4.591836734693878
23684,330490405000623,64,42,60,41,37,23,11,2,267,13,280,4.642857142857143
23685,330490405000624,12,12,13,12,15,8,5,3,72,8,80,10.0
23686,330490405000625,16,17,27,18,20,19,8,6,117,14,131,10.687022900763358
23687,330490405000626,20,25,32,27,21,22,11,7,147,18,165,10.909090909090908
23688,330490405000627,136,185,145,119,119,52,40,24,756,64,820,7.804878048780488
23689,330490405000628,57,86,82,78,80,45,34,24,428,58,486,11.934156378600823
23690,330490405000629,19,19,19,15,16,14,6,5,102,11,113,9.734513274336283
23691,330490405000630,2,3,3,6,7,3,8,4,24,12,36,33.333333333333336
23693,330490405000632,68,64,77,69,61,41,22,25,380,47,427,11.007025761124122
23694,330490405000633,34,45,41,42,38,37,10,14,237,24,261,9.195402298850574
23695,330490405000634,119,142,99,106,77,57,38,48,600,86,686,12.536443148688047
23696,330490405000635,30,35,29,30,25,13,7,7,162,14,176,7.954545454545454
23697,330490405000636,110,126,118,117,107,79,54,33,657,87,744,11.693548387096774
23698,330490405000637,48,50,47,46,38,25,14,6,254,20,274,7.299270072992701
23699,330490405000638,62,92,63,59,69,53,30,25,398,55,453,12.141280353200884
23700,330490405000639,94,134,131,131,101,69,27,16,660,43,703,6.116642958748222
23701,330490405000640,20,19,23,19,24,16,9,5,121,14,135,10.37037037037037
23702,330490405000642,19,18,19,13,17,11,5,1,97,6,103,5.825242718446602
23703,330490405000643,68,88,71,79,74,47,31,23,427,54,481,11.226611226611226
23704,330490405000644,93,98,134,124,90,87,39,21,626,60,686,8.746355685131196
23705,330490405000645,38,46,66,46,70,43,17,38,309,55,364,15.10989010989011
23706,330490405000646,101,81,94,107,76,60,26,18,519,44,563,7.815275310834814
23707,330490405000647,38,42,51,42,40,50,32,23,263,55,318,17.29559748427673
23708,330490405000648,122,132,133,135,106,70,44,34,698,78,776,10.051546391752577
23710,330490405000651,31,22,24,15,25,7,4,3,124,7,131,5.343511450381679
23711,330490405000652,4,3,12,9,8,8,2,2,44,4,48,8.333333333333334
23712,330490405000653,7,10,13,10,15,20,8,8,75,16,91,17.582417582417584
23713,330490405000654,115,122,111,143,130,72,27,18,693,45,738,6.097560975609756
23714,330490405000658,60,54,91,93,67,77,36,30,442,66,508,12.992125984251969
23717,330490405000661,59,59,53,46,46,22,25,18,285,43,328,13.109756097560975
23718,330490405000662,69,80,66,70,56,43,6,17,384,23,407,5.651105651105651
23719,330490405000663,54,79,45,53,55,29,9,7,315,16,331,4.833836858006042
23720,330490405000664,42,30,51,35,18,29,14,6,205,20,225,8.88888888888889
23721,330490405000665,74,105,102,74,72,56,32,16,483,48,531,9.03954802259887
23722,330490405000666,30,53,40,44,43,28,25,11,238,36,274,13.138686131386862
23723,330490405000668,101,134,91,107,115,46,36,11,594,47,641,7.332293291731669
23724,330490410000001,57,70,88,82,83,66,58,37,446,95,541,17.56007393715342
23725,330490410000002,82,90,145,121,121,147,104,84,706,188,894,21.02908277404922
23726,330490410000003,119,168,154,171,136,128,73,46,876,119,995,11.959798994974875
23727,330490410000004,69,97,105,89,105,92,47,43,557,90,647,13.910355486862443
23728,330490410000005,45,48,61,56,58,46,40,15,314,55,369,14.905149051490515
23729,330490410000006,51,92,94,86,99,81,45,32,503,77,580,13.275862068965518
23730,330490410000007,124,197,178,185,191,129,83,61,1004,144,1148,12.543554006968641
23731,330490410000008,110,174,184,152,191,129,54,48,940,102,1042,9.78886756238004
23732,330490410000009,77,114,138,150,116,101,71,38,696,109,805,13.540372670807454
23733,330490410000010,103,128,106,143,126,67,64,54,673,118,791,14.917825537294563
23734,330490410000011,81,102,111,99,110,82,72,45,585,117,702,16.666666666666668
23735,330490410000012,112,170,151,159,151,120,76,52,863,128,991,12.916246215943492
23736,330490410000013,73,107,97,139,96,92,68,30,604,98,702,13.96011396011396
23737,330490410000014,93,122,131,132,108,105,75,46,691,121,812,14.901477832512315
23738,330490410000015,85,85,98,111,113,71,43,40,563,83,646,12.84829721362229
23739,330490410000016,94,92,129,135,97,74,51,13,621,64,685,9.343065693430656
23740,330490410000017,74,106,110,106,106,66,45,30,568,75,643,11.66407465007776
23741,330490410000018,119,130,118,137,82,93,61,18,679,79,758,10.422163588390502
23742,330490410000019,73,72,86,78,67,63,43,27,439,70,509,13.7524557956778
23743,330490410000020,48,77,65,63,45,24,17,3,322,20,342,5.847953216374269
23744,330490410000021,92,126,107,124,80,64,60,33,593,93,686,13.556851311953352
23745,330490410000022,77,112,80,93,86,54,43,20,502,63,565,11.150442477876107
23746,330490410000023,195,198,204,226,176,124,65,34,1123,99,1222,8.101472995090017
23747,330490410000024,57,93,69,79,73,45,36,24,416,60,476,12.605042016806722
23748,330490410000025,178,240,196,197,176,126,78,36,1113,114,1227,9.290953545232274
23749,330490410000026,116,143,110,129,112,68,33,30,678,63,741,8.502024291497976
23750,330490410000027,94,102,90,85,68,53,35,23,492,58,550,10.545454545454545
23751,330490410000028,158,185,184,156,129,107,57,43,919,100,1019,9.813542688910697
23752,330490410000029,51,51,61,51,48,37,12,14,299,26,325,8.0
23753,330490410000030,189,262,226,231,198,149,89,53,1255,142,1397,10.164638511095204
23754,330490410000031,95,124,113,109,95,75,43,18,611,61,672,9.077380952380953
23755,330490410000032,16,34,13,38,25,18,11,5,144,16,160,10.0
23756,330490410000033,140,132,169,136,107,97,73,30,781,103,884,11.65158371040724
23757,330490410000034,133,167,136,155,107,81,45,35,779,80,859,9.31315483119907
23758,330490410000035,141,150,161,193,138,92,62,48,875,110,985,11.16751269035533
23759,330490410000036,97,125,133,122,116,82,44,32,675,76,751,10.119840213049267
23760,330490410000037,166,160,153,164,107,91,48,30,841,78,919,8.487486398258977
23761,330490410000038,120,148,129,115,121,78,33,18,711,51,762,6.692913385826771
23762,330490410000039,160,233,188,165,185,130,60,36,1061,96,1157,8.297320656871218
23763,330490410000040,157,218,180,154,158,118,58,35,985,93,1078,8.62708719851577
23764,330490410000041,30,71,36,46,41,32,16,18,256,34,290,11.724137931034482
23766,330490410000043,110,166,147,152,192,117,77,51,884,128,1012,12.648221343873518
23767,330490410000044,4,6,4,11,4,9,5,3,38,8,46,17.391304347826086
23769,330490410000046,62,104,80,102,81,75,59,30,504,89,593,15.008431703204048
23770,330490410000047,69,88,87,110,92,59,47,46,505,93,598,15.551839464882944
23771,330490410000048,9,20,17,17,15,21,6,6,99,12,111,10.81081081081081
23772,330490410000049,85,124,88,143,108,94,46,49,642,95,737,12.890094979647218
23773,330490410000050,73,97,75,95,97,86,37,39,523,76,599,12.687813021702839
23774,330490410000051,139,169,150,153,114,78,45,32,803,77,880,8.75
23775,330490410000052,53,89,105,90,45,40,32,20,422,52,474,10.970464135021096
23776,330490410000053,184,199,205,165,154,126,79,59,1033,138,1171,11.784799316823229
23777,330490410000054,110,150,136,157,144,87,32,22,784,54,838,6.443914081145585
23778,330490410000055,115,132,112,145,153,82,42,42,739,84,823,10.206561360874849
23779,330490410000056,130,160,130,156,145,100,55,23,821,78,899,8.676307007786429
23780,330490410000057,69,94,98,78,62,65,34,14,466,48,514,9.33852140077821
23781,330490410000058,107,101,113,115,75,60,33,17,571,50,621,8.051529790660226
23782,330490410000059,66,90,70,81,54,37,30,19,398,49,447,10.961968680089486
23783,330490410000060,51,39,49,32,52,34,10,14,257,24,281,8.540925266903914
23784,330490410000061,147,167,126,144,116,58,34,31,758,65,823,7.897934386391252
23785,330490410000062,79,79,100,89,70,68,37,19,485,56,541,10.351201478743068
23786,330490410000063,162,188,197,165,159,88,73,29,959,102,1061,9.613572101790764
23787,330490410000064,218,229,217,214,122,88,50,27,1088,77,1165,6.609442060085837
23788,330490410000065,135,159,175,125,121,81,35,15,796,50,846,5.91016548463357
23789,330490410000066,146,173,173,129,83,59,15,17,763,32,795,4.0251572327044025
23790,330490410000067,211,243,208,231,78,41,38,21,1012,59,1071,5.508870214752568
23791,330490410000068,39,69,56,42,63,48,24,21,317,45,362,12.430939226519337
23792,330490410000069,141,163,124,144,129,84,27,23,785,50,835,5.9880239520958085
23793,330490410000070,109,115,135,141,106,83,56,39,689,95,784,12.11734693877551
23794,330490410000071,108,145,127,114,110,80,49,35,684,84,768,10.9375
23795,330490410000072,77,92,100,110,92,53,39,30,524,69,593,11.63575042158516
23796,330490410000073,87,116,125,102,117,72,34,23,619,57,676,8.431952662721894
23797,330490410000074,157,216,198,198,145,80,54,32,994,86,1080,7.962962962962963
23798,330490410000075,37,74,60,54,68,45,26,15,338,41,379,10.817941952506596
23799,330490410000076,144,171,167,155,157,89,49,36,883,85,968,8.78099173553719
23800,330490410000077,148,178,209,182,173,129,65,46,1019,111,1130,9.823008849557523
23801,330490410000078,123,134,162,125,155,73,61,59,772,120,892,13.452914798206278
23802,330490410000079,45,49,48,66,45,43,35,20,296,55,351,15.66951566951567
23803,330490410000080,120,134,153,142,143,139,77,58,831,135,966,13.975155279503106
23804,330490410000081,47,66,72,63,78,63,38,46,389,84,473,17.758985200845665
23805,330490410000082,165,240,213,209,165,144,68,32,1136,100,1236,8.090614886731391
23806,330490410000083,125,178,138,177,184,100,40,23,902,63,965,6.528497409326425
23807,330490410000084,141,171,170,144,134,105,59,39,865,98,963,10.176531671858775
23808,330490410000085,102,146,114,144,137,62,47,30,705,77,782,9.846547314578006
23809,330490410000086,145,191,172,181,136,90,48,33,915,81,996,8.132530120481928
23810,330490410000087,39,66,47,70,71,40,25,13,333,38,371,10.242587601078167
23811,330490410000088,104,95,129,128,112,72,46,28,640,74,714,10.364145658263306
23812,330490410000089,89,123,120,179,137,112,66,42,760,108,868,12.442396313364055
23813,330490410000090,52,65,67,81,65,58,34,32,388,66,454,14.537444933920705
23814,330490410000091,70,102,128,105,98,66,41,38,569,79,648,12.191358024691358
23815,330490410000092,92,103,124,108,110,109,47,39,646,86,732,11.748633879781421
23816,330490410000093,26,45,31,26,37,18,6,3,183,9,192,4.6875
23817,330490410000094,79,111,104,86,80,47,18,10,507,28,535,5.233644859813084
23818,330490410000095,81,98,104,105,75,63,40,17,526,57,583,9.777015437392796
23819,330490410000096,117,135,101,127,95,66,39,25,641,64,705,9.078014184397164
23820,330490410000097,117,148,129,124,143,83,47,48,744,95,839,11.32300357568534
23821,330490410000098,70,138,137,96,186,129,41,71,756,112,868,12.903225806451612
23822,330490410000099,82,92,107,130,96,61,37,29,568,66,634,10.410094637223974
23823,330490410000100,46,57,80,103,71,66,32,14,423,46,469,9.808102345415778
23824,330490410000101,76,82,76,100,93,52,53,35,479,88,567,15.520282186948853
23825,330490410000102,87,97,121,105,101,66,32,22,577,54,631,8.55784469096672
23826,330490410000103,132,122,145,144,132,103,50,32,778,82,860,9.534883720930232
23827,330490410000104,62,81,88,93,79,76,49,36,479,85,564,15.070921985815604
23828,330490410000105,45,56,40,71,59,40,36,25,311,61,372,16.397849462365592
23829,330490410000106,99,201,122,201,141,77,67,39,841,106,947,11.19324181626188
23830,330490410000107,61,68,64,72,62,39,33,21,366,54,420,12.857142857142858
23831,330490410000108,129,178,152,172,143,93,45,35,867,80,947,8.447729672650475
23832,330490410000109,162,560,43,547,140,16,5,2,1468,7,1475,0.4745762711864407
23833,330490410000110,161,192,140,175,118,63,57,27,849,84,933,9.003215434083602
23834,330490410000111,90,104,117,98,87,69,39,19,565,58,623,9.309791332263242
23835,330490410000112,53,68,78,71,62,50,26,26,382,52,434,11.981566820276498
23836,330490410000113,111,140,80,106,64,48,11,15,549,26,575,4.521739130434782
23837,330490410000114,150,185,180,145,146,108,63,41,914,104,1018,10.216110019646365
23838,330490410000115,56,82,56,114,72,67,44,10,447,54,501,10.778443113772456
23839,330490410000116,88,115,121,103,106,76,61,28,609,89,698,12.750716332378223
23840,330490410000117,107,141,78,122,120,57,53,48,625,101,726,13.911845730027549
23841,330490410000118,94,123,79,106,85,52,41,17,539,58,597,9.715242881072026
23842,330490410000119,157,217,157,165,156,102,55,38,954,93,1047,8.882521489971346
23843,330490410000120,120,140,141,130,103,90,64,35,724,99,823,12.029161603888214
23844,330490410000121,63,91,82,83,73,55,27,23,447,50,497,10.060362173038229
23845,330490410000122,145,124,136,106,94,69,26,10,674,36,710,5.070422535211268
23846,330490410000123,93,108,112,103,94,48,40,22,558,62,620,10.0
23847,330490410000124,159,228,160,226,122,54,35,18,949,53,1002,5.289421157684631
23848,330490410000125,69,99,108,129,89,39,36,13,533,49,582,8.419243986254296
23849,330490410000126,94,103,115,114,110,82,49,30,618,79,697,11.33428981348637
23850,330490410000127,100,89,130,120,95,87,61,52,621,113,734,15.39509536784741
23851,330490410000128,90,118,103,138,83,58,43,20,590,63,653,9.647779479326188
23852,330490410000129,71,79,84,83,62,71,23,19,450,42,492,8.536585365853659
23853,330490410000130,150,147,153,184,130,95,44,33,859,77,936,8.226495726495726
23854,330490410000131,107,134,98,130,119,57,43,33,645,76,721,10.540915395284328
23855,330490410000132,109,96,87,87,50,54,35,24,483,59,542,10.885608856088561
23856,330490410000133,61,78,77,78,86,49,35,24,429,59,488,12.09016393442623
23857,330490410000134,72,106,90,83,77,52,31,25,480,56,536,10.447761194029852
23858,330490410000135,109,131,142,127,117,75,50,31,701,81,782,10.358056265984654
23859,330490410000136,73,84,95,78,94,68,38,32,492,70,562,12.455516014234876
23860,330490410000137,88,163,88,139,120,74,59,47,672,106,778,13.624678663239074
23861,330490410000138,123,127,154,151,146,94,65,43,795,108,903,11.960132890365449
23862,330490410000139,115,129,151,121,117,97,61,35,730,96,826,11.62227602905569
23863,330490410000140,175,185,189,223,165,129,84,31,1066,115,1181,9.737510584250636
23864,330490410000141,64,102,98,93,99,67,45,19,523,64,587,10.90289608177172
23865,330490410000142,185,156,163,172,146,86,64,50,908,114,1022,11.154598825831702
23866,330490410000143,67,82,90,77,71,50,37,26,437,63,500,12.6
23867,330490410000144,108,139,148,142,105,92,50,45,734,95,829,11.459589867310012
23868,330490410000145,57,103,90,92,126,84,58,46,552,104,656,15.853658536585366
23869,330490410000146,87,125,106,117,116,93,52,40,644,92,736,12.5
23870,330490410000147,92,133,144,114,113,80,68,52,676,120,796,15.075376884422111
23871,330490410000148,70,117,122,112,102,84,53,24,607,77,684,11.257309941520468
23872,330490410000149,104,116,135,127,138,92,58,43,712,101,813,12.423124231242312
23873,330490410000150,46,66,56,62,55,36,25,14,321,39,360,10.833333333333334
23874,330490410000151,130,164,147,150,127,63,47,29,781,76,857,8.868144690781797
23875,330490410000152,58,89,69,70,78,59,33,21,423,54,477,11.320754716981131
23876,330490410000153,162,171,151,148,133,79,58,35,844,93,937,9.925293489861259
23877,330490410000154,131,135,122,149,101,79,50,41,717,91,808,11.262376237623762
23878,330490410000155,241,359,230,298,195,100,59,31,1423,90,1513,5.948446794448117
23879,330490410000156,188,295,182,201,122,57,59,23,1045,82,1127,7.275953859804791
23880,330490410000157,198,209,203,215,139,94,64,27,1058,91,1149,7.919930374238469
23881,330490410000158,106,109,130,157,115,66,41,30,683,71,754,9.416445623342176
23882,330490410000159,56,57,70,87,63,52,24,23,385,47,432,10.87962962962963
23883,330490410000160,94,116,111,126,90,73,37,35,610,72,682,10.557184750733137
23884,330490410000161,117,154,149,167,122,83,67,29,792,96,888,10.81081081081081
23885,330490410000162,163,171,193,201,173,126,70,48,1027,118,1145,10.305676855895197
23886,330490410000163,41,65,61,65,67,34,47,20,333,67,400,16.75
23887,330490410000164,72,59,81,73,70,59,32,31,414,63,477,13.20754716981132
23888,330490410000165,57,97,85,86,65,58,33,28,448,61,509,11.984282907662083
23889,330490410000166,59,97,80,121,92,60,48,28,509,76,585,12.991452991452991
23890,330490410000167,89,124,113,89,132,98,46,49,645,95,740,12.837837837837839
23891,330490410000168,131,178,191,187,180,127,82,58,994,140,1134,12.345679012345679
23892,330490410000169,101,146,134,142,127,105,70,59,755,129,884,14.592760180995475
23893,330490410000170,87,173,176,169,186,114,73,85,905,158,1063,14.863593603010347
23894,330490410000171,61,96,108,110,92,70,42,42,537,84,621,13.526570048309178
23895,330490410000172,64,76,94,80,87,70,53,37,471,90,561,16.0427807486631
23896,330490410000173,44,43,49,72,61,47,32,20,316,52,368,14.130434782608695
23897,330490410000174,45,44,65,66,53,40,32,26,313,58,371,15.633423180592992
23898,330490410000175,130,126,171,178,132,135,76,67,872,143,1015,14.088669950738916
23899,330490410000176,49,62,92,73,83,57,38,38,416,76,492,15.447154471544716
23900,330490410000177,76,103,111,107,104,90,31,22,591,53,644,8.229813664596273
23901,330490410000178,147,180,135,209,124,77,47,43,872,90,962,9.355509355509355
23902,330490410000179,160,124,224,183,167,135,76,52,993,128,1121,11.418376449598572
23903,330490410000180,87,117,117,113,102,90,36,34,626,70,696,10.057471264367816
23904,330490410000181,63,115,106,103,114,97,37,29,598,66,664,9.939759036144578
23905,330490410000182,65,92,103,78,95,88,36,33,521,69,590,11.694915254237289
23906,330490410000183,229,360,276,285,248,144,77,39,1542,116,1658,6.996381182147165
23907,330490410000184,6,6,3,8,6,2,3,2,31,5,36,13.88888888888889
23908,330490410000185,10,13,16,16,13,15,7,6,83,13,96,13.541666666666666
23909,330490410000186,4,7,4,5,4,3,0,2,27,2,29,6.896551724137931
23910,330490410000187,54,68,49,75,52,36,22,17,334,39,373,10.455764075067025
23911,330490410000188,2,3,1,3,2,3,1,0,14,1,15,6.666666666666667
23912,330490410000189,2,2,11,4,3,6,1,0,28,1,29,3.4482758620689653
23913,330490410000190,94,118,96,91,75,60,27,15,534,42,576,7.291666666666667
23914,330490410000191,4,11,5,7,13,8,3,2,48,5,53,9.433962264150944
23915,330490410000192,12,34,17,32,34,10,9,18,139,27,166,16.265060240963855
23916,330490410000193,112,105,123,110,107,61,23,28,618,51,669,7.623318385650224
23917,330490410000195,51,85,92,83,67,40,45,20,418,65,483,13.457556935817806
23918,330490410000196,146,153,156,148,127,82,66,37,812,103,915,11.256830601092895
23919,330490410000197,12,16,14,11,5,6,5,2,64,7,71,9.859154929577464
23920,330490410000198,81,91,98,99,69,65,32,13,503,45,548,8.211678832116789
23921,330490410000199,10,13,6,8,9,1,10,1,47,11,58,18.96551724137931
23922,330490410000200,6,7,7,3,1,5,2,1,29,3,32,9.375
23923,330490410000201,84,98,115,89,76,72,54,24,534,78,612,12.745098039215685
23924,330490410000202,22,34,18,25,23,9,3,2,131,5,136,3.676470588235294
23925,330490410000203,2,4,3,5,6,9,7,3,29,10,39,25.641025641025642
23926,330490410000204,12,10,16,10,9,9,2,4,66,6,72,8.333333333333334
23927,330490410000205,3,7,5,5,2,2,3,0,24,3,27,11.11111111111111
23928,330490410000206,36,53,40,57,48,34,29,17,268,46,314,14.64968152866242
23929,330490410000207,44,62,57,60,62,40,32,16,325,48,373,12.868632707774799
23930,330490410000208,59,54,65,72,67,32,26,15,349,41,390,10.512820512820513
23931,330490410000209,12,20,20,15,16,18,5,7,101,12,113,10.619469026548673
23932,330490410000210,37,26,47,33,34,24,11,10,201,21,222,9.45945945945946
23933,330490410000211,121,101,134,122,93,80,22,28,651,50,701,7.132667617689016
23934,330490410000212,4,10,14,5,11,9,5,2,53,7,60,11.666666666666666
23935,330490410000213,36,41,77,74,63,34,12,3,325,15,340,4.411764705882353
23936,330490410000214,106,107,181,192,121,91,27,14,798,41,839,4.886769964243147
23937,330490410000215,78,110,85,113,94,45,41,25,525,66,591,11.16751269035533
23938,330490410000216,22,14,25,21,18,22,6,13,122,19,141,13.47517730496454
23939,330490410000217,63,47,58,94,52,26,10,8,340,18,358,5.027932960893855
23940,330490410000218,5,3,13,7,13,4,5,2,45,7,52,13.461538461538462
23941,330490410000219,55,53,58,60,41,31,13,15,298,28,326,8.588957055214724
23944,330490410000222,48,64,60,55,48,52,32,14,327,46,373,12.332439678284182
23945,330490410000223,45,81,67,69,101,59,34,27,422,61,483,12.629399585921325
23946,330490410000224,137,136,114,142,109,53,61,22,691,83,774,10.723514211886306
23947,330490410000225,17,24,22,15,19,8,16,0,105,16,121,13.223140495867769
23948,330490410000226,32,61,49,64,57,43,35,20,306,55,361,15.23545706371191
23949,330490410000227,22,59,29,36,52,26,22,15,224,37,261,14.17624521072797
23950,330490410000228,21,38,31,29,34,22,20,12,175,32,207,15.458937198067632
23951,330490410000229,35,38,41,39,44,39,29,23,236,52,288,18.055555555555557
23952,330490410000230,54,74,91,89,72,59,37,29,439,66,505,13.069306930693068
23953,330490410000231,30,50,48,60,41,37,21,25,266,46,312,14.743589743589743
23954,330490410000232,44,79,77,71,72,50,26,21,393,47,440,10.681818181818182
23955,330490410000233,12,22,26,19,22,19,5,9,120,14,134,10.447761194029852
23956,330490410000234,12,25,15,21,30,25,9,17,128,26,154,16.883116883116884
23957,330490410000235,37,39,36,32,33,28,14,10,205,24,229,10.480349344978166
23958,330490410000236,68,82,73,77,85,60,30,21,445,51,496,10.28225806451613
23959,330490410000237,14,23,23,20,12,18,14,3,110,17,127,13.385826771653543
23960,330490410000238,120,123,144,114,112,76,47,17,689,64,753,8.49933598937583
23961,330490410000239,54,75,71,72,45,45,19,19,362,38,400,9.5
23962,330490410000240,47,54,71,61,59,45,23,11,337,34,371,9.164420485175203
23963,330490410000241,43,50,79,83,57,84,44,25,396,69,465,14.838709677419354
23965,330490410000243,5,1,3,5,1,0,2,1,15,3,18,16.666666666666668
23966,330490410000244,11,15,16,12,15,3,4,4,72,8,80,10.0
23968,330490410000246,17,20,11,18,11,8,2,2,85,4,89,4.49438202247191
23969,330490410000247,166,234,176,192,169,138,88,44,1075,132,1207,10.936205468102735
23970,330490410000248,76,93,89,136,77,25,21,9,496,30,526,5.7034220532319395
23971,330490410000249,2,7,12,5,13,8,6,1,47,7,54,12.962962962962964
23972,330490410000250,193,248,193,202,94,70,27,15,1000,42,1042,4.030710172744722
23973,330490410000251,76,74,88,77,78,57,27,20,450,47,497,9.456740442655935
23974,330490410000252,113,129,130,118,113,85,52,15,688,67,755,8.874172185430464
23975,330490410000254,7,7,10,8,5,11,0,1,48,1,49,2.0408163265306123
23976,330490410000255,170,197,184,172,171,108,64,31,1002,95,1097,8.659981768459435
23977,330490410000256,4,7,5,7,6,1,3,2,30,5,35,14.285714285714286
23978,330490410000257,2,3,1,3,0,0,2,1,9,3,12,25.0
23979,330490410000258,5,9,5,14,4,5,4,1,42,5,47,10.638297872340425
23981,330490410000260,12,13,18,13,8,15,8,7,79,15,94,15.957446808510639
23982,330490410000262,61,68,72,70,67,38,35,22,376,57,433,13.163972286374134
23984,330490410000265,25,28,29,24,25,32,28,15,163,43,206,20.87378640776699
23985,330490410000266,23,34,16,32,26,21,8,5,152,13,165,7.878787878787879
23986,330490410000267,6,1,5,4,4,5,8,3,25,11,36,30.555555555555557
23987,330490410000268,13,19,11,35,13,7,2,2,98,4,102,3.9215686274509802
23988,330490410000269,3,9,9,9,9,8,6,0,47,6,53,11.320754716981131
23989,330490410000270,20,16,19,21,16,10,12,3,102,15,117,12.820512820512821
23990,330490410000271,3,4,5,1,3,5,3,0,21,3,24,12.5
23991,330490410000272,9,9,6,9,3,3,2,2,39,4,43,9.30232558139535
23993,330490410000274,2,7,0,9,1,4,1,0,23,1,24,4.166666666666667
23994,330490410000275,6,11,3,6,9,4,2,3,39,5,44,11.363636363636363
23995,330490410000276,90,120,116,118,94,72,55,23,610,78,688,11.337209302325581
23996,330490410000277,72,93,75,87,63,55,44,17,445,61,506,12.055335968379447
23997,330490410000278,77,75,84,112,83,74,43,33,505,76,581,13.080895008605852
23998,330490410000279,65,50,80,68,64,46,35,20,373,55,428,12.850467289719626
23999,330490410000280,96,114,101,138,103,85,48,66,637,114,751,15.179760319573901
24000,330490410000282,7,16,11,12,19,9,5,3,74,8,82,9.75609756097561
24001,330490410000283,34,37,32,49,26,29,8,9,207,17,224,7.589285714285714
24002,330490410000284,94,93,82,113,114,66,53,23,562,76,638,11.912225705329154
24003,330490410000285,13,10,8,18,4,9,4,4,62,8,70,11.428571428571429
24004,330490410000286,33,29,18,25,22,17,4,2,144,6,150,4.0
24005,330490410000287,7,9,8,13,12,5,6,7,54,13,67,19.402985074626866
24006,330490410000288,6,17,7,13,11,6,3,2,60,5,65,7.6923076923076925
24007,330490410000289,38,46,62,54,57,50,26,19,307,45,352,12.784090909090908
24008,330490410000290,59,67,82,71,73,42,35,20,394,55,449,12.249443207126948
24009,330490410000291,85,86,83,95,64,67,40,29,480,69,549,12.568306010928962
24010,330490410000292,72,115,84,104,118,85,49,25,578,74,652,11.349693251533742
24011,330490410000293,49,67,89,48,55,42,25,14,350,39,389,10.025706940874036
24012,330490410000294,80,80,91,121,66,69,41,28,507,69,576,11.979166666666666
24013,330490410000295,191,265,205,196,203,100,66,36,1160,102,1262,8.082408874801901
24014,330490410000296,201,241,233,258,177,133,63,43,1243,106,1349,7.857672349888807
24015,330490410000297,90,129,131,108,112,80,49,35,650,84,734,11.444141689373296
24016,330490410000298,16,15,9,15,8,7,5,3,70,8,78,10.256410256410257
24017,330490410000299,6,3,5,4,1,4,0,0,23,0,23,0.0
24018,330490410000300,75,118,155,146,138,75,54,12,707,66,773,8.538163001293661
24019,330490410000301,49,47,60,55,47,27,26,9,285,35,320,10.9375
24020,330490410000302,104,52,76,179,110,33,24,13,554,37,591,6.260575296108291
24021,330490410000303,202,365,387,306,242,149,66,18,1651,84,1735,4.8414985590778095
24023,330490410000305,43,54,66,70,41,47,15,16,321,31,352,8.806818181818182
24025,330490410000307,19,40,26,32,27,21,9,6,165,15,180,8.333333333333334
24026,330490410000309,0,4,1,2,3,2,1,4,12,5,17,29.41176470588235
24027,330490410000310,16,18,21,18,18,22,11,5,113,16,129,12.4031007751938
24028,330490410000311,53,40,52,61,20,37,27,9,263,36,299,12.040133779264215
24029,330490410000312,5,7,1,4,3,2,0,1,22,1,23,4.3478260869565215
24030,330490410000313,12,11,15,13,8,6,3,0,65,3,68,4.411764705882353
24031,330490410000314,53,91,56,71,94,51,17,22,416,39,455,8.571428571428571
24032,330490410000315,25,41,44,45,32,23,22,10,210,32,242,13.223140495867769
24034,330490410000317,29,31,30,39,19,27,6,6,175,12,187,6.4171122994652405
24035,330490410000318,6,7,14,17,9,5,7,4,58,11,69,15.942028985507246
24036,330490410000319,52,60,50,61,60,39,26,16,322,42,364,11.538461538461538
24037,330490410000320,9,18,12,20,15,6,5,3,80,8,88,9.090909090909092
24038,330490410000321,70,85,102,71,87,73,50,41,488,91,579,15.716753022452504
24039,330490410000322,7,18,16,18,11,8,4,6,78,10,88,11.363636363636363
24041,330490410000324,5,7,4,2,1,4,1,2,23,3,26,11.538461538461538
24043,330490410000326,21,19,26,20,15,13,6,1,114,7,121,5.785123966942149
24044,330490410000327,83,85,86,86,78,42,19,22,460,41,501,8.183632734530939
24046,330490410000329,56,114,64,68,89,44,14,23,435,37,472,7.838983050847458
24047,330490410000330,30,60,55,62,47,18,20,6,272,26,298,8.724832214765101
24048,330490410000331,81,83,71,65,52,35,19,14,387,33,420,7.857142857142857
24050,330490410000333,27,20,26,21,13,7,3,1,114,4,118,3.389830508474576
24051,330490410000334,5,8,7,2,11,2,2,1,35,3,38,7.894736842105263
24052,330490410000335,123,150,132,124,114,86,48,23,729,71,800,8.875
24053,330490410000336,9,10,5,19,6,4,3,1,53,4,57,7.017543859649122
24055,330490410000338,3,3,12,2,3,5,2,1,28,3,31,9.67741935483871
24056,330490410000339,9,11,10,18,11,8,6,8,67,14,81,17.28395061728395
24057,330490410000340,109,150,149,164,150,102,68,55,824,123,947,12.988384371700105
24058,330490410000341,15,19,12,14,10,9,9,1,79,10,89,11.235955056179776
24059,330490410000342,97,112,102,126,88,65,37,16,590,53,643,8.242612752721618
24060,330490410000343,38,49,47,56,32,24,20,3,246,23,269,8.550185873605948
24062,330490410000345,63,66,70,84,56,49,22,15,388,37,425,8.705882352941176
24063,330490410000346,74,73,105,99,73,71,32,29,495,61,556,10.971223021582734
24064,330490410000347,98,131,124,133,84,53,40,21,623,61,684,8.91812865497076
24065,330490410000348,45,81,58,60,64,31,29,11,339,40,379,10.554089709762533
24066,330490410000349,37,55,34,50,43,32,25,12,251,37,288,12.847222222222221
24067,330490410000350,47,71,74,76,103,52,23,32,423,55,478,11.506276150627615
24068,330490410000351,108,95,128,113,93,71,50,25,608,75,683,10.980966325036603
24069,330490410000352,39,72,94,66,49,47,10,2,367,12,379,3.1662269129287597
24070,330490410000353,10,11,17,22,8,16,7,2,84,9,93,9.67741935483871
24071,330490410000354,3,8,6,11,11,1,2,2,40,4,44,9.090909090909092
24072,330490410000355,83,125,97,112,107,67,37,28,591,65,656,9.908536585365853
24074,330490410000357,6,10,8,9,13,8,8,3,54,11,65,16.923076923076923
24075,330490410000358,2,6,2,11,2,2,5,3,25,8,33,24.242424242424242
24076,330490410000359,38,43,48,32,37,36,17,7,234,24,258,9.30232558139535
24077,330490410000360,210,242,210,206,170,111,52,40,1149,92,1241,7.413376309427881
24078,330490410000361,74,52,41,110,86,29,34,13,392,47,439,10.70615034168565
24079,330490410000362,20,43,51,45,23,23,6,2,205,8,213,3.755868544600939
24080,330490410000364,66,77,83,98,56,63,25,9,443,34,477,7.127882599580713
24082,330490410000366,39,63,61,47,43,36,16,6,289,22,311,7.07395498392283
24083,330490410000367,35,57,35,45,44,27,15,9,243,24,267,8.98876404494382
24084,330490410000368,31,30,29,42,25,21,22,3,178,25,203,12.31527093596059
24085,330490410000369,102,122,121,136,113,61,37,23,655,60,715,8.391608391608392
24086,330490410000370,74,108,76,121,95,82,50,20,556,70,626,11.182108626198083
24087,330490410000371,135,191,135,156,131,95,49,29,843,78,921,8.469055374592834
24088,330490410000372,239,205,171,268,121,48,31,12,1052,43,1095,3.9269406392694064
24089,330490410000373,146,182,199,213,172,123,77,44,1035,121,1156,10.46712802768166
24090,330490410000374,123,147,176,160,150,107,65,26,863,91,954,9.538784067085954
24091,330490415000001,44,87,81,93,85,63,34,37,453,71,524,13.549618320610687
24092,330490415000002,76,75,90,72,95,86,44,40,494,84,578,14.53287197231834
24093,330490415000003,66,81,104,96,53,51,39,34,451,73,524,13.931297709923664
24094,330490415000004,27,63,34,48,55,23,16,21,250,37,287,12.89198606271777
24095,330490415000005,108,138,132,120,131,111,50,32,740,82,822,9.975669099756692
24096,330490415000006,26,35,31,25,15,18,5,3,150,8,158,5.063291139240507
24097,330490415000007,61,103,86,72,77,50,24,13,449,37,486,7.613168724279835
24098,330490415000008,90,103,81,116,86,71,28,17,547,45,592,7.601351351351352
24099,330490415000009,118,189,144,158,147,106,40,36,862,76,938,8.102345415778252
24100,330490415000010,183,243,231,214,170,102,54,57,1143,111,1254,8.851674641148325
24101,330490415000011,85,126,103,151,125,70,47,23,660,70,730,9.58904109589041
24102,330490415000012,62,76,89,83,71,46,39,28,427,67,494,13.562753036437247
24103,330490415000013,68,82,118,102,88,47,35,16,505,51,556,9.172661870503598
24104,330490415000014,79,125,119,104,124,83,47,36,634,83,717,11.576011157601116
24105,330490415000015,100,128,118,132,136,92,47,43,706,90,796,11.306532663316583
24106,330490415000016,77,82,101,85,79,80,47,34,504,81,585,13.846153846153847
24107,330490415000017,79,107,115,94,110,64,35,40,569,75,644,11.645962732919255
24108,330490415000018,54,77,80,82,67,45,38,43,405,81,486,16.666666666666668
24109,330490415000019,72,82,80,66,69,64,48,31,433,79,512,15.4296875
24110,330490415000020,52,62,50,64,51,41,35,21,320,56,376,14.893617021276595
24111,330490415000021,108,169,172,141,122,113,57,40,825,97,922,10.52060737527115
24112,330490415000022,128,162,162,146,155,87,78,43,840,121,961,12.59105098855359
24113,330490415000023,39,40,58,47,45,48,37,23,277,60,337,17.80415430267062
24114,330490415000024,80,163,99,117,121,86,56,42,666,98,764,12.827225130890053
24115,330490415000025,96,112,144,117,104,91,61,50,664,111,775,14.32258064516129
24116,330490415000026,116,93,151,124,106,79,42,23,669,65,734,8.85558583106267
24117,330490415000027,83,94,107,94,95,67,48,30,540,78,618,12.62135922330097
24118,330490415000028,88,76,91,97,85,45,41,25,482,66,548,12.043795620437956
24119,330490415000029,85,104,105,118,103,94,56,31,609,87,696,12.5
24120,330490415000030,67,118,119,121,105,81,66,58,611,124,735,16.87074829931973
24121,330490415000031,126,159,169,130,175,107,57,29,866,86,952,9.033613445378151
24122,330490415000032,101,143,126,149,116,84,37,25,719,62,781,7.9385403329065305
24123,330490415000033,67,86,74,89,89,44,42,25,449,67,516,12.984496124031008
24124,330490415000034,81,84,99,100,79,50,30,19,493,49,542,9.040590405904059
24125,330490415000035,82,103,119,102,87,51,41,15,544,56,600,9.333333333333334
24126,330490415000036,99,153,129,156,121,79,54,36,737,90,827,10.882708585247883
24127,330490415000037,113,151,120,139,136,68,41,42,727,83,810,10.246913580246913
24128,330490415000038,127,169,155,150,143,100,55,49,844,104,948,10.970464135021096
24129,330490415000039,109,132,156,137,114,86,55,36,734,91,825,11.030303030303031
24130,330490415000040,57,73,99,102,87,66,41,17,484,58,542,10.70110701107011
24131,330490415000041,112,117,140,158,116,109,76,58,752,134,886,15.124153498871332
24132,330490415000042,86,171,107,102,112,61,36,29,639,65,704,9.232954545454545
24133,330490415000043,50,68,88,56,33,44,6,8,339,14,353,3.9660056657223794
24134,330490415000044,160,121,176,167,113,108,100,51,845,151,996,15.160642570281125
24135,330490415000045,93,102,123,125,79,69,48,20,591,68,659,10.318664643399089
24136,330490415000046,123,140,156,185,101,126,69,43,831,112,943,11.876988335100743
24137,330490415000047,133,180,166,181,144,123,71,38,927,109,1036,10.521235521235521
24138,330490415000048,97,119,113,118,98,77,45,22,622,67,689,9.72423802612482
24139,330490415000049,83,90,101,96,99,63,33,25,532,58,590,9.830508474576272
24140,330490415000050,151,184,138,170,142,108,67,47,893,114,1007,11.320754716981131
24141,330490415000051,95,111,119,113,96,59,39,43,593,82,675,12.148148148148149
24142,330490415000052,118,133,111,154,117,73,60,42,706,102,808,12.623762376237623
24143,330490415000053,114,138,121,158,100,73,35,42,704,77,781,9.859154929577464
24144,330490415000054,134,178,162,153,149,112,47,26,888,73,961,7.596253902185223
24145,330490415000055,224,218,183,248,176,90,63,22,1139,85,1224,6.944444444444445
24146,330490415000056,129,152,116,103,87,69,40,31,656,71,727,9.766162310866575
24147,330490415000057,145,215,157,192,182,106,62,41,997,103,1100,9.363636363636363
24148,330490415000058,128,139,142,148,122,76,51,37,755,88,843,10.438908659549229
24149,330490415000059,126,160,144,143,136,81,66,38,790,104,894,11.6331096196868
24150,330490415000060,124,149,164,174,137,118,76,54,866,130,996,13.052208835341366
24151,330490415000061,155,189,228,201,181,126,82,60,1080,142,1222,11.620294599018003
24152,330490415000062,158,183,171,186,152,123,64,51,973,115,1088,10.569852941176471
24153,330490415000063,147,196,199,175,170,107,54,34,994,88,1082,8.133086876155268
24154,330490415000064,175,226,241,210,181,127,67,49,1160,116,1276,9.090909090909092
24155,330490415000065,130,160,122,150,119,47,45,39,728,84,812,10.344827586206897
24156,330490415000066,120,137,133,138,122,81,47,51,731,98,829,11.821471652593486
24157,330490415000067,67,102,99,117,94,61,43,27,540,70,610,11.475409836065573
24158,330490415000068,115,146,163,133,132,91,45,29,780,74,854,8.665105386416862
24159,330490415000069,115,157,123,129,121,86,55,36,731,91,822,11.070559610705596
24160,330490415000070,79,83,101,84,86,61,37,33,494,70,564,12.411347517730496
24161,330490415000071,66,92,102,92,80,67,35,18,499,53,552,9.601449275362318
24162,330490415000072,122,174,185,156,139,109,64,34,885,98,983,9.969481180061038
24163,330490415000073,75,91,86,80,81,62,45,34,475,79,554,14.259927797833935
24164,330490415000074,135,179,209,167,192,130,98,56,1012,154,1166,13.20754716981132
24165,330490415000075,153,223,258,222,186,105,89,76,1147,165,1312,12.576219512195122
24166,330490415000076,201,202,225,215,163,137,94,41,1143,135,1278,10.56338028169014
24167,330490415000077,136,209,231,194,111,78,69,35,959,104,1063,9.783631232361241
24168,330490415000078,115,135,165,147,130,89,51,41,781,92,873,10.538373424971363
24169,330490415000079,114,148,128,143,107,84,41,30,724,71,795,8.930817610062894
24170,330490415000080,53,79,75,77,81,61,40,34,426,74,500,14.8
24171,330490415000081,79,78,91,85,85,58,53,28,476,81,557,14.542190305206462
24172,330490415000082,71,116,93,89,85,61,44,25,515,69,584,11.815068493150685
24173,330490415000083,73,107,96,128,103,90,51,26,597,77,674,11.42433234421365
24174,330490415000084,78,140,107,115,102,79,51,28,621,79,700,11.285714285714286
24175,330490415000085,78,97,109,102,67,59,47,16,512,63,575,10.956521739130435
24176,330490415000086,89,151,134,124,109,68,30,22,675,52,727,7.152682255845942
24177,330490415000087,71,120,86,110,99,57,44,31,543,75,618,12.135922330097088
24178,330490415000088,109,144,148,139,132,95,43,24,767,67,834,8.03357314148681
24179,330490415000089,94,126,104,113,78,71,28,10,586,38,624,6.089743589743589
24180,330490415000090,157,154,147,150,125,80,46,25,813,71,884,8.031674208144796
24181,330490415000091,124,156,176,132,134,94,49,40,816,89,905,9.834254143646408
24182,330490415000092,92,254,113,177,152,96,56,40,884,96,980,9.795918367346939
24183,330490415000093,111,202,140,198,155,99,61,35,905,96,1001,9.59040959040959
24184,330490415000094,89,85,135,100,96,85,54,39,590,93,683,13.616398243045388
24185,330490415000095,114,150,121,157,126,82,48,22,750,70,820,8.536585365853659
24186,330490415000096,101,107,122,98,103,80,36,30,611,66,677,9.748892171344165
24187,330490415000097,169,289,285,285,239,159,75,35,1426,110,1536,7.161458333333333
24188,330490415000098,146,162,143,133,130,96,35,23,810,58,868,6.682027649769585
24190,330490415000100,154,164,206,172,124,92,66,44,912,110,1022,10.76320939334638
24191,330490415000101,80,97,106,89,75,64,30,16,511,46,557,8.258527827648114
24192,330490415000102,191,226,170,193,131,116,67,36,1027,103,1130,9.11504424778761
24193,330490415000103,158,168,181,192,118,112,65,20,929,85,1014,8.382642998027613
24194,330490415000104,121,170,97,146,156,75,60,30,765,90,855,10.526315789473685
24195,330490415000105,127,157,149,175,128,118,56,43,854,99,953,10.388247639034628
24196,330490415000106,88,128,118,124,118,86,51,45,662,96,758,12.664907651715039
24197,330490415000107,117,140,138,112,115,74,33,21,696,54,750,7.2
24198,330490415000108,47,38,45,64,33,30,10,7,257,17,274,6.204379562043796
24199,330490415000109,121,118,136,113,94,55,28,12,637,40,677,5.908419497784343
24200,330490415000110,172,209,188,178,170,164,74,51,1081,125,1206,10.364842454394694
24201,330490415000111,163,157,208,161,140,132,71,52,961,123,1084,11.346863468634686
24202,330490415000112,125,159,151,154,127,96,51,38,812,89,901,9.877913429522753
24203,330490415000113,55,75,68,61,70,61,23,20,390,43,433,9.930715935334874
24204,330490415000114,144,146,165,143,137,88,39,21,823,60,883,6.795016987542469
24205,330490415000115,93,93,90,99,80,57,22,11,512,33,545,6.055045871559633
24206,330490415000116,153,165,183,174,131,98,61,30,904,91,995,9.14572864321608
24207,330490415000117,108,112,102,92,106,82,49,32,602,81,683,11.859443631039532
24208,330490415000118,50,61,66,55,65,62,31,20,359,51,410,12.439024390243903
24209,330490415000119,12,33,13,24,17,6,2,8,105,10,115,8.695652173913043
24210,330490415000120,238,288,274,237,201,135,69,41,1373,110,1483,7.4173971679029
24211,330490415000121,74,96,105,113,69,77,38,20,534,58,592,9.797297297297296
24212,330490415000122,79,92,76,77,64,63,38,16,451,54,505,10.693069306930694
24213,330490415000123,126,127,136,150,114,101,50,30,754,80,834,9.59232613908873
24214,330490415000124,92,122,154,158,79,113,90,35,718,125,843,14.827995255041518
24215,330490415000125,90,125,127,115,90,89,45,20,636,65,701,9.27246790299572
24216,330490415000126,139,174,170,166,180,126,70,32,955,102,1057,9.649952696310311
24217,330490415000127,94,119,143,141,69,55,25,27,621,52,673,7.726597325408618
24218,330490415000128,110,124,102,133,90,67,50,22,626,72,698,10.315186246418339
24219,330490415000129,124,163,136,182,103,87,59,20,795,79,874,9.038901601830664
24220,330490415000130,104,131,102,122,83,74,45,28,616,73,689,10.595065312046444
24221,330490415000131,74,91,71,77,58,36,34,14,407,48,455,10.54945054945055
24222,330490415000132,70,102,87,112,75,49,47,19,495,66,561,11.764705882352942
24223,330490415000133,97,112,124,149,102,84,76,47,668,123,791,15.549936788874842
24224,330490415000134,154,174,163,215,166,119,69,32,991,101,1092,9.249084249084248
24225,330490415000135,140,168,149,174,110,57,45,30,798,75,873,8.59106529209622
24226,330490415000136,35,54,62,54,51,54,22,16,310,38,348,10.919540229885058
24227,330490415000137,70,96,114,118,94,90,31,23,582,54,636,8.49056603773585
24228,330490415000138,41,61,65,60,68,38,34,38,333,72,405,17.77777777777778
24229,330490415000139,33,57,40,41,41,29,16,6,241,22,263,8.365019011406844
24230,330490415000140,40,44,65,55,48,43,27,13,295,40,335,11.940298507462687
24231,330490415000141,79,73,100,115,99,79,43,32,545,75,620,12.096774193548388
24232,330490415000142,128,140,187,170,148,132,58,36,905,94,999,9.40940940940941
24233,330490415000143,117,148,177,137,118,97,78,42,794,120,914,13.12910284463895
24234,330490415000144,67,100,98,95,122,69,49,26,551,75,626,11.980830670926517
24235,330490415000145,164,197,194,230,185,133,69,45,1103,114,1217,9.367296631059984
24236,330490415000146,128,162,136,136,103,87,39,22,752,61,813,7.503075030750307
24237,330490415000147,136,170,220,180,174,127,55,38,1007,93,1100,8.454545454545455
24238,330490415000148,76,110,82,77,65,41,28,10,451,38,489,7.770961145194274
24239,330490415000149,85,88,105,107,79,65,33,28,529,61,590,10.338983050847459
24240,330490415000150,48,60,38,48,30,35,17,5,259,22,281,7.829181494661921
24241,330490415000151,81,131,78,122,111,65,37,14,588,51,639,7.981220657276995
24242,330490415000152,118,166,158,154,141,102,64,39,839,103,942,10.934182590233545
24243,330490415000153,67,74,57,75,60,30,31,24,363,55,418,13.157894736842104
24244,330490415000154,95,186,163,141,155,81,63,40,821,103,924,11.147186147186147
24245,330490415000155,61,82,71,61,64,37,29,19,376,48,424,11.320754716981131
24246,330490415000156,94,102,101,121,89,83,41,32,590,73,663,11.010558069381599
24247,330490415000157,99,131,111,127,93,65,31,19,626,50,676,7.396449704142012
24248,330490415000158,192,271,222,254,225,131,68,57,1295,125,1420,8.80281690140845
24249,330490415000159,100,74,100,86,86,80,49,29,526,78,604,12.913907284768213
24250,330490415000160,90,130,158,124,97,102,54,37,701,91,792,11.48989898989899
24251,330490415000161,66,129,174,84,122,115,44,20,690,64,754,8.488063660477454
24252,330490415000162,106,218,178,161,212,116,51,39,991,90,1081,8.325624421831638
24253,330490415000163,140,195,178,164,133,74,37,23,884,60,944,6.3559322033898304
24254,330490415000164,146,143,161,134,117,92,65,23,793,88,881,9.988649262202044
24255,330490415000165,93,134,135,118,103,85,46,15,668,61,729,8.367626886145406
24256,330490415000166,49,88,63,77,80,66,38,34,423,72,495,14.545454545454545
24257,330490415000167,120,127,137,132,123,93,65,53,732,118,850,13.882352941176471
24258,330490415000168,66,93,82,88,84,61,29,19,474,48,522,9.195402298850574
24259,330490415000169,77,76,110,106,86,48,26,24,503,50,553,9.041591320072333
24260,330490415000170,90,152,144,142,153,95,53,29,776,82,858,9.557109557109557
24261,330490415000171,94,163,123,154,148,78,51,45,760,96,856,11.214953271028037
24262,330490415000173,91,96,112,141,153,72,52,25,665,77,742,10.377358490566039
24263,330490415000174,163,271,270,257,267,153,95,54,1381,149,1530,9.738562091503267
24264,330490415000175,145,172,174,212,142,124,85,51,969,136,1105,12.307692307692308
24265,330490415000176,112,206,176,128,220,138,62,32,980,94,1074,8.752327746741155
24266,330490415000177,74,111,117,125,102,80,34,33,609,67,676,9.911242603550296
24267,330490415000178,40,54,49,41,62,38,26,14,284,40,324,12.345679012345679
24268,330490415000179,74,112,113,113,87,59,35,21,558,56,614,9.120521172638437
24269,330490415000180,118,163,207,151,150,129,57,46,918,103,1021,10.088148873653282
24270,330490415000181,66,97,139,145,83,48,26,18,578,44,622,7.07395498392283
24271,330490415000182,82,111,247,164,82,91,36,24,777,60,837,7.168458781362007
24272,330490415000183,77,111,179,172,145,92,69,45,776,114,890,12.808988764044944
24273,330490415000184,111,206,139,165,164,100,66,49,885,115,1000,11.5
24274,330490415000185,95,115,119,120,109,93,45,40,651,85,736,11.548913043478262
24275,330490415000186,183,205,192,184,185,106,87,51,1055,138,1193,11.567476948868398
24276,330490415000187,102,167,148,138,140,85,45,32,780,77,857,8.98483080513419
24277,330490415000188,105,155,267,148,160,85,33,26,920,59,979,6.026557711950971
24278,330490415000189,73,95,96,103,70,62,35,32,499,67,566,11.837455830388693
24279,330490415000190,92,128,186,139,123,94,76,46,762,122,884,13.800904977375566
24280,330490415000191,90,102,100,127,112,75,64,26,606,90,696,12.931034482758621
24281,330490415000192,63,70,113,80,79,55,35,35,460,70,530,13.20754716981132
24282,330490415000193,94,188,206,191,135,72,74,51,886,125,1011,12.363996043521267
24283,330490415000194,78,78,107,85,70,56,33,22,474,55,529,10.396975425330814
24284,330490415000195,47,69,81,68,66,59,31,28,390,59,449,13.140311804008908
24285,330490415000196,74,91,97,102,102,58,31,38,524,69,593,11.63575042158516
24286,330490415000197,93,122,152,155,128,134,72,57,784,129,913,14.129244249726177
24287,330490415000198,108,129,231,131,121,121,58,36,841,94,935,10.053475935828876
24288,330490415000199,93,180,159,147,122,88,46,35,789,81,870,9.310344827586206
24289,330490415000200,64,118,123,115,76,77,38,43,573,81,654,12.385321100917432
24290,330490415000201,94,103,105,127,102,73,36,31,604,67,671,9.985096870342772
24291,330490415000202,69,68,103,97,71,68,51,35,476,86,562,15.302491103202847
24292,330490415000203,107,125,139,119,112,102,64,39,704,103,807,12.763320941759604
24293,330490415000204,85,89,108,94,98,66,45,36,540,81,621,13.043478260869565
24294,330490415000205,70,109,93,102,92,70,44,38,536,82,618,13.268608414239482
24295,330490415000206,100,122,93,121,89,61,46,26,586,72,658,10.94224924012158
24296,330490415000207,59,89,95,91,85,71,43,31,490,74,564,13.120567375886525
24297,330490415000208,41,74,76,66,79,61,28,22,397,50,447,11.185682326621924
24298,330490415000209,46,56,62,59,55,37,16,15,315,31,346,8.959537572254336
24299,330490415000210,91,117,116,114,99,91,59,47,628,106,734,14.44141689373297
24300,330490415000211,18,17,22,22,15,14,6,5,108,11,119,9.243697478991596
24301,330490415000212,47,47,66,58,57,46,31,19,321,50,371,13.477088948787062
24302,330490415000213,84,100,75,102,69,57,42,32,487,74,561,13.190730837789662
24303,330490415000214,52,68,91,70,76,56,33,27,413,60,473,12.684989429175475
24304,330490415000215,65,79,99,81,85,62,25,26,471,51,522,9.770114942528735
24305,330490415000216,134,143,209,141,126,115,45,55,868,100,968,10.330578512396695
24306,330490415000217,122,151,142,142,142,94,44,46,793,90,883,10.192525481313703
24307,330490415000218,89,126,86,124,82,40,30,23,547,53,600,8.833333333333334
24308,330490415000219,130,170,149,132,114,88,36,25,783,61,844,7.2274881516587675
24309,330490415000220,85,96,112,113,98,66,34,24,570,58,628,9.235668789808917
24310,330490415000221,60,94,85,82,94,54,35,31,469,66,535,12.336448598130842
24311,330490415000222,97,115,237,135,87,91,28,33,762,61,823,7.411907654921021
24312,330490415000223,89,104,137,127,135,97,35,36,689,71,760,9.342105263157896
24313,330490415000224,53,63,79,84,85,61,45,20,425,65,490,13.26530612244898
24314,330490415000225,33,45,56,54,51,52,27,25,291,52,343,15.160349854227405
24315,330490415000226,72,89,108,67,108,80,51,25,524,76,600,12.666666666666666
24316,330490415000227,42,59,65,50,67,38,42,35,321,77,398,19.34673366834171
24317,330490415000228,47,86,80,66,105,73,55,56,457,111,568,19.54225352112676
24318,330490415000229,40,75,60,80,70,78,40,28,403,68,471,14.437367303609342
24319,330490415000230,94,126,146,108,110,91,49,32,675,81,756,10.714285714285714
24320,330490415000231,65,82,85,96,87,55,47,35,470,82,552,14.855072463768115
24321,330490415000232,70,92,98,103,86,72,35,30,521,65,586,11.092150170648464
24322,330490415000233,102,110,99,101,68,54,28,19,534,47,581,8.089500860585199
24323,330490415000234,80,107,98,89,91,55,49,28,520,77,597,12.89782244556114
24324,330490415000235,50,69,67,73,61,34,27,9,354,36,390,9.23076923076923
24325,330490415000236,53,65,83,74,75,48,27,29,398,56,454,12.334801762114537
24326,330490415000237,68,89,59,92,56,28,25,19,392,44,436,10.091743119266056
24327,330490415000238,60,59,90,63,84,76,26,6,432,32,464,6.896551724137931
24328,330490415000239,39,76,58,60,56,48,24,8,337,32,369,8.672086720867208
24329,330490415000240,44,71,73,80,76,47,29,22,391,51,442,11.538461538461538
24330,330490415000241,100,103,102,85,86,51,31,28,527,59,586,10.06825938566553
24331,330490415000242,63,81,83,76,68,52,27,21,423,48,471,10.19108280254777
24332,330490415000243,61,69,79,89,68,51,35,27,417,62,479,12.943632567849686
24333,330490415000244,69,110,94,93,76,50,34,22,492,56,548,10.218978102189782
24334,330490415000245,77,111,95,98,104,55,29,14,540,43,583,7.375643224699829
24335,330490415000246,94,100,120,100,100,68,44,22,582,66,648,10.185185185185185
24336,330490415000247,49,55,68,52,46,44,17,3,314,20,334,5.9880239520958085
24337,330490415000248,10,17,10,7,10,2,2,1,56,3,59,5.084745762711864
24338,330490415000249,9,15,8,14,18,11,5,6,75,11,86,12.790697674418604
24339,330490415000250,32,73,55,61,68,46,29,20,335,49,384,12.760416666666666
24340,330490415000251,75,103,92,60,77,61,26,22,468,48,516,9.30232558139535
24341,330490415000252,83,101,129,84,72,70,31,30,539,61,600,10.166666666666666
24342,330490415000253,125,145,168,173,130,88,41,25,829,66,895,7.374301675977653
24343,330490415000254,33,92,62,77,71,27,26,18,362,44,406,10.83743842364532
24344,330490415000255,40,47,50,45,38,41,15,9,261,24,285,8.421052631578947
24345,330490415000256,45,94,69,70,78,56,21,16,412,37,449,8.240534521158128
24346,330490415000257,244,288,284,302,203,142,67,48,1463,115,1578,7.287705956907478
24347,330490415000258,20,27,37,39,20,10,11,4,153,15,168,8.928571428571429
24348,330490415000259,99,109,114,106,99,66,39,23,593,62,655,9.465648854961833
24350,330490415000262,90,105,87,84,74,64,34,17,504,51,555,9.18918918918919
24351,330490415000263,92,138,96,130,95,71,34,19,622,53,675,7.851851851851852
24352,330490415000264,153,196,191,134,142,84,53,18,900,71,971,7.312049433573636
24353,330490415000265,151,117,158,156,80,91,57,21,753,78,831,9.386281588447654
24354,330490415000266,115,150,70,141,91,54,27,20,621,47,668,7.0359281437125745
24355,330490415000267,95,183,120,151,115,62,49,21,726,70,796,8.793969849246231
24356,330490415000268,51,69,92,60,58,29,30,27,359,57,416,13.701923076923077
24357,330490415000269,6,8,5,1,11,13,3,12,44,15,59,25.423728813559322
24358,330490415000271,180,167,185,176,126,102,57,29,936,86,1022,8.414872798434443
24359,330490415000272,28,70,42,49,38,27,21,10,254,31,285,10.87719298245614
24360,330490415000273,99,116,122,107,96,102,53,31,642,84,726,11.570247933884298
24361,330490415000274,74,78,66,89,69,41,29,12,417,41,458,8.951965065502183
24362,330490415000275,160,143,233,150,136,151,74,54,973,128,1101,11.625794732061761
24363,330490415000276,113,128,125,127,92,68,35,19,653,54,707,7.637906647807638
24364,330490415000277,158,115,206,166,96,133,49,30,874,79,953,8.289611752360965
24365,330490415000278,49,35,51,41,34,25,14,10,235,24,259,9.266409266409266
24366,330490415000279,48,51,56,55,43,43,23,5,296,28,324,8.641975308641975
24367,330490415000280,69,67,108,89,68,65,31,14,466,45,511,8.806262230919765
24369,330490415000282,2,2,3,4,1,5,2,0,17,2,19,10.526315789473685
24370,330490415000283,101,151,102,130,119,71,46,26,674,72,746,9.651474530831099
24371,330490415000284,55,63,64,60,61,46,14,16,349,30,379,7.915567282321899
24372,330490415000285,143,280,244,232,161,102,37,14,1162,51,1213,4.204451772464963
24373,330490415000286,45,38,50,43,31,39,9,11,246,20,266,7.518796992481203
24374,330490415000287,7,6,8,10,6,8,4,3,45,7,52,13.461538461538462
24375,330490415000288,71,65,63,59,52,33,21,13,343,34,377,9.018567639257295
24376,330490415000289,104,112,95,104,72,64,28,16,551,44,595,7.394957983193278
24377,330490415000290,155,141,155,126,133,98,49,36,808,85,893,9.518477043673013
24378,330490415000291,100,209,213,164,118,85,49,27,889,76,965,7.875647668393782
24380,330490415000293,6,4,6,3,4,1,1,0,24,1,25,4.0
24381,330490415000294,50,69,47,56,62,18,21,15,302,36,338,10.650887573964496
24383,330490415000296,13,11,10,17,15,11,3,1,77,4,81,4.938271604938271
24384,330490415000297,18,18,22,14,16,6,7,1,94,8,102,7.8431372549019605
24385,330490415000298,51,63,39,61,57,36,21,13,307,34,341,9.970674486803519
24386,330490415000299,12,8,14,13,14,6,0,2,67,2,69,2.898550724637681
24388,330490415000301,28,43,40,39,46,39,33,14,235,47,282,16.666666666666668
24389,330490415000302,6,18,13,9,15,10,3,0,71,3,74,4.054054054054054
24390,330490415000303,90,164,168,143,140,78,42,10,783,52,835,6.227544910179641
24391,330490415000304,82,84,80,149,72,46,16,4,513,20,533,3.75234521575985
24392,330490415000305,29,70,40,53,53,35,11,12,280,23,303,7.590759075907591
24393,330490415000306,19,23,21,22,15,11,5,1,111,6,117,5.128205128205129
24394,330490415000307,16,15,15,12,12,7,8,3,77,11,88,12.5
24395,330490415000308,56,76,150,123,87,71,40,26,563,66,629,10.492845786963434
24396,330490415000309,16,16,16,25,16,6,7,4,95,11,106,10.377358490566039
24397,330490415000310,59,74,75,85,93,73,33,20,459,53,512,10.3515625
24398,330490415000311,39,31,51,41,42,42,24,11,246,35,281,12.455516014234876
24399,330490415000312,4,13,11,9,8,5,4,2,50,6,56,10.714285714285714
24400,330490415000313,29,44,32,48,50,34,19,13,237,32,269,11.895910780669144
24401,330490415000314,17,22,31,33,6,13,7,1,122,8,130,6.153846153846154
24402,330490415000315,14,19,22,18,17,12,8,4,102,12,114,10.526315789473685
24404,330490415000317,32,54,45,42,57,26,12,9,256,21,277,7.581227436823105
24405,330490415000318,16,34,35,31,28,23,37,11,167,48,215,22.325581395348838
24406,330490415000319,50,70,49,54,47,35,15,13,305,28,333,8.408408408408409
24407,330490415000320,38,49,44,76,56,44,29,23,307,52,359,14.484679665738161
24408,330490415000321,27,30,26,48,22,14,3,8,167,11,178,6.179775280898877
24409,330490415000322,21,26,29,24,24,8,2,3,132,5,137,3.6496350364963503
24410,330490415000323,10,16,18,12,18,16,4,8,90,12,102,11.764705882352942
24411,330490415000324,24,33,37,33,45,21,13,9,193,22,215,10.232558139534884
24413,330490415000326,42,56,53,49,59,55,14,25,314,39,353,11.048158640226628
24414,330490415000327,2,6,1,5,1,2,2,1,17,3,20,15.0
24415,330490415000328,29,57,78,51,57,28,27,11,300,38,338,11.242603550295858
24416,330490415000329,19,23,27,43,25,16,26,3,153,29,182,15.934065934065934
24417,330490415000330,49,74,61,68,73,59,33,14,384,47,431,10.904872389791183
24418,330490415000331,13,18,21,16,21,23,16,5,112,21,133,15.789473684210526
24419,330490415000332,8,24,13,31,16,15,14,14,107,28,135,20.74074074074074
24420,330490415000333,15,10,24,19,14,14,2,5,96,7,103,6.796116504854369
24421,330490415000334,6,11,12,9,15,14,9,6,67,15,82,18.29268292682927
24422,330490415000335,2,4,4,5,9,2,3,3,26,6,32,18.75
24423,330490415000336,49,67,90,74,55,53,30,27,388,57,445,12.808988764044944
24424,330490415000337,59,92,76,105,71,53,29,28,456,57,513,11.11111111111111
24425,330490415000338,5,10,10,11,18,9,7,5,63,12,75,16.0
24426,330490415000339,17,18,16,22,27,19,9,12,119,21,140,15.0
24427,330490415000340,9,15,10,8,17,5,5,6,64,11,75,14.666666666666666
24428,330490415000341,5,11,23,5,18,22,8,11,84,19,103,18.446601941747574
24429,330490415000342,23,17,29,28,21,21,8,10,139,18,157,11.464968152866241
24430,330490415000343,2,6,7,6,2,3,5,2,26,7,33,21.21212121212121
24431,330490415000344,7,13,11,9,4,10,5,4,54,9,63,14.285714285714286
24432,330490415000345,9,24,18,19,22,23,9,8,115,17,132,12.878787878787879
24433,330490415000346,42,79,74,98,73,26,19,9,392,28,420,6.666666666666667
24434,330490415000347,149,226,268,204,202,130,46,39,1179,85,1264,6.724683544303797
24435,330490415000348,138,162,248,186,171,115,48,43,1020,91,1111,8.190819081908192
24436,330490415000349,66,61,60,89,61,48,26,29,385,55,440,12.5
24437,330490415000350,77,67,99,72,60,31,31,9,406,40,446,8.968609865470851
24438,330490415000351,119,143,207,154,102,114,56,35,839,91,930,9.78494623655914
24439,330490415000352,74,77,100,102,68,54,24,18,475,42,517,8.123791102514506
24440,330490415000353,66,79,97,93,85,83,43,51,503,94,597,15.745393634840871
24441,330490415000354,48,79,76,62,73,65,39,29,403,68,471,14.437367303609342
24442,330490415000355,40,50,53,51,49,45,16,12,288,28,316,8.860759493670885
24443,330490415000356,116,196,159,120,150,92,48,23,833,71,904,7.853982300884955
24444,330490415000357,51,38,46,56,48,34,29,23,273,52,325,16.0
24445,330490415000358,48,55,63,100,66,48,35,26,380,61,441,13.832199546485262
24446,330490415000359,25,24,43,31,23,23,5,12,169,17,186,9.13978494623656
24449,330490415000363,6,12,6,9,18,3,4,1,54,5,59,8.474576271186441
24450,330490415000364,80,76,79,95,71,54,35,18,455,53,508,10.433070866141732
24451,330490415000365,49,73,94,94,53,21,15,2,384,17,401,4.239401496259352
24452,330490415000366,82,76,110,107,99,49,17,16,523,33,556,5.9352517985611515
24453,330490415000367,19,37,25,20,29,17,13,5,147,18,165,10.909090909090908
24454,330490415000368,81,73,74,67,51,51,27,16,397,43,440,9.772727272727273
24455,330490420000001,56,72,85,74,101,65,40,43,453,83,536,15.485074626865671
24456,330490420000002,46,39,33,43,46,45,23,11,252,34,286,11.888111888111888
24457,330490420000003,9,11,16,25,17,9,11,6,87,17,104,16.346153846153847
24458,330490420000004,36,71,72,73,75,76,47,37,403,84,487,17.248459958932237
24459,330490420000005,43,66,102,71,116,88,49,38,486,87,573,15.18324607329843
24460,330490420000006,31,33,52,49,45,46,37,27,256,64,320,20.0
24461,330490420000007,70,76,77,90,80,75,40,27,468,67,535,12.523364485981308
24462,330490420000008,54,95,105,86,102,114,68,62,556,130,686,18.950437317784257
24463,330490420000009,64,65,86,105,77,71,56,41,468,97,565,17.168141592920353
24464,330490420000010,44,56,81,71,64,75,38,40,391,78,469,16.631130063965884
24465,330490420000011,38,67,50,55,63,51,31,31,324,62,386,16.06217616580311
24466,330490420000012,75,100,87,113,88,75,34,33,538,67,605,11.074380165289256
24467,330490420000013,70,85,99,75,76,50,25,24,455,49,504,9.722222222222221
24468,330490420000015,97,146,120,103,125,55,35,23,646,58,704,8.238636363636363
24469,330490420000016,44,56,61,67,94,50,45,43,372,88,460,19.130434782608695
24470,330490420000017,88,103,136,138,112,109,47,39,686,86,772,11.139896373056995
24471,330490420000018,36,55,90,59,66,93,34,45,399,79,478,16.527196652719667
24472,330490420000019,47,58,68,76,84,49,56,50,382,106,488,21.721311475409838
24473,330490420000020,97,111,161,157,93,142,75,63,761,138,899,15.350389321468299
24474,330490420000021,44,60,61,69,79,59,61,32,372,93,465,20.0
24475,330490420000022,66,100,100,92,102,77,52,36,537,88,625,14.08
24476,330490420000023,48,61,77,68,76,78,66,50,408,116,524,22.137404580152673
24477,330490420000024,47,87,165,135,79,58,43,16,571,59,630,9.365079365079366
24478,330490420000025,101,85,75,122,46,57,11,28,486,39,525,7.428571428571429
24479,330490420000026,60,95,79,95,111,63,34,48,503,82,585,14.017094017094017
24480,330490420000027,103,135,110,164,104,90,61,36,706,97,803,12.079701120797012
24481,330490420000028,53,82,89,103,84,70,73,47,481,120,601,19.966722129783694
24482,330490420000029,126,163,171,212,126,115,85,42,913,127,1040,12.211538461538462
24483,330490420000030,47,74,97,84,81,90,70,50,473,120,593,20.236087689713322
24484,330490420000031,59,101,114,115,101,91,82,70,581,152,733,20.73669849931787
24485,330490420000032,65,67,84,87,65,54,68,43,422,111,533,20.825515947467167
24486,330490420000033,57,84,77,80,88,73,39,37,459,76,535,14.205607476635514
24487,330490420000034,15,16,17,17,18,16,13,3,99,16,115,13.91304347826087
24488,330490420000035,11,32,31,16,38,25,22,15,153,37,190,19.473684210526315
24489,330490420000036,165,163,188,201,112,63,40,22,892,62,954,6.49895178197065
24490,330490420000037,34,35,31,24,46,15,8,9,185,17,202,8.415841584158416
24491,330490420000038,96,81,144,136,104,88,74,35,649,109,758,14.379947229551451
24492,330490420000039,83,95,86,117,60,55,47,17,496,64,560,11.428571428571429
24493,330490420000040,48,50,81,81,69,61,60,32,390,92,482,19.08713692946058
24494,330490420000041,125,134,174,138,126,102,93,38,799,131,930,14.086021505376344
24495,330490420000042,51,65,94,88,77,102,66,38,477,104,581,17.900172117039588
24496,330490420000043,15,23,25,35,38,22,19,9,158,28,186,15.053763440860216
24497,330490420000044,56,83,98,118,98,93,53,71,546,124,670,18.507462686567163
24498,330490420000045,126,125,187,148,142,133,89,59,861,148,1009,14.66798810703667
24499,330490420000046,78,85,151,124,98,107,59,44,643,103,746,13.806970509383378
24500,330490420000047,28,33,32,36,34,26,16,11,189,27,216,12.5
24501,330490420000048,60,78,90,118,83,103,77,71,532,148,680,21.764705882352942
24502,330490420000049,73,80,84,75,74,46,45,26,432,71,503,14.115308151093439
24503,330490420000050,126,170,164,151,132,56,37,37,799,74,873,8.47651775486827
24504,330490420000051,45,70,85,84,109,73,57,61,466,118,584,20.205479452054796
24505,330490420000052,64,89,130,93,137,138,65,60,651,125,776,16.108247422680414
24506,330490420000053,31,45,48,46,54,60,43,45,284,88,372,23.655913978494624
24507,330490420000054,70,91,98,109,87,87,75,53,542,128,670,19.104477611940297
24508,330490420000055,91,104,113,125,97,100,84,82,630,166,796,20.85427135678392
24509,330490420000056,87,140,141,129,146,131,68,75,774,143,917,15.59432933478735
24510,330490420000057,52,80,74,89,88,85,57,35,468,92,560,16.428571428571427
24511,330490420000058,68,73,112,103,82,93,56,58,531,114,645,17.674418604651162
24512,330490420000059,66,117,103,140,121,83,48,41,630,89,719,12.378303198887343
24513,330490420000060,50,59,65,84,85,49,53,31,392,84,476,17.647058823529413
24514,330490420000061,67,69,94,76,85,75,51,43,466,94,560,16.785714285714285
24515,330490420000062,104,154,161,122,110,90,55,30,741,85,826,10.290556900726392
24516,330490420000063,69,80,90,99,74,69,40,26,481,66,547,12.06581352833638
24517,330490420000064,87,82,161,132,92,94,43,22,648,65,713,9.1164095371669
24518,330490420000065,128,123,122,194,143,73,37,21,783,58,841,6.896551724137931
24519,330490420000066,62,76,81,61,72,51,33,26,403,59,462,12.770562770562771
24520,330490420000067,91,134,152,120,119,111,55,54,727,109,836,13.038277511961722
24521,330490420000068,25,41,68,60,53,73,43,33,320,76,396,19.19191919191919
24522,330490420000069,120,145,135,188,133,106,67,47,827,114,941,12.114771519659936
24523,330490420000070,42,60,65,73,67,82,49,42,389,91,480,18.958333333333332
24524,330490420000071,81,95,117,84,94,60,44,34,531,78,609,12.807881773399014
24525,330490420000072,39,43,37,45,45,43,33,17,252,50,302,16.556291390728475
24526,330490420000073,13,21,27,25,24,21,21,13,131,34,165,20.606060606060606
24527,330490420000074,47,67,89,86,75,83,48,36,447,84,531,15.819209039548022
24528,330490420000075,72,73,112,72,85,103,71,49,517,120,637,18.838304552590266
24529,330490420000076,68,46,69,76,66,56,25,19,381,44,425,10.352941176470589
24530,330490420000077,38,26,43,37,34,33,16,8,211,24,235,10.212765957446809
24531,330490420000078,50,75,61,99,69,61,52,21,415,73,488,14.959016393442623
24532,330490420000079,67,86,74,93,64,64,29,18,448,47,495,9.494949494949495
24533,330490420000080,47,75,70,82,74,63,40,29,411,69,480,14.375
24534,330490420000081,83,100,114,99,104,99,56,55,599,111,710,15.633802816901408
24535,330490420000082,85,80,105,105,118,86,77,60,579,137,716,19.134078212290504
24536,330490420000083,81,103,104,131,106,79,72,56,604,128,732,17.48633879781421
24537,330490420000084,62,66,83,87,96,46,25,24,440,49,489,10.020449897750511
24538,330490420000085,36,40,59,44,36,35,15,17,250,32,282,11.347517730496454
24539,330490420000086,62,89,105,88,89,87,43,29,520,72,592,12.162162162162161
24540,330490420000087,103,137,128,154,126,127,89,62,775,151,926,16.30669546436285
24541,330490420000088,72,116,99,119,99,90,50,54,595,104,699,14.878397711015737
24542,330490420000089,33,39,42,54,57,40,28,32,265,60,325,18.46153846153846
24543,330490420000090,30,61,64,50,58,65,39,32,328,71,399,17.794486215538846
24544,330490420000091,96,86,143,137,111,89,36,26,662,62,724,8.56353591160221
24545,330490420000092,60,80,115,94,106,75,36,22,530,58,588,9.863945578231293
24546,330490420000093,52,96,116,89,101,135,56,59,589,115,704,16.335227272727273
24547,330490420000094,74,60,123,127,116,81,38,24,581,62,643,9.64230171073095
24548,330490420000095,21,36,64,46,34,51,16,17,252,33,285,11.578947368421053
24549,330490420000096,41,50,76,61,64,65,46,46,357,92,449,20.489977728285076
24550,330490420000097,54,86,92,92,81,69,44,50,474,94,568,16.549295774647888
24551,330490420000098,62,74,81,93,91,73,63,38,474,101,575,17.565217391304348
24552,330490420000099,21,37,44,26,47,35,19,23,210,42,252,16.666666666666668
24553,330490420000100,71,81,97,101,103,70,67,52,523,119,642,18.53582554517134
24554,330490420000101,58,90,69,74,82,59,29,41,432,70,502,13.944223107569721
24555,330490420000102,114,137,147,124,123,95,46,20,740,66,806,8.188585607940446
24556,330490420000103,80,111,108,94,59,63,37,15,515,52,567,9.171075837742505
24557,330490420000104,90,80,153,102,84,116,51,50,625,101,726,13.911845730027549
24558,330490420000105,120,142,149,139,116,95,45,22,761,67,828,8.091787439613526
24559,330490420000106,60,89,98,101,95,82,44,30,525,74,599,12.353923205342237
24560,330490420000107,103,132,103,124,102,98,48,36,662,84,746,11.26005361930295
24561,330490420000108,34,48,52,50,46,44,40,23,274,63,337,18.694362017804153
24562,330490420000109,66,94,85,87,85,93,38,34,510,72,582,12.371134020618557
24563,330490420000110,63,83,100,111,77,90,68,33,524,101,625,16.16
24564,330490420000111,87,65,81,107,71,75,47,37,486,84,570,14.736842105263158
24565,330490420000112,66,65,79,82,69,53,43,31,414,74,488,15.163934426229508
24566,330490420000113,65,82,122,108,112,122,71,66,611,137,748,18.315508021390375
24567,330490420000114,65,59,112,99,96,77,57,55,508,112,620,18.06451612903226
24568,330490420000115,32,44,41,51,70,35,33,41,273,74,347,21.32564841498559
24569,330490420000116,45,60,57,77,79,67,46,52,385,98,483,20.28985507246377
24570,330490420000117,41,49,85,76,81,72,59,44,404,103,507,20.315581854043394
24571,330490420000118,48,67,74,71,67,75,65,47,402,112,514,21.78988326848249
24572,330490420000119,18,32,27,48,31,29,30,14,185,44,229,19.213973799126638
24573,330490420000120,66,84,89,99,89,65,61,53,492,114,606,18.81188118811881
24574,330490420000121,83,82,103,91,86,51,46,28,496,74,570,12.982456140350877
24575,330490420000122,40,59,64,66,67,52,41,26,348,67,415,16.14457831325301
24576,330490420000123,75,83,98,94,80,56,40,19,486,59,545,10.825688073394495
24577,330490420000124,62,85,90,96,93,71,44,44,497,88,585,15.042735042735043
24578,330490420000125,65,102,87,95,89,74,49,29,512,78,590,13.220338983050848
24579,330490420000126,62,70,92,89,94,63,33,29,470,62,532,11.654135338345865
24580,330490420000127,73,83,96,94,78,109,69,50,533,119,652,18.25153374233129
24581,330490420000128,64,96,118,106,88,84,58,45,556,103,659,15.629742033383915
24582,330490420000129,49,83,68,86,75,55,56,49,416,105,521,20.15355086372361
24583,330490420000130,38,64,72,56,76,43,23,23,349,46,395,11.645569620253164
24584,330490420000131,83,79,107,105,91,99,58,44,564,102,666,15.315315315315315
24585,330490420000132,25,43,47,51,53,52,36,28,271,64,335,19.104477611940297
24586,330490420000133,37,41,57,40,54,66,38,33,295,71,366,19.398907103825138
24587,330490420000134,64,118,126,130,145,161,98,79,744,177,921,19.218241042345277
24588,330490420000135,56,77,105,83,72,95,59,44,488,103,591,17.42808798646362
24589,330490420000136,21,19,30,24,24,24,7,18,142,25,167,14.970059880239521
24590,330490420000137,152,190,198,227,183,133,84,83,1083,167,1250,13.36
24591,330490420000138,46,71,71,83,71,55,32,28,397,60,457,13.12910284463895
24592,330490420000139,29,31,44,62,39,33,23,17,238,40,278,14.388489208633093
24593,330490420000140,65,71,95,88,76,77,35,35,472,70,542,12.915129151291513
24594,330490420000141,102,152,98,130,87,60,39,20,629,59,688,8.575581395348838
24595,330490420000142,61,62,108,58,82,71,35,35,442,70,512,13.671875
24596,330490420000143,60,89,100,107,109,82,48,39,547,87,634,13.722397476340694
24597,330490420000144,56,73,93,75,67,64,35,26,428,61,489,12.474437627811861
24598,330490420000145,26,41,41,43,37,29,33,11,217,44,261,16.85823754789272
24599,330490420000146,73,95,100,129,94,71,30,26,562,56,618,9.06148867313916
24600,330490420000147,84,113,104,107,103,77,50,42,588,92,680,13.529411764705882
24601,330490420000148,81,72,94,104,75,74,41,26,500,67,567,11.81657848324515
24602,330490420000149,141,146,155,172,130,90,46,33,834,79,913,8.652792990142387
24603,330490420000150,111,139,136,169,111,80,37,20,746,57,803,7.098381070983811
24604,330490420000151,110,114,108,141,93,66,43,42,632,85,717,11.854951185495118
24605,330490420000152,79,80,82,102,60,54,34,24,457,58,515,11.262135922330097
24606,330490420000153,66,64,73,86,63,51,32,24,403,56,459,12.200435729847495
24607,330490420000154,49,89,76,83,72,37,33,33,406,66,472,13.983050847457626
24608,330490420000155,87,119,114,103,118,94,47,47,635,94,729,12.89437585733882
24609,330490420000156,34,61,61,72,66,44,21,24,338,45,383,11.74934725848564
24610,330490420000157,56,70,100,80,80,95,37,37,481,74,555,13.333333333333334
24611,330490420000158,38,36,36,51,42,47,33,29,250,62,312,19.871794871794872
24612,330490420000159,60,76,71,78,76,70,26,34,431,60,491,12.219959266802444
24613,330490420000160,51,76,78,86,74,89,31,49,454,80,534,14.9812734082397
24614,330490420000161,53,63,94,74,72,56,35,35,412,70,482,14.522821576763485
24615,330490420000162,49,63,91,69,62,71,52,44,405,96,501,19.161676646706585
24616,330490420000163,48,67,57,74,61,44,42,24,351,66,417,15.827338129496402
24617,330490420000164,92,130,144,130,111,92,74,62,699,136,835,16.2874251497006
24618,330490420000165,78,86,124,108,90,78,80,47,564,127,691,18.37916063675832
24619,330490420000166,62,92,89,104,96,65,68,57,508,125,633,19.747235387045812
24620,330490420000167,46,62,75,55,62,73,37,45,373,82,455,18.021978021978022
24621,330490420000168,26,32,69,42,73,53,61,48,295,109,404,26.980198019801982
24622,330490420000169,41,67,56,76,67,61,34,30,368,64,432,14.814814814814815
24623,330490420000170,46,73,56,62,65,48,41,76,350,117,467,25.053533190578158
24624,330490420000171,44,55,56,55,58,39,31,15,307,46,353,13.031161473087819
24625,330490420000172,55,63,89,96,82,81,70,58,466,128,594,21.54882154882155
24626,330490420000173,50,97,116,116,134,101,74,45,614,119,733,16.234652114597544
24627,330490420000174,45,66,64,70,70,71,44,53,386,97,483,20.082815734989648
24628,330490420000175,28,70,69,55,70,66,46,27,358,73,431,16.937354988399072
24629,330490420000176,66,78,83,88,82,70,41,53,467,94,561,16.75579322638146
24630,330490420000177,56,68,94,116,105,78,47,44,517,91,608,14.967105263157896
24631,330490420000178,51,55,80,84,74,65,49,36,409,85,494,17.206477732793523
24632,330490420000179,127,177,149,132,131,82,42,26,798,68,866,7.852193995381063
24633,330490420000180,68,81,154,114,118,85,69,59,620,128,748,17.112299465240643
24634,330490420000181,50,85,125,99,96,97,41,35,552,76,628,12.101910828025478
24635,330490420000182,25,41,81,60,63,78,36,40,348,76,424,17.92452830188679
24636,330490420000183,109,120,173,147,140,135,76,54,824,130,954,13.626834381551364
24637,330490420000184,62,113,106,88,111,63,47,35,543,82,625,13.12
24638,330490420000185,44,67,80,91,70,84,64,52,436,116,552,21.014492753623188
24639,330490420000186,63,73,88,84,72,95,47,46,475,93,568,16.37323943661972
24640,330490420000187,79,119,95,117,94,75,43,31,579,74,653,11.332312404287903
24641,330490420000188,93,144,146,141,126,107,70,54,757,124,881,14.074914869466514
24642,330490420000189,39,42,67,45,50,48,30,35,291,65,356,18.258426966292134
24643,330490420000190,6,12,9,13,7,9,3,5,56,8,64,12.5
24644,330490420000191,102,137,127,94,115,80,59,33,655,92,747,12.315930388219545
24645,330490420000192,94,114,120,141,80,80,58,24,629,82,711,11.533052039381154
24646,330490420000193,52,62,85,69,75,85,48,25,428,73,501,14.570858283433134
24647,330490420000194,44,57,80,66,57,72,44,25,376,69,445,15.50561797752809
24648,330490420000195,59,104,89,92,122,93,54,64,559,118,677,17.42983751846381
24649,330490420000196,109,139,143,184,115,132,111,58,822,169,991,17.05348133198789
24650,330490420000197,58,83,76,96,67,71,40,23,451,63,514,12.256809338521402
24651,330490420000198,49,74,76,80,66,47,41,23,392,64,456,14.035087719298245
24652,330490420000199,35,51,51,57,40,46,19,25,280,44,324,13.580246913580247
24653,330490420000200,40,67,73,81,89,66,78,66,416,144,560,25.714285714285715
24654,330490420000201,30,34,35,44,33,42,21,25,218,46,264,17.424242424242426
24655,330490420000202,64,65,98,87,74,81,44,40,469,84,553,15.189873417721518
24656,330490420000203,36,41,38,56,50,37,44,24,258,68,326,20.858895705521473
24657,330490420000204,61,71,90,73,69,67,61,34,431,95,526,18.06083650190114
24658,330490420000205,25,38,38,54,74,44,45,31,273,76,349,21.77650429799427
24659,330490420000206,71,109,90,93,99,69,67,45,531,112,643,17.418351477449455
24660,330490420000207,69,99,100,99,79,55,25,25,501,50,551,9.074410163339383
24661,330490420000208,48,37,63,84,59,65,23,21,356,44,400,11.0
24662,330490420000209,45,55,73,82,84,52,34,22,391,56,447,12.527964205816556
24663,330490420000210,51,56,88,83,81,53,36,37,412,73,485,15.051546391752577
24664,330490420000211,25,35,35,60,39,37,28,28,231,56,287,19.51219512195122
24665,330490420000212,69,77,111,120,85,90,58,50,552,108,660,16.363636363636363
24666,330490420000213,46,54,74,64,48,58,37,22,344,59,403,14.640198511166252
24667,330490420000214,86,109,105,122,106,74,55,41,602,96,698,13.753581661891117
24668,330490420000215,104,120,201,156,146,113,88,79,840,167,1007,16.583912611717974
24669,330490420000216,58,85,97,92,70,91,61,42,493,103,596,17.28187919463087
24670,330490420000217,41,41,63,45,64,62,25,38,316,63,379,16.622691292875988
24671,330490420000218,38,70,79,88,58,69,25,19,402,44,446,9.865470852017937
24672,330490420000219,80,81,137,107,124,117,34,56,646,90,736,12.228260869565217
24673,330490420000220,76,86,78,76,58,62,35,17,436,52,488,10.655737704918034
24674,330490420000221,87,133,152,147,146,138,80,91,803,171,974,17.5564681724846
24675,330490420000222,81,81,91,88,87,59,39,22,487,61,548,11.13138686131387
24676,330490420000223,92,123,129,144,111,51,44,32,650,76,726,10.46831955922865
24677,330490420000224,95,126,126,130,125,71,67,76,673,143,816,17.524509803921568
24678,330490420000225,38,41,63,43,61,54,35,42,300,77,377,20.424403183023873
24679,330490420000226,85,97,157,125,86,131,73,72,681,145,826,17.5544794188862
24680,330490420000227,73,75,66,88,59,81,36,22,442,58,500,11.6
24681,330490420000228,58,82,87,89,62,48,17,12,426,29,455,6.373626373626373
24682,330490420000229,80,98,127,95,90,57,49,33,547,82,629,13.036565977742448
24683,330490420000230,65,109,106,132,103,69,45,50,584,95,679,13.991163475699558
24684,330490420000231,25,37,48,45,47,45,21,40,247,61,308,19.805194805194805
24685,330490420000232,42,53,51,56,48,61,34,36,311,70,381,18.37270341207349
24686,330490420000233,55,84,105,93,98,95,62,53,530,115,645,17.829457364341085
24687,330490420000234,35,69,74,63,81,72,53,51,394,104,498,20.883534136546185
24688,330490420000235,60,81,132,82,98,84,47,48,537,95,632,15.031645569620252
24689,330490420000236,8,20,4,14,12,7,3,0,65,3,68,4.411764705882353
24690,330490420000237,71,65,88,77,74,57,31,26,432,57,489,11.656441717791411
24691,330490420000238,20,30,23,29,38,14,24,21,154,45,199,22.613065326633166
24692,330490420000239,0,7,15,11,8,8,8,0,49,8,57,14.035087719298245
24694,330490420000241,5,6,6,7,7,2,3,2,33,5,38,13.157894736842104
24695,330490420000242,45,47,62,60,47,42,20,19,303,39,342,11.403508771929825
24696,330490420000243,21,29,34,26,16,9,8,1,135,9,144,6.25
24697,330490420000244,27,60,58,82,60,46,38,25,333,63,396,15.909090909090908
24698,330490420000245,7,12,16,16,9,27,12,5,87,17,104,16.346153846153847
24699,330490420000246,19,26,46,50,22,15,19,13,178,32,210,15.238095238095237
24701,330490420000248,29,29,36,21,25,18,10,9,158,19,177,10.734463276836157
24702,330490420000249,62,93,104,109,84,105,64,41,557,105,662,15.861027190332326
24703,330490420000250,3,2,2,6,3,1,5,2,17,7,24,29.166666666666668
24705,330490420000252,19,19,27,34,33,32,20,19,164,39,203,19.211822660098523
24706,330490420000253,12,17,11,15,16,19,4,7,90,11,101,10.891089108910892
24707,330490420000254,78,84,87,144,95,60,37,37,548,74,622,11.897106109324758
24708,330490420000255,47,60,32,58,35,32,19,5,264,24,288,8.333333333333334
24709,330490420000256,42,45,55,49,41,44,29,15,276,44,320,13.75
24710,330490420000257,43,39,50,38,38,39,24,23,247,47,294,15.986394557823129
24711,330490420000258,2,3,3,4,6,3,6,7,21,13,34,38.23529411764706
24712,330490420000259,15,16,16,21,22,10,12,14,100,26,126,20.634920634920636
24713,330490420000260,58,65,68,70,70,56,34,23,387,57,444,12.837837837837839
24714,330490420000261,15,15,20,16,11,9,3,6,86,9,95,9.473684210526315
24715,330490420000262,19,23,27,30,16,20,5,8,135,13,148,8.783783783783784
24716,330490420000263,21,25,36,30,28,36,18,16,176,34,210,16.19047619047619
24717,330490420000264,27,42,45,48,34,43,23,20,239,43,282,15.24822695035461
24718,330490420000265,8,6,20,2,8,9,3,4,53,7,60,11.666666666666666
24719,330490420000266,23,23,48,27,29,31,31,15,181,46,227,20.26431718061674
24720,330490420000267,12,14,16,19,19,18,8,6,98,14,112,12.5
24721,330490420000268,9,28,36,25,30,25,19,16,153,35,188,18.617021276595743
24722,330490420000269,35,69,39,76,77,27,26,19,323,45,368,12.228260869565217
24723,330490420000270,3,5,7,6,6,7,6,5,34,11,45,24.444444444444443
24724,330490420000271,32,35,36,48,35,44,24,13,230,37,267,13.857677902621722
24725,330490420000273,5,7,4,11,11,11,10,2,49,12,61,19.672131147540984
24726,330490420000274,9,13,16,18,9,12,13,5,77,18,95,18.94736842105263
24727,330490420000275,5,7,13,11,13,6,6,9,55,15,70,21.428571428571427
24728,330490420000276,54,72,63,63,54,38,29,10,344,39,383,10.182767624020888
24729,330490420000277,5,2,13,6,9,9,7,2,44,9,53,16.9811320754717
24730,330490420000278,0,8,7,2,7,4,2,1,28,3,31,9.67741935483871
24731,330490420000280,0,4,3,4,6,6,6,5,23,11,34,32.35294117647059
24733,330490420000282,15,23,22,27,12,24,9,8,123,17,140,12.142857142857142
24734,330490420000283,48,48,52,61,59,63,32,31,331,63,394,15.98984771573604
24735,330490420000284,17,20,27,25,41,20,15,12,150,27,177,15.254237288135593
24736,330490420000285,36,35,44,48,39,29,21,16,231,37,268,13.805970149253731
24737,330490420000286,55,72,45,41,41,25,13,9,279,22,301,7.308970099667774
24738,330490420000287,0,1,2,2,3,1,2,0,9,2,11,18.181818181818183
24739,330490420000288,2,5,7,8,10,4,8,5,36,13,49,26.53061224489796
24740,330490420000289,5,7,14,12,22,11,6,8,71,14,85,16.470588235294116
24741,330490420000290,4,6,12,11,4,12,13,9,49,22,71,30.985915492957748
24742,330490420000291,39,60,67,48,73,58,31,34,345,65,410,15.853658536585366
24743,330490420000292,0,11,12,6,14,13,6,16,56,22,78,28.205128205128204
24744,330490420000293,8,7,3,7,7,8,3,2,40,5,45,11.11111111111111
24745,330490420000294,37,64,77,57,78,75,43,34,388,77,465,16.559139784946236
24747,330490420000296,21,26,28,34,16,22,23,18,147,41,188,21.80851063829787
24749,330490420000299,15,18,23,31,25,25,17,20,137,37,174,21.264367816091955
24750,330490420000300,8,13,15,19,24,10,8,6,89,14,103,13.592233009708737
24751,330490420000301,74,95,111,83,90,63,33,45,516,78,594,13.131313131313131
24752,330490420000302,6,15,4,9,7,9,6,4,50,10,60,16.666666666666668
24753,330490420000303,52,52,59,59,46,42,20,21,310,41,351,11.68091168091168
24754,330490420000304,3,6,3,6,3,1,2,0,22,2,24,8.333333333333334
24755,330490420000305,5,8,12,8,15,9,3,1,57,4,61,6.557377049180328
24756,330490420000306,70,114,92,108,78,52,42,26,514,68,582,11.683848797250858
24757,330490420000307,44,55,48,47,60,36,12,6,290,18,308,5.8441558441558445
24758,330490420000308,117,159,145,139,126,76,50,23,762,73,835,8.74251497005988
24759,330490420000309,79,88,93,86,66,71,34,31,483,65,548,11.861313868613138
24760,330490420000310,9,13,13,15,13,6,7,1,69,8,77,10.38961038961039
24761,330490420000311,137,139,161,151,104,96,49,20,788,69,857,8.051341890315053
24762,330490420000314,11,12,20,16,12,16,3,6,87,9,96,9.375
24763,330490420000316,105,67,130,87,62,58,30,17,509,47,556,8.453237410071942
24764,330490420000317,15,24,19,27,27,25,24,13,137,37,174,21.264367816091955
24765,330490420000318,91,91,113,117,99,85,34,41,596,75,671,11.177347242921014
24766,330490420000319,42,50,54,75,45,52,34,20,318,54,372,14.516129032258064
24768,330490420000322,42,59,79,66,62,68,31,40,376,71,447,15.883668903803132
24769,330490420000323,18,35,31,27,31,30,17,19,172,36,208,17.307692307692307
24772,330490420000327,0,2,0,3,2,0,3,1,7,4,11,36.36363636363637
24773,330490420000328,11,13,16,19,18,11,12,6,88,18,106,16.9811320754717
24774,330490420000329,28,40,44,52,36,46,19,8,246,27,273,9.89010989010989
24775,330490420000330,6,14,18,20,16,21,18,12,95,30,125,24.0
24776,330490420000331,146,179,200,257,186,150,78,49,1118,127,1245,10.200803212851406
24777,330490420000332,83,80,147,161,113,81,52,31,665,83,748,11.096256684491978
24778,330490420000333,8,16,14,19,16,6,11,7,79,18,97,18.556701030927837
24779,330490420000334,9,13,17,12,8,5,5,4,64,9,73,12.32876712328767
24780,330490420000335,10,10,12,14,5,6,2,1,57,3,60,5.0
24781,330490420000336,1,2,1,2,5,2,1,1,13,2,15,13.333333333333334
24782,330490420000337,8,6,12,16,12,19,5,7,73,12,85,14.117647058823529
24783,330490420000338,23,29,36,45,29,41,35,25,203,60,263,22.813688212927758
24784,330490420000339,14,20,25,28,23,17,14,10,127,24,151,15.894039735099337
24785,330490420000340,2,12,9,12,7,8,2,7,50,9,59,15.254237288135593
24786,330490420000341,26,56,47,60,54,42,34,21,285,55,340,16.176470588235293
24787,330490420000342,10,9,15,10,8,6,4,1,58,5,63,7.936507936507937
24788,330490420000343,9,19,13,23,17,12,9,9,93,18,111,16.216216216216218
24789,330490420000344,6,12,19,10,24,12,7,11,83,18,101,17.821782178217823
24790,330490420000345,6,9,12,6,15,6,9,10,54,19,73,26.027397260273972
24791,330490420000346,23,24,32,30,33,31,15,14,173,29,202,14.356435643564357
24792,330490420000347,5,8,6,4,7,3,5,0,33,5,38,13.157894736842104
24794,330490420000349,6,5,14,6,11,11,7,3,53,10,63,15.873015873015873
24795,330490420000350,18,29,26,19,29,8,8,1,129,9,138,6.521739130434782
24796,330490420000351,38,48,59,84,43,53,35,37,325,72,397,18.1360201511335
24797,330490420000352,49,53,87,93,55,88,38,26,425,64,489,13.087934560327199
24798,330490420000353,8,12,12,5,8,7,2,1,52,3,55,5.454545454545454
24799,330490420000354,75,93,82,80,63,59,22,14,452,36,488,7.377049180327869
24800,330490420000355,5,10,10,18,12,16,8,6,71,14,85,16.470588235294116
24802,330490420000357,12,12,20,16,20,12,10,24,92,34,126,26.984126984126984
24803,330490420000358,16,8,16,13,9,12,1,3,74,4,78,5.128205128205129
24804,330490420000359,0,3,11,16,6,2,3,1,38,4,42,9.523809523809524
24805,330490420000360,1,2,2,7,6,7,4,5,25,9,34,26.470588235294116
24807,330490420000363,2,8,24,25,18,15,5,2,92,7,99,7.070707070707071
24808,330490420000364,48,61,60,63,65,62,44,37,359,81,440,18.40909090909091
24809,330490420000365,46,72,62,66,82,54,28,30,382,58,440,13.181818181818182
24810,330490420000366,24,41,29,35,23,16,6,8,168,14,182,7.6923076923076925
24811,330490420000367,9,14,17,18,13,15,21,11,86,32,118,27.11864406779661
24812,330490420000368,7,8,11,9,9,14,10,5,58,15,73,20.54794520547945
24813,330490420000369,14,20,25,26,25,15,7,2,125,9,134,6.7164179104477615
24814,330490420000370,167,205,168,137,136,121,48,19,934,67,1001,6.693306693306694
24815,330490420000371,96,110,102,80,75,40,31,15,503,46,549,8.37887067395264
24816,330490420000372,69,86,167,104,91,64,26,23,581,49,630,7.777777777777778
24817,330490420000373,54,68,46,42,35,27,18,16,272,34,306,11.11111111111111
24818,330490420000374,22,22,29,26,24,18,8,3,141,11,152,7.2368421052631575
24819,330490420000375,23,11,15,14,9,9,7,3,81,10,91,10.989010989010989
24820,330490420000376,79,78,76,85,56,36,17,9,410,26,436,5.963302752293578
24821,330490420000377,58,87,68,69,54,39,18,15,375,33,408,8.088235294117647
24822,330490425000001,176,196,199,186,189,151,61,36,1097,97,1194,8.12395309882747
24823,330490425000002,123,128,146,191,180,105,59,48,873,107,980,10.918367346938776
24824,330490425000003,73,88,104,105,118,89,54,67,577,121,698,17.335243553008596
24825,330490425000004,66,87,86,86,76,54,36,25,455,61,516,11.821705426356589
24826,330490425000005,107,118,169,141,114,90,87,40,739,127,866,14.665127020785219
24827,330490425000006,97,100,124,168,92,44,27,35,625,62,687,9.024745269286754
24828,330490425000007,25,35,45,51,38,15,17,8,209,25,234,10.683760683760683
24829,330490425000008,124,97,100,144,61,78,40,30,604,70,674,10.385756676557863
24830,330490425000009,51,27,29,68,28,10,6,7,213,13,226,5.752212389380531
24831,330490425000010,119,85,99,100,49,60,39,14,512,53,565,9.380530973451327
24832,330490425000011,34,52,54,42,32,38,25,13,252,38,290,13.10344827586207
24833,330490425000012,44,47,54,52,54,41,16,13,292,29,321,9.034267912772586
24834,330490425000013,121,166,122,101,101,76,31,25,687,56,743,7.537012113055182
24835,330490425000014,150,161,176,138,131,89,47,25,845,72,917,7.851690294438386
24836,330490425000015,140,172,135,147,142,85,48,21,821,69,890,7.752808988764045
24837,330490425000016,15,30,10,26,20,14,9,8,115,17,132,12.878787878787879
24838,330490425000017,29,29,30,59,18,25,23,12,190,35,225,15.555555555555555
24839,330490425000018,127,204,160,177,200,132,80,66,1000,146,1146,12.739965095986038
24840,330490425000019,163,158,158,154,88,90,47,12,811,59,870,6.781609195402299
24841,330490425000020,136,180,193,143,158,134,98,77,944,175,1119,15.638963360142984
24842,330490425000021,94,125,124,114,95,85,47,38,637,85,722,11.772853185595569
24843,330490425000022,47,70,61,65,56,58,31,22,357,53,410,12.926829268292684
24844,330490425000023,36,43,61,42,53,45,27,46,280,73,353,20.679886685552407
24845,330490425000024,47,83,95,82,96,99,63,61,502,124,626,19.808306709265175
24846,330490425000025,47,71,107,88,99,95,60,73,507,133,640,20.78125
24847,330490425000026,65,131,76,177,145,103,75,56,697,131,828,15.821256038647343
24848,330490425000027,27,37,57,52,48,48,31,53,269,84,353,23.796033994334277
24849,330490425000028,50,60,56,66,65,41,29,38,338,67,405,16.54320987654321
24850,330490425000029,20,22,25,27,23,33,25,12,150,37,187,19.78609625668449
24851,330490425000030,35,50,68,64,57,57,48,42,331,90,421,21.377672209026127
24852,330490425000031,110,103,125,115,79,88,54,68,620,122,742,16.442048517520217
24853,330490425000032,26,38,43,34,48,48,16,23,237,39,276,14.130434782608695
24854,330490425000033,101,112,141,145,116,131,83,96,746,179,925,19.35135135135135
24855,330490425000034,114,153,128,121,122,108,58,58,746,116,862,13.45707656612529
24856,330490425000035,38,69,61,66,49,28,20,15,311,35,346,10.115606936416185
24857,330490425000036,63,100,125,112,88,90,77,87,578,164,742,22.10242587601078
24858,330490425000037,69,83,108,78,65,76,30,29,479,59,538,10.966542750929367
24859,330490425000038,81,114,130,90,107,118,63,60,640,123,763,16.120576671035387
24860,330490425000039,56,81,108,101,118,100,68,96,564,164,728,22.52747252747253
24861,330490425000040,72,141,105,123,114,84,66,50,639,116,755,15.364238410596027
24862,330490425000041,53,61,60,63,47,46,29,26,330,55,385,14.285714285714286
24863,330490425000042,78,102,143,121,115,85,75,55,644,130,774,16.795865633074936
24864,330490425000043,48,72,82,82,83,79,51,39,446,90,536,16.791044776119403
24865,330490425000044,116,118,112,108,75,76,59,37,605,96,701,13.69472182596291
24866,330490425000045,40,64,91,76,70,87,52,85,428,137,565,24.24778761061947
24867,330490425000046,31,46,65,77,44,51,29,35,314,64,378,16.93121693121693
24868,330490425000047,68,128,122,100,120,102,78,61,640,139,779,17.84338896020539
24869,330490425000048,59,77,74,81,72,48,38,12,411,50,461,10.845986984815617
24870,330490425000049,23,30,26,34,32,27,23,20,172,43,215,20.0
24871,330490425000050,63,77,89,67,94,65,57,36,455,93,548,16.970802919708028
24872,330490425000051,48,68,48,57,53,35,25,17,309,42,351,11.965811965811966
24873,330490425000052,48,49,46,51,55,43,39,19,292,58,350,16.571428571428573
24874,330490425000053,107,116,138,126,128,120,66,62,735,128,863,14.831981460023176
24875,330490425000054,96,122,132,128,110,93,69,28,681,97,778,12.467866323907455
24876,330490425000055,78,88,77,86,75,56,26,21,460,47,507,9.270216962524655
24877,330490425000056,98,129,134,105,127,129,64,85,722,149,871,17.106773823191734
24878,330490425000057,77,92,91,89,86,86,35,30,521,65,586,11.092150170648464
24879,330490425000058,62,89,117,89,99,83,64,53,539,117,656,17.835365853658537
24880,330490425000059,77,65,112,140,81,45,27,15,520,42,562,7.473309608540926
24881,330490425000060,49,60,84,60,66,54,40,38,373,78,451,17.29490022172949
24882,330490425000061,48,80,73,77,69,45,37,32,392,69,461,14.967462039045554
24883,330490425000062,29,35,52,53,35,58,39,32,262,71,333,21.32132132132132
24884,330490425000063,50,81,92,88,83,118,74,69,512,143,655,21.83206106870229
24885,330490425000064,52,93,93,105,95,103,55,60,541,115,656,17.53048780487805
24886,330490425000065,47,51,88,86,57,74,43,39,403,82,485,16.90721649484536
24887,330490425000066,27,25,39,47,35,29,25,17,202,42,244,17.21311475409836
24888,330490425000067,39,63,71,70,61,53,58,47,357,105,462,22.727272727272727
24889,330490425000068,39,52,73,63,70,44,44,16,341,60,401,14.962593516209477
24890,330490425000069,9,14,21,14,15,14,10,5,87,15,102,14.705882352941176
24891,330490425000070,73,99,102,98,94,101,69,46,567,115,682,16.86217008797654
24892,330490425000071,26,48,41,50,29,47,21,7,241,28,269,10.408921933085502
24893,330490425000072,46,50,54,63,64,48,40,20,325,60,385,15.584415584415584
24894,330490425000073,142,178,158,164,132,112,65,45,886,110,996,11.04417670682731
24895,330490425000074,54,72,91,89,81,77,39,28,464,67,531,12.617702448210922
24896,330490425000075,58,80,109,104,95,84,29,12,530,41,571,7.1803852889667255
24897,330490425000076,69,100,99,98,105,95,47,41,566,88,654,13.45565749235474
24898,330490425000077,87,107,109,120,132,111,68,54,666,122,788,15.48223350253807
24899,330490425000078,46,55,67,55,59,57,29,24,339,53,392,13.520408163265307
24900,330490425000079,46,53,94,70,66,63,45,21,392,66,458,14.410480349344978
24901,330490425000080,85,121,118,119,94,97,43,28,634,71,705,10.070921985815604
24902,330490425000081,105,93,123,107,103,75,41,34,606,75,681,11.013215859030836
24903,330490425000082,87,110,104,103,92,103,65,34,599,99,698,14.183381088825215
24904,330490425000083,91,117,123,113,132,94,82,69,670,151,821,18.392204628501826
24905,330490425000084,47,59,82,56,50,70,30,32,364,62,426,14.553990610328638
24906,330490425000085,79,109,89,97,91,77,36,30,542,66,608,10.855263157894736
24907,330490425000086,65,99,133,100,107,122,66,55,626,121,747,16.198125836680052
24908,330490425000087,45,74,67,72,73,80,40,40,411,80,491,16.293279022403258
24909,330490425000088,79,114,95,116,109,80,48,40,593,88,681,12.922173274596181
24910,330490425000089,70,112,99,111,82,86,55,38,560,93,653,14.241960183767228
24911,330490425000090,9,15,15,21,12,19,4,5,91,9,100,9.0
24912,330490425000091,88,84,107,90,99,95,40,39,563,79,642,12.305295950155763
24913,330490425000092,70,76,95,79,78,63,48,29,461,77,538,14.312267657992566
24914,330490425000093,58,54,50,43,39,18,12,5,262,17,279,6.093189964157706
24915,330490425000094,77,96,87,98,82,92,48,30,532,78,610,12.78688524590164
24916,330490425000095,5,8,6,4,2,6,4,2,31,6,37,16.216216216216218
24917,330490425000096,61,66,48,52,62,47,22,16,336,38,374,10.16042780748663
24918,330490425000097,69,108,102,62,100,68,26,43,509,69,578,11.937716262975778
24919,330490425000098,111,176,127,132,111,99,54,31,756,85,841,10.107015457788346
24920,330490425000099,117,195,146,167,161,116,67,55,902,122,1024,11.9140625
24921,330490425000100,49,70,59,59,56,42,23,16,335,39,374,10.427807486631016
24922,330490425000101,95,124,102,101,100,56,47,19,578,66,644,10.248447204968944
24923,330490425000102,71,101,121,99,118,103,55,25,613,80,693,11.544011544011545
24924,330490425000103,64,76,85,71,69,55,47,36,420,83,503,16.50099403578529
24925,330490425000104,83,96,117,108,95,70,61,30,569,91,660,13.787878787878787
24926,330490425000105,94,126,126,113,102,106,70,37,667,107,774,13.824289405684755
24927,330490425000106,22,26,34,22,17,11,10,6,132,16,148,10.81081081081081
24928,330490425000107,96,103,105,86,65,58,23,12,513,35,548,6.386861313868613
24929,330490425000108,89,132,180,173,148,114,64,39,836,103,939,10.969116080937168
24930,330490425000109,122,152,140,191,158,120,65,31,883,96,979,9.805924412665986
24931,330490425000110,71,78,73,61,73,52,34,35,408,69,477,14.465408805031446
24932,330490425000111,94,99,123,110,124,109,79,54,659,133,792,16.792929292929294
24933,330490425000112,132,160,166,155,132,94,69,55,839,124,963,12.876427829698859
24934,330490425000113,45,79,85,72,73,39,22,25,393,47,440,10.681818181818182
24935,330490425000114,115,185,236,291,204,167,115,93,1198,208,1406,14.793741109530583
24936,330490425000115,49,30,113,112,77,67,51,25,448,76,524,14.50381679389313
24937,330490425000116,88,139,123,124,113,95,68,28,682,96,778,12.339331619537274
24938,330490425000117,19,25,23,16,20,13,6,6,116,12,128,9.375
24939,330490425000118,36,39,45,27,33,32,17,5,212,22,234,9.401709401709402
24940,330490425000119,50,72,43,60,42,39,18,9,306,27,333,8.108108108108109
24942,330490425000121,163,204,201,178,146,133,69,34,1025,103,1128,9.131205673758865
24943,330490425000122,3,3,4,1,7,2,4,1,20,5,25,20.0
24944,330490425000123,9,10,11,5,6,5,2,1,46,3,49,6.122448979591836
24945,330490425000124,22,37,33,29,36,24,8,3,181,11,192,5.729166666666667
24946,330490425000125,48,64,73,58,57,29,21,17,329,38,367,10.354223433242506
24947,330490425000126,112,147,215,184,205,170,107,25,1033,132,1165,11.330472103004292
24949,330490425000128,9,11,4,7,4,3,2,1,38,3,41,7.317073170731708
24950,330490425000129,2,5,8,3,5,6,6,5,29,11,40,27.5
24951,330490425000130,136,177,175,172,176,138,101,67,974,168,1142,14.711033274956216
24952,330490425000131,25,25,19,16,17,14,4,0,116,4,120,3.3333333333333335
24953,330490425000132,23,34,30,30,18,31,8,9,166,17,183,9.289617486338798
24954,330490425000133,10,16,8,16,14,7,5,0,71,5,76,6.578947368421052
24955,330490425000134,21,26,32,36,33,42,18,28,190,46,236,19.491525423728813
24956,330490425000135,7,13,11,6,9,7,3,0,53,3,56,5.357142857142857
24958,330490425000137,8,13,21,15,12,16,2,8,85,10,95,10.526315789473685
24959,330490425000138,13,18,22,20,21,15,7,13,109,20,129,15.503875968992247
24961,330490425000140,5,12,7,18,7,13,6,5,62,11,73,15.068493150684931
24962,330490425000141,9,18,7,10,5,2,1,1,51,2,53,3.7735849056603774
24963,330490425000142,9,19,16,30,20,15,17,10,109,27,136,19.852941176470587
24964,330490425000143,14,7,12,16,10,7,5,2,66,7,73,9.58904109589041
24965,330490425000144,46,63,67,76,84,62,42,41,398,83,481,17.255717255717254
24966,330490425000145,20,32,33,28,27,19,7,12,159,19,178,10.674157303370787
24967,330490425000146,17,10,18,19,6,14,6,1,84,7,91,7.6923076923076925
24968,330490425000147,44,66,50,52,58,45,25,15,315,40,355,11.267605633802816
24969,330490425000148,43,60,47,41,47,27,7,6,265,13,278,4.676258992805756
24970,330490425000149,29,26,32,21,30,15,10,14,153,24,177,13.559322033898304
24971,330490425000150,15,16,17,30,13,18,20,12,109,32,141,22.69503546099291
24972,330490425000151,12,5,12,17,10,8,4,6,64,10,74,13.513513513513514
24973,330490425000152,14,25,22,21,30,22,14,31,134,45,179,25.139664804469273
24974,330490425000153,3,7,7,14,14,3,11,6,48,17,65,26.153846153846153
24975,330490425000154,16,13,9,13,12,8,5,6,71,11,82,13.414634146341463
24976,330490425000155,41,60,26,60,36,24,10,12,247,22,269,8.178438661710038
24977,330490425000156,15,22,25,19,30,30,14,11,141,25,166,15.060240963855422
24978,330490425000157,66,85,77,93,69,95,47,31,485,78,563,13.854351687388988
24979,330490425000158,50,55,83,47,57,75,36,15,367,51,418,12.200956937799043
24980,330490425000159,34,71,75,59,72,53,39,18,364,57,421,13.539192399049881
24981,330490425000160,60,74,78,79,86,63,58,29,440,87,527,16.50853889943074
24982,330490425000161,6,14,5,12,7,4,9,2,48,11,59,18.64406779661017
24983,330490425000162,71,95,92,81,104,67,37,44,510,81,591,13.705583756345177
24984,330490425000163,6,9,7,8,6,6,3,2,42,5,47,10.638297872340425
24985,330490425000164,65,74,69,89,51,61,32,12,409,44,453,9.713024282560706
24986,330490425000165,0,1,2,0,2,0,4,0,5,4,9,44.44444444444444
24987,330490425000166,8,10,10,10,8,5,5,3,51,8,59,13.559322033898304
24988,330490425000167,96,130,103,115,124,65,28,29,633,57,690,8.26086956521739
24989,330490425000168,59,95,128,94,102,142,65,33,620,98,718,13.649025069637883
24990,330490425000169,85,130,128,137,121,89,43,20,690,63,753,8.366533864541832
24991,330500005000001,108,129,147,133,143,117,107,81,777,188,965,19.481865284974095
24992,330500005000002,66,84,73,76,99,67,64,41,465,105,570,18.42105263157895
24993,330500005000003,38,56,79,68,62,64,36,59,367,95,462,20.562770562770563
24994,330500005000004,52,71,91,59,86,58,47,36,417,83,500,16.6
24995,330500005000005,42,57,64,56,61,48,39,34,328,73,401,18.204488778054863
24996,330500005000006,89,105,133,87,112,90,61,42,616,103,719,14.325452016689846
24997,330500005000007,53,82,78,61,78,67,43,33,419,76,495,15.353535353535353
24998,330500005000008,74,94,111,87,99,60,33,15,525,48,573,8.37696335078534
24999,330500005000009,96,135,134,123,101,85,53,40,674,93,767,12.1251629726206
25000,330500005000010,93,131,127,94,116,102,66,34,663,100,763,13.106159895150721
25001,330500005000011,133,164,160,113,120,79,36,26,769,62,831,7.460890493381468
25002,330500005000012,58,90,95,70,75,77,45,18,465,63,528,11.931818181818182
25003,330500005000013,134,136,160,124,86,77,48,17,717,65,782,8.312020460358056
25004,330500005000014,3,9,12,9,10,12,6,3,55,9,64,14.0625
25005,330500005000016,74,80,76,86,80,39,29,12,435,41,476,8.61344537815126
25008,330500005000020,8,6,7,10,4,7,4,5,42,9,51,17.647058823529413
25009,330500005000021,97,122,111,126,92,69,50,37,617,87,704,12.357954545454545
25010,330500007000001,81,76,108,90,90,79,37,19,524,56,580,9.655172413793103
25011,330500007000002,86,85,120,84,63,65,43,31,503,74,577,12.824956672443674
25012,330500007000003,49,69,56,70,59,45,33,27,348,60,408,14.705882352941176
25013,330500007000004,39,41,35,39,55,36,21,32,245,53,298,17.78523489932886
25014,330500007000005,13,21,15,21,16,25,9,15,111,24,135,17.77777777777778
25015,330500007000006,18,36,31,36,38,32,29,32,191,61,252,24.206349206349206
25016,330500007000007,50,78,73,61,70,56,43,17,388,60,448,13.392857142857142
25017,330500007000008,58,70,69,64,57,44,21,23,362,44,406,10.83743842364532
25018,330500007000009,80,124,103,103,82,58,38,28,550,66,616,10.714285714285714
25019,330500007000010,86,95,87,96,66,47,17,8,477,25,502,4.9800796812749
25020,330500007000011,63,61,61,43,44,32,21,21,304,42,346,12.138728323699421
25021,330500007000012,89,90,93,102,57,43,22,10,474,32,506,6.324110671936759
25022,330500007000013,20,16,22,14,16,23,8,4,111,12,123,9.75609756097561
25023,330500007000014,7,5,10,8,12,11,3,4,53,7,60,11.666666666666666
25024,330500007000015,235,258,216,189,150,84,48,22,1132,70,1202,5.8236272878535775
25025,330500007000016,26,38,28,35,17,32,9,7,176,16,192,8.333333333333334
25026,330500007000017,11,17,22,20,31,11,6,2,112,8,120,6.666666666666667
25029,330500010000001,87,132,119,107,102,100,58,54,647,112,759,14.756258234519104
25030,330500010000002,131,173,173,139,161,116,59,71,893,130,1023,12.70772238514174
25031,330500010000003,33,57,62,36,61,43,34,29,292,63,355,17.746478873239436
25032,330500010000004,17,21,12,18,22,8,7,9,98,16,114,14.035087719298245
25033,330500010000005,27,30,26,32,20,18,19,12,153,31,184,16.847826086956523
25034,330500010000006,69,81,71,69,78,51,38,42,419,80,499,16.03206412825651
25035,330500010000007,22,28,28,30,26,20,11,10,154,21,175,12.0
25036,330500010000008,12,23,11,10,23,8,13,8,87,21,108,19.444444444444443
25037,330500010000009,54,72,78,60,62,42,35,29,368,64,432,14.814814814814815
25038,330500010000010,25,37,57,25,38,41,18,27,223,45,268,16.791044776119403
25039,330500010000011,51,54,51,53,63,43,34,31,315,65,380,17.105263157894736
25040,330500010000012,1,3,2,1,2,4,0,2,13,2,15,13.333333333333334
25041,330500010000013,1,2,1,2,0,4,2,0,10,2,12,16.666666666666668
25042,330500010000014,12,19,24,22,15,26,15,11,118,26,144,18.055555555555557
25043,330500016000001,5,3,4,6,6,4,3,2,28,5,33,15.151515151515152
25045,330500016000003,10,15,3,10,6,5,4,4,49,8,57,14.035087719298245
25047,330500018000001,4,6,29,23,23,14,8,8,99,16,115,13.91304347826087
25048,330500018000002,4,11,8,11,18,12,7,7,64,14,78,17.94871794871795
25049,330500018000003,4,8,10,10,14,17,15,5,63,20,83,24.096385542168676
25050,330500018000004,29,26,21,27,26,28,17,5,157,22,179,12.29050279329609
25051,330500018000005,12,17,24,21,19,22,11,14,115,25,140,17.857142857142858
25052,330500018000006,8,17,15,17,17,16,9,6,90,15,105,14.285714285714286
25053,330500018000007,13,19,27,17,20,24,13,26,120,39,159,24.528301886792452
25054,330500018000008,4,8,7,3,5,9,11,3,36,14,50,28.0
25055,330500018000009,12,13,10,11,13,3,11,5,62,16,78,20.512820512820515
25056,330500018000010,16,20,16,16,12,11,10,6,91,16,107,14.953271028037383
25057,330500018000011,25,36,23,24,19,13,20,14,140,34,174,19.54022988505747
25058,330500018000012,54,77,86,58,60,34,25,23,369,48,417,11.510791366906474
25059,330500018000013,101,113,134,152,70,58,82,37,628,119,747,15.930388219544845
25060,330500018000014,80,112,84,67,73,36,34,16,452,50,502,9.9601593625498
25061,330500018000015,25,40,24,27,19,22,15,6,157,21,178,11.797752808988765
25062,330500018000016,7,13,13,10,9,19,4,10,71,14,85,16.470588235294116
25063,330500018000017,3,12,18,18,12,11,5,0,74,5,79,6.329113924050633
25064,330500018000018,59,87,62,80,63,47,34,14,398,48,446,10.762331838565023
25065,330500018000019,98,113,118,120,89,73,27,20,611,47,658,7.142857142857143
25066,330500018000020,20,27,28,27,29,30,17,25,161,42,203,20.689655172413794
25067,330500018000021,31,30,30,31,29,14,24,14,165,38,203,18.7192118226601
25068,330500018000022,26,28,21,21,18,17,11,4,131,15,146,10.273972602739725
25069,330500018000023,28,33,38,32,36,31,14,13,198,27,225,12.0
25070,330500018000024,46,61,57,51,50,45,35,13,310,48,358,13.40782122905028
25071,330500018000025,14,23,9,9,15,14,7,2,84,9,93,9.67741935483871
25072,330500018000026,40,50,40,35,31,45,24,9,241,33,274,12.043795620437956
25073,330500018000027,17,27,25,14,22,14,15,7,119,22,141,15.602836879432624
25074,330500018000028,20,23,33,13,19,15,8,10,123,18,141,12.76595744680851
25075,330500030000001,7,19,12,19,15,23,23,19,95,42,137,30.656934306569344
25076,330500030000002,25,33,26,32,23,16,18,23,155,41,196,20.918367346938776
25077,330500030000003,15,22,17,15,18,22,15,9,109,24,133,18.045112781954888
25078,330500030000004,20,19,16,22,17,5,17,13,99,30,129,23.25581395348837
25079,330500030000005,18,33,23,18,34,14,17,12,140,29,169,17.159763313609467
25081,330500030000007,34,48,30,31,33,26,20,14,202,34,236,14.40677966101695
25083,330500030000009,39,39,36,25,28,34,34,12,201,46,247,18.62348178137652
25084,330500030000010,30,26,31,24,22,25,16,13,158,29,187,15.508021390374331
25085,330500030000011,22,16,30,16,13,13,18,11,110,29,139,20.863309352517987
25086,330500030000012,17,28,21,23,18,20,24,15,127,39,166,23.49397590361446
25087,330500030000013,47,54,56,34,43,17,17,12,251,29,280,10.357142857142858
25088,330500030000014,59,68,61,80,62,43,63,46,373,109,482,22.61410788381743
25089,330500030000015,39,57,53,41,47,38,29,25,275,54,329,16.41337386018237
25090,330500030000016,16,11,14,18,21,16,6,8,96,14,110,12.727272727272727
25091,330500030000017,59,79,61,85,74,46,33,14,404,47,451,10.42128603104213
25092,330500030000018,19,29,20,21,28,20,8,15,137,23,160,14.375
25093,330500030000019,33,29,45,27,30,27,11,9,191,20,211,9.47867298578199
25094,330500030000020,107,130,121,93,95,52,48,28,598,76,674,11.275964391691394
25095,330500030000021,73,95,101,69,88,65,41,24,491,65,556,11.690647482014388
25096,330500030000022,63,115,90,68,68,49,30,21,453,51,504,10.119047619047619
25097,330510905000001,54,91,100,106,82,91,72,59,524,131,655,20.0
25098,330510905000002,49,52,73,58,67,72,48,38,371,86,457,18.818380743982495
25099,330510905000003,63,95,90,92,110,87,46,47,537,93,630,14.761904761904763
25100,330510905000004,71,103,127,103,109,105,76,63,618,139,757,18.361955085865258
25101,330510905000005,44,67,77,68,63,66,31,26,385,57,442,12.895927601809955
25102,330510905000006,70,92,97,84,77,90,43,49,510,92,602,15.282392026578073
25103,330510905000007,88,102,131,134,120,109,74,44,684,118,802,14.713216957605985
25104,330510905000008,77,102,119,108,108,94,50,37,608,87,695,12.517985611510792
25105,330510905000009,78,90,102,103,65,79,51,43,517,94,611,15.384615384615385
25106,330510905000010,96,127,125,117,101,100,57,48,666,105,771,13.618677042801556
25107,330510905000011,31,49,54,40,59,62,33,36,295,69,364,18.956043956043956
25108,330510905000012,105,146,126,137,121,86,63,43,721,106,827,12.817412333736396
25109,330510905000013,37,60,76,85,64,69,49,41,391,90,481,18.71101871101871
25110,330510905000014,58,96,83,64,73,73,36,22,447,58,505,11.485148514851485
25111,330510905000015,92,97,140,88,107,82,46,32,606,78,684,11.403508771929825
25112,330510905000016,58,101,102,84,105,89,50,59,539,109,648,16.820987654320987
25113,330510905000017,91,112,136,125,103,110,63,59,677,122,799,15.269086357947435
25114,330510905000018,15,19,31,50,41,30,41,27,186,68,254,26.771653543307085
25115,330510905000019,49,46,51,68,58,43,28,31,315,59,374,15.775401069518717
25116,330510905000020,95,115,135,115,90,111,68,39,661,107,768,13.932291666666666
25117,330510905000021,81,99,89,108,110,108,80,61,595,141,736,19.157608695652176
25118,330510905000022,41,53,58,48,62,60,33,23,322,56,378,14.814814814814815
25119,330510905000023,30,38,47,34,44,38,23,18,231,41,272,15.073529411764707
25120,330510905000024,40,35,31,41,33,35,29,20,215,49,264,18.560606060606062
25121,330510905000025,75,119,105,73,95,88,48,36,555,84,639,13.145539906103286
25122,330510905000026,69,127,116,177,119,84,45,39,692,84,776,10.824742268041238
25123,330510905000027,104,115,122,107,110,112,62,50,670,112,782,14.322250639386189
25124,330510905000028,109,166,144,148,149,108,72,72,824,144,968,14.87603305785124
25125,330510905000029,37,73,93,105,78,102,53,44,488,97,585,16.581196581196583
25126,330510905000030,48,76,78,66,94,83,36,33,445,69,514,13.424124513618677
25127,330510905000031,63,79,88,85,66,78,50,46,459,96,555,17.2972972972973
25128,330510905000032,110,136,175,132,127,126,57,62,806,119,925,12.864864864864865
25129,330510905000033,127,173,151,143,141,124,71,62,859,133,992,13.40725806451613
25130,330510905000034,82,100,103,120,97,94,75,53,596,128,724,17.679558011049725
25131,330510905000035,81,106,82,57,80,55,27,30,461,57,518,11.003861003861005
25132,330510905000036,124,129,151,121,108,102,54,43,735,97,832,11.658653846153847
25133,330510905000037,34,57,50,50,49,45,27,25,285,52,337,15.43026706231454
25134,330510905000038,95,127,111,111,114,113,62,47,671,109,780,13.974358974358974
25135,330510905000039,55,76,92,96,71,82,51,31,472,82,554,14.8014440433213
25136,330510905000040,109,101,108,117,91,96,56,46,622,102,724,14.088397790055248
25137,330510905000041,72,89,97,91,70,64,47,29,483,76,559,13.595706618962433
25138,330510905000042,91,145,129,120,121,100,53,47,706,100,806,12.40694789081886
25139,330510905000043,69,78,90,95,68,60,27,24,460,51,511,9.980430528375734
25140,330510905000044,71,83,91,106,67,62,35,27,480,62,542,11.439114391143912
25141,330510905000045,102,121,137,128,88,81,29,48,657,77,734,10.490463215258856
25142,330510905000046,52,97,75,72,86,49,46,30,431,76,507,14.990138067061144
25143,330510905000047,151,166,165,142,130,101,47,49,855,96,951,10.094637223974763
25144,330510905000048,142,154,135,148,91,85,52,39,755,91,846,10.756501182033096
25145,330510905000049,50,68,82,71,77,87,45,37,435,82,517,15.86073500967118
25146,330510905000050,40,66,66,57,52,53,26,20,334,46,380,12.105263157894736
25147,330510905000051,146,172,137,146,158,96,92,62,855,154,1009,15.262636273538156
25148,330510905000052,22,33,35,24,26,24,13,12,164,25,189,13.227513227513228
25149,330510905000053,74,116,134,109,96,89,45,23,618,68,686,9.912536443148689
25150,330510905000054,100,111,146,127,110,89,57,39,683,96,779,12.32349165596919
25151,330510905000055,79,146,88,116,94,81,56,32,604,88,692,12.716763005780347
25152,330510905000056,97,109,101,96,107,75,44,27,585,71,656,10.823170731707316
25153,330510905000057,100,120,124,90,92,77,40,27,603,67,670,10.0
25154,330510905000058,88,114,98,117,107,85,81,55,609,136,745,18.25503355704698
25155,330510905000059,135,141,112,133,120,103,57,40,744,97,841,11.533888228299643
25156,330510905000060,89,135,117,113,127,109,65,46,690,111,801,13.857677902621722
25157,330510905000061,70,103,92,93,54,50,49,14,462,63,525,12.0
25158,330510905000062,73,72,100,84,77,55,36,21,461,57,518,11.003861003861005
25159,330510905000063,63,109,85,69,78,45,31,22,449,53,502,10.557768924302788
25160,330510905000064,141,151,153,142,130,101,58,45,818,103,921,11.183496199782844
25161,330510905000065,108,125,142,138,119,93,66,58,725,124,849,14.605418138987044
25162,330510905000066,62,91,98,92,83,75,49,35,501,84,585,14.35897435897436
25163,330510905000067,113,150,143,130,152,86,70,54,774,124,898,13.808463251670378
25164,330510905000068,100,127,117,121,95,98,53,53,658,106,764,13.87434554973822
25165,330510905000069,64,78,93,100,91,78,57,41,504,98,602,16.27906976744186
25166,330510905000070,71,105,133,124,98,70,47,43,601,90,691,13.024602026049203
25167,330510905000071,91,115,115,113,87,67,45,30,588,75,663,11.312217194570136
25168,330510905000072,90,111,89,94,93,61,33,23,538,56,594,9.427609427609427
25169,330510905000073,30,28,37,32,33,27,7,9,187,16,203,7.8817733990147785
25170,330510905000074,109,152,135,90,118,61,33,20,665,53,718,7.381615598885793
25171,330510905000075,96,99,129,103,83,54,34,21,564,55,619,8.88529886914378
25172,330510905000076,47,58,63,40,38,31,22,15,277,37,314,11.78343949044586
25173,330510905000077,66,76,70,58,76,51,30,24,397,54,451,11.973392461197339
25174,330510905000078,64,99,90,72,71,72,33,26,468,59,527,11.195445920303605
25175,330510905000079,116,150,143,135,127,105,77,46,776,123,899,13.681868743047831
25176,330510905000080,113,94,125,108,89,96,43,32,625,75,700,10.714285714285714
25177,330510905000081,90,152,138,128,123,93,69,49,724,118,842,14.014251781472684
25178,330510905000082,90,79,100,101,103,71,34,31,544,65,609,10.673234811165846
25179,330510905000083,114,167,143,144,115,101,67,48,784,115,899,12.791991101223582
25180,330510905000084,67,77,80,79,56,63,34,33,422,67,489,13.701431492842536
25181,330510905000085,112,115,130,120,135,91,55,44,703,99,802,12.344139650872817
25182,330510905000086,67,85,86,77,79,74,42,26,468,68,536,12.686567164179104
25183,330510905000087,111,160,139,149,139,107,62,50,805,112,917,12.213740458015268
25184,330510905000088,107,107,128,142,102,82,30,29,668,59,727,8.11554332874828
25185,330510905000089,59,84,81,108,75,79,40,35,486,75,561,13.368983957219251
25186,330510905000090,50,63,52,60,50,49,30,26,324,56,380,14.736842105263158
25187,330510905000091,79,70,74,94,60,64,49,20,441,69,510,13.529411764705882
25188,330510905000092,104,157,134,119,108,59,42,23,681,65,746,8.71313672922252
25189,330510905000093,113,153,140,149,142,92,58,42,789,100,889,11.24859392575928
25190,330510905000094,179,215,180,178,158,117,43,35,1027,78,1105,7.0588235294117645
25191,330510905000095,113,137,158,108,146,89,60,38,751,98,849,11.54299175500589
25192,330510905000096,32,38,59,49,26,47,29,19,251,48,299,16.05351170568562
25193,330510905000097,69,89,89,84,78,68,34,23,477,57,534,10.674157303370787
25194,330510905000098,92,161,109,83,108,59,25,26,612,51,663,7.6923076923076925
25195,330510905000099,105,132,93,115,64,74,45,22,583,67,650,10.307692307692308
25196,330510905000100,139,158,136,140,125,68,36,14,766,50,816,6.127450980392157
25197,330510905000101,70,72,66,63,48,25,10,7,344,17,361,4.7091412742382275
25198,330510905000102,145,180,144,137,98,57,38,19,761,57,818,6.968215158924205
25199,330510905000103,149,167,138,136,111,81,46,34,782,80,862,9.280742459396752
25200,330510905000104,209,260,199,209,188,133,77,45,1198,122,1320,9.242424242424242
25201,330510905000105,105,146,148,113,100,74,47,30,686,77,763,10.091743119266056
25202,330510905000106,76,119,100,86,70,63,49,27,514,76,590,12.88135593220339
25203,330510905000107,57,86,68,71,81,54,32,41,417,73,490,14.89795918367347
25204,330510905000108,93,101,116,99,100,53,40,13,562,53,615,8.617886178861788
25205,330510905000109,115,131,124,122,102,112,64,37,706,101,807,12.515489467162329
25206,330510905000110,271,334,249,194,161,103,59,34,1312,93,1405,6.619217081850533
25207,330510905000111,174,172,138,166,124,92,58,28,866,86,952,9.033613445378151
25208,330510905000112,151,145,147,141,107,104,43,31,795,74,869,8.51553509781358
25209,330510905000113,89,119,108,99,85,71,42,26,571,68,639,10.641627543035995
25210,330510905000114,131,132,113,121,89,59,27,22,645,49,694,7.060518731988473
25211,330510905000115,66,102,88,95,84,71,39,25,506,64,570,11.228070175438596
25212,330510905000116,89,94,99,131,94,96,46,38,603,84,687,12.22707423580786
25213,330510905000117,78,92,91,97,77,62,45,28,497,73,570,12.807017543859649
25214,330510905000118,36,58,40,32,52,37,15,15,255,30,285,10.526315789473685
25215,330510905000119,109,127,136,127,126,90,48,36,715,84,799,10.513141426783479
25216,330510905000120,92,83,101,80,66,49,36,16,471,52,523,9.94263862332696
25217,330510905000122,61,83,83,76,80,66,42,26,449,68,517,13.152804642166345
25218,330510905000123,108,113,132,102,102,67,54,38,624,92,716,12.849162011173185
25219,330510905000124,141,177,161,157,171,115,64,44,922,108,1030,10.485436893203884
25220,330510905000125,47,75,65,65,65,47,30,15,364,45,409,11.00244498777506
25221,330510905000126,120,187,133,125,128,114,56,36,807,92,899,10.233592880978865
25222,330510905000127,59,88,77,58,78,62,25,23,422,48,470,10.212765957446809
25223,330510905000128,82,85,112,82,91,73,40,35,525,75,600,12.5
25224,330510905000129,33,61,39,49,35,32,12,13,249,25,274,9.124087591240876
25225,330510905000130,42,66,63,53,72,56,25,24,352,49,401,12.219451371571072
25226,330510905000131,92,120,133,118,126,90,65,93,679,158,837,18.876941457586618
25227,330510905000132,71,138,91,92,114,65,38,35,571,73,644,11.335403726708075
25228,330510905000133,74,102,96,102,92,88,48,45,554,93,647,14.37403400309119
25229,330510905000134,65,82,91,77,83,72,38,41,470,79,549,14.389799635701275
25230,330510905000135,88,127,100,136,119,84,49,47,654,96,750,12.8
25231,330510905000136,75,94,60,80,64,43,26,21,416,47,463,10.151187904967603
25232,330510905000137,123,146,134,126,108,92,41,35,729,76,805,9.440993788819876
25233,330510905000138,39,54,47,55,35,46,13,9,276,22,298,7.382550335570469
25234,330510905000139,117,137,90,102,79,54,20,14,579,34,613,5.5464926590538335
25235,330510905000140,135,143,109,105,80,55,34,19,627,53,680,7.794117647058823
25236,330510905000141,68,117,96,73,95,54,45,24,503,69,572,12.062937062937063
25237,330510905000142,72,122,78,76,85,58,35,41,491,76,567,13.403880070546737
25238,330510905000143,172,167,185,122,170,114,53,52,930,105,1035,10.144927536231885
25239,330510905000144,42,62,50,56,44,45,32,21,299,53,352,15.056818181818182
25240,330510905000145,106,116,125,93,124,84,38,35,648,73,721,10.124826629681
25241,330510905000146,16,26,24,22,23,20,11,12,131,23,154,14.935064935064934
25242,330510905000147,48,97,59,55,61,56,33,22,376,55,431,12.761020881670534
25243,330510905000148,39,47,41,33,33,26,14,12,219,26,245,10.612244897959183
25244,330510905000149,197,165,142,120,102,66,39,23,792,62,854,7.259953161592506
25245,330510905000150,90,108,96,107,85,58,45,29,544,74,618,11.974110032362459
25246,330510905000151,90,132,103,115,114,88,43,29,642,72,714,10.084033613445378
25247,330510905000152,75,111,121,82,103,67,29,33,559,62,621,9.98389694041868
25248,330510905000153,46,68,53,46,57,29,19,8,299,27,326,8.282208588957054
25249,330510905000154,76,98,83,75,88,59,41,24,479,65,544,11.948529411764707
25250,330510905000155,98,96,91,102,89,69,32,33,545,65,610,10.655737704918034
25251,330510905000156,126,132,157,114,144,108,37,40,781,77,858,8.974358974358974
25252,330510905000157,135,192,145,163,135,71,55,37,841,92,933,9.860664523043944
25253,330510905000158,83,105,85,81,68,47,35,31,469,66,535,12.336448598130842
25254,330510905000159,85,89,128,108,68,79,50,36,557,86,643,13.374805598755833
25255,330510905000160,89,156,162,131,152,109,70,53,799,123,922,13.34056399132321
25256,330510905000161,68,102,81,90,72,54,28,18,467,46,513,8.966861598440547
25257,330510905000162,107,90,118,105,92,67,47,25,579,72,651,11.059907834101383
25258,330510905000163,69,101,63,86,88,50,39,43,457,82,539,15.213358070500927
25259,330510905000164,116,126,213,128,85,92,60,30,760,90,850,10.588235294117647
25260,330510905000165,23,40,32,39,31,27,11,12,192,23,215,10.69767441860465
25261,330510905000166,58,91,80,78,83,61,27,33,451,60,511,11.741682974559687
25262,330510905000167,44,74,61,58,64,46,18,18,347,36,383,9.399477806788513
25263,330510905000168,66,91,103,81,103,77,34,41,521,75,596,12.583892617449665
25264,330510905000169,56,78,53,52,64,51,24,13,354,37,391,9.462915601023019
25265,330510905000170,42,64,53,50,68,57,23,14,334,37,371,9.973045822102426
25266,330510905000171,27,36,16,23,31,14,11,7,147,18,165,10.909090909090908
25267,330510905000172,216,223,196,168,137,106,55,41,1046,96,1142,8.40630472854641
25268,330510905000173,106,132,143,118,113,94,59,41,706,100,806,12.40694789081886
25269,330510905000174,102,106,124,140,129,112,67,80,713,147,860,17.093023255813954
25270,330510905000175,148,166,206,152,137,146,82,62,955,144,1099,13.102820746132847
25271,330510905000176,130,196,176,156,187,102,70,69,947,139,1086,12.79926335174954
25272,330510905000177,78,101,104,95,91,76,52,26,545,78,623,12.520064205457464
25273,330510905000178,129,154,136,139,133,120,66,34,811,100,911,10.97694840834248
25274,330510905000179,141,195,155,173,165,106,77,29,935,106,1041,10.182516810758885
25275,330510905000180,140,168,169,178,162,113,78,45,930,123,1053,11.68091168091168
25276,330510905000181,85,128,126,96,94,71,58,32,600,90,690,13.043478260869565
25277,330510905000182,168,183,197,183,144,108,66,32,983,98,1081,9.06567992599445
25278,330510905000183,129,160,147,153,142,104,60,41,835,101,936,10.790598290598291
25279,330510905000184,155,183,203,192,168,128,79,71,1029,150,1179,12.72264631043257
25280,330510905000185,121,158,152,134,135,109,58,51,809,109,918,11.87363834422658
25281,330510905000186,154,174,202,192,162,130,84,64,1014,148,1162,12.736660929432015
25282,330510905000187,81,75,80,66,74,49,25,23,425,48,473,10.14799154334038
25283,330510905000188,46,54,50,39,42,19,13,13,250,26,276,9.420289855072463
25284,330510905000189,78,71,92,94,66,52,34,15,453,49,502,9.760956175298805
25285,330510905000190,213,236,209,173,174,87,59,38,1092,97,1189,8.15811606391926
25286,330510905000191,140,183,166,150,134,80,39,27,853,66,919,7.181719260065289
25287,330510905000192,93,92,107,118,75,57,28,22,542,50,592,8.445945945945946
25288,330510905000193,119,104,176,115,77,97,57,59,688,116,804,14.427860696517413
25289,330510905000194,50,68,53,66,64,56,20,20,357,40,397,10.075566750629722
25290,330510905000195,184,206,186,168,152,110,61,38,1006,99,1105,8.959276018099548
25291,330510905000196,64,84,79,78,59,72,21,29,436,50,486,10.2880658436214
25292,330510905000197,105,104,111,107,85,75,49,24,587,73,660,11.06060606060606
25293,330510905000198,44,62,75,39,56,56,32,23,332,55,387,14.21188630490956
25294,330510905000199,144,152,158,130,185,91,38,12,860,50,910,5.4945054945054945
25295,330510905000200,76,92,116,92,91,75,37,42,542,79,621,12.721417069243156
25296,330510905000201,121,152,153,133,144,120,92,73,823,165,988,16.700404858299596
25297,330510905000202,43,70,69,57,73,42,24,20,354,44,398,11.055276381909549
25298,330510905000203,101,101,110,130,115,110,48,53,667,101,768,13.151041666666666
25299,330510905000204,76,86,113,93,75,81,46,23,524,69,593,11.63575042158516
25300,330510905000205,88,89,95,100,71,68,44,40,511,84,595,14.117647058823529
25301,330510905000206,70,77,68,70,75,60,24,31,420,55,475,11.578947368421053
25302,330510905000207,77,88,73,60,52,53,21,18,403,39,442,8.823529411764707
25303,330510905000208,156,168,139,135,95,53,26,21,746,47,793,5.926860025220681
25304,330510905000209,96,130,110,133,90,85,60,28,644,88,732,12.021857923497267
25305,330510905000210,91,106,95,80,76,41,37,23,489,60,549,10.92896174863388
25306,330510905000211,90,116,101,79,97,49,33,28,532,61,593,10.286677908937605
25307,330510905000212,70,119,95,85,91,49,37,35,509,72,581,12.392426850258175
25308,330510905000213,115,124,100,109,73,58,21,17,579,38,617,6.158833063209076
25309,330510905000214,185,168,196,178,102,116,48,60,945,108,1053,10.256410256410257
25310,330510905000215,91,125,129,91,82,67,41,24,585,65,650,10.0
25311,330510905000216,113,127,136,113,120,90,47,42,699,89,788,11.294416243654823
25312,330510905000217,51,73,56,68,58,36,20,17,342,37,379,9.762532981530343
25313,330510905000218,85,103,63,77,77,43,22,16,448,38,486,7.818930041152264
25314,330510905000219,60,93,82,75,78,48,22,30,436,52,488,10.655737704918034
25315,330510905000220,106,171,173,185,131,126,58,58,892,116,1008,11.507936507936508
25316,330510905000221,78,101,72,76,83,50,30,33,460,63,523,12.045889101338432
25317,330510905000222,72,101,94,133,111,88,60,44,599,104,703,14.793741109530583
25318,330510905000223,68,84,80,80,91,74,44,35,477,79,556,14.20863309352518
25319,330510905000224,93,111,123,103,94,108,56,42,632,98,730,13.424657534246576
25320,330510905000225,81,88,98,95,65,89,38,27,516,65,581,11.187607573149743
25321,330510905000226,104,112,164,99,126,111,73,43,716,116,832,13.942307692307692
25322,330510905000227,115,121,98,84,81,57,33,21,556,54,610,8.852459016393443
25323,330510905000228,178,223,178,193,139,123,82,46,1034,128,1162,11.015490533562822
25324,330510905000229,74,62,87,62,52,51,16,19,388,35,423,8.274231678486998
25325,330510905000230,77,92,92,82,61,58,22,21,462,43,505,8.514851485148515
25326,330510905000231,78,101,70,93,82,45,24,16,469,40,509,7.858546168958743
25327,330510905000232,120,138,137,130,107,90,61,34,722,95,817,11.627906976744185
25328,330510905000233,121,109,127,134,80,71,54,37,642,91,733,12.414733969986358
25329,330510905000234,46,75,87,64,80,69,30,21,421,51,472,10.805084745762711
25330,330510905000235,57,105,98,92,99,68,31,43,519,74,593,12.478920741989882
25331,330510905000236,51,57,62,62,55,46,32,36,333,68,401,16.957605985037407
25332,330510905000237,93,94,93,89,99,75,50,37,543,87,630,13.80952380952381
25333,330510905000238,87,115,120,109,100,119,54,38,650,92,742,12.398921832884097
25334,330510905000239,109,125,140,113,114,92,50,42,693,92,785,11.719745222929935
25335,330510905000240,67,95,78,87,79,66,36,29,472,65,537,12.104283054003725
25336,330510905000241,93,117,97,105,113,88,32,53,613,85,698,12.177650429799426
25337,330510905000242,100,124,118,138,116,91,49,31,687,80,767,10.430247718383312
25338,330510905000243,93,89,78,63,54,52,28,11,429,39,468,8.333333333333334
25339,330510905000244,85,115,63,79,62,36,24,13,440,37,477,7.756813417190775
25340,330510905000245,87,127,86,98,78,70,40,30,546,70,616,11.363636363636363
25341,330510905000246,106,154,113,117,136,70,35,32,696,67,763,8.781127129750983
25342,330510905000247,146,199,165,151,171,113,50,42,945,92,1037,8.871745419479268
25343,330510905000248,132,145,121,125,95,55,58,30,673,88,761,11.563731931668856
25344,330510905000249,49,60,61,60,67,33,20,14,330,34,364,9.340659340659341
25345,330510905000250,74,131,114,116,86,78,39,36,599,75,674,11.127596439169139
25346,330510905000251,100,128,102,111,85,69,18,14,595,32,627,5.103668261562999
25347,330510905000252,165,182,175,176,117,71,57,31,886,88,974,9.034907597535934
25348,330510905000253,129,158,142,127,108,92,55,33,756,88,844,10.42654028436019
25349,330510905000254,128,136,167,146,153,115,78,57,845,135,980,13.775510204081632
25350,330510905000255,85,100,91,105,91,102,50,49,574,99,673,14.710252600297176
25351,330510905000256,94,99,89,91,85,49,42,29,507,71,578,12.283737024221454
25352,330510905000257,84,185,152,180,174,105,32,25,880,57,937,6.08324439701174
25353,330510905000258,87,133,115,122,103,89,55,41,649,96,745,12.885906040268456
25354,330510905000259,69,101,87,77,79,76,34,50,489,84,573,14.659685863874346
25355,330510905000260,80,96,98,97,94,43,51,33,508,84,592,14.18918918918919
25356,330510905000261,116,134,129,115,135,72,38,35,701,73,774,9.431524547803617
25357,330510905000262,95,124,122,107,113,62,28,35,623,63,686,9.183673469387756
25358,330510905000263,92,116,94,103,100,62,47,33,567,80,647,12.364760432766616
25359,330510905000264,138,201,146,157,163,105,57,52,910,109,1019,10.69676153091266
25360,330510905000265,69,103,78,63,51,52,44,23,416,67,483,13.871635610766045
25361,330510905000266,70,84,82,82,58,62,24,29,438,53,491,10.79429735234216
25362,330510905000267,81,105,122,102,93,106,54,40,609,94,703,13.37126600284495
25363,330510905000268,159,158,127,123,87,58,36,17,712,53,765,6.928104575163399
25364,330510905000269,128,172,146,119,134,83,59,37,782,96,878,10.933940774487471
25365,330510905000270,105,152,156,133,135,100,52,42,781,94,875,10.742857142857142
25366,330510905000271,153,166,173,147,128,107,49,46,874,95,969,9.803921568627452
25367,330510905000272,118,168,156,145,139,109,58,59,835,117,952,12.289915966386555
25368,330510905000273,151,180,149,146,123,91,67,40,840,107,947,11.29883843717001
25369,330510905000274,104,126,118,104,83,86,48,29,621,77,698,11.031518624641834
25370,330510905000275,144,178,177,134,129,121,67,56,883,123,1006,12.226640159045726
25371,330510905000276,59,88,63,81,75,38,34,22,404,56,460,12.173913043478262
25372,330510905000277,56,86,79,61,86,74,36,25,442,61,503,12.127236580516898
25373,330510905000278,91,148,110,107,110,56,40,32,622,72,694,10.37463976945245
25374,330510905000279,95,139,88,85,100,49,24,20,556,44,600,7.333333333333333
25375,330510905000280,111,125,116,94,61,87,29,18,594,47,641,7.332293291731669
25376,330510905000281,154,150,147,99,81,63,30,18,694,48,742,6.46900269541779
25377,330510905000282,63,68,73,55,76,52,19,31,387,50,437,11.441647597254004
25378,330510905000283,110,109,93,107,83,58,30,21,560,51,611,8.346972176759412
25379,330510905000284,87,119,115,113,97,79,40,39,610,79,689,11.46589259796807
25380,330510905000285,112,120,130,155,106,109,53,30,732,83,815,10.184049079754601
25381,330510905000286,57,61,93,62,60,54,37,24,387,61,448,13.616071428571429
25382,330510905000287,115,168,135,103,105,86,46,38,712,84,796,10.552763819095478
25383,330510905000288,78,84,83,72,58,56,29,22,431,51,482,10.58091286307054
25384,330510905000289,150,181,177,108,135,104,45,39,855,84,939,8.945686900958467
25385,330510905000290,121,129,101,106,103,54,20,20,614,40,654,6.116207951070336
25386,330510905000291,84,110,84,86,102,64,33,38,530,71,601,11.813643926788686
25387,330510905000292,133,167,148,126,96,54,37,19,724,56,780,7.17948717948718
25388,330510905000293,73,98,70,86,70,54,35,17,451,52,503,10.337972166998012
25389,330510905000294,55,73,70,64,76,73,31,28,411,59,470,12.553191489361701
25390,330510905000295,59,77,51,64,56,22,12,18,329,30,359,8.356545961002785
25391,330510905000296,114,152,145,142,113,95,61,39,761,100,861,11.614401858304298
25392,330510905000297,102,142,111,111,89,77,44,20,632,64,696,9.195402298850574
25393,330510905000298,89,97,91,80,87,71,42,23,515,65,580,11.206896551724139
25394,330510905000299,74,108,77,53,63,47,16,21,422,37,459,8.061002178649238
25395,330510905000300,70,84,78,71,75,68,37,33,446,70,516,13.565891472868216
25396,330510905000301,56,95,72,73,59,45,27,16,400,43,443,9.706546275395034
25397,330510905000302,261,298,238,209,157,117,55,23,1280,78,1358,5.743740795287187
25398,330510905000303,127,113,120,100,57,70,12,20,587,32,619,5.169628432956381
25399,330510905000304,23,36,30,30,22,18,11,9,159,20,179,11.1731843575419
25400,330510905000305,109,127,139,90,118,70,34,32,653,66,719,9.179415855354659
25401,330510905000306,30,47,50,26,46,18,17,16,217,33,250,13.2
25402,330510905000307,121,141,129,107,112,72,28,24,682,52,734,7.084468664850136
25403,330510905000308,60,70,80,55,52,51,26,18,368,44,412,10.679611650485437
25404,330510905000309,66,64,63,51,37,27,14,9,308,23,331,6.948640483383686
25405,330510905000310,46,53,38,29,28,18,12,3,212,15,227,6.607929515418502
25406,330510905000311,128,169,163,142,121,108,42,44,831,86,917,9.378407851690294
25407,330510905000312,38,42,42,64,52,20,7,7,258,14,272,5.147058823529412
25408,330510905000313,58,63,74,48,38,39,33,15,320,48,368,13.043478260869565
25409,330510905000314,51,81,71,51,79,48,33,36,381,69,450,15.333333333333334
25410,330510905000315,63,104,95,80,97,60,43,36,499,79,578,13.667820069204152
25411,330510905000316,166,175,246,119,102,66,45,14,874,59,933,6.323687031082529
25412,330510905000317,82,85,100,69,76,67,36,34,479,70,549,12.750455373406194
25413,330510905000318,49,66,46,65,47,35,21,16,308,37,345,10.72463768115942
25414,330510905000319,26,45,61,33,60,38,29,17,263,46,309,14.88673139158576
25415,330510905000320,24,38,30,39,35,46,27,22,212,49,261,18.773946360153257
25416,330510905000321,63,70,80,78,53,45,35,28,389,63,452,13.938053097345133
25417,330510905000322,115,141,110,116,99,45,34,24,626,58,684,8.47953216374269
25418,330510905000323,66,102,75,92,75,44,25,27,454,52,506,10.276679841897232
25419,330510905000324,102,119,118,123,94,77,37,27,633,64,697,9.182209469153515
25420,330510905000325,87,89,89,98,76,55,40,26,494,66,560,11.785714285714286
25421,330510905000326,124,156,109,125,123,74,61,33,711,94,805,11.677018633540373
25422,330510905000327,69,95,86,94,77,38,41,21,459,62,521,11.900191938579654
25423,330510905000328,116,130,136,108,115,52,30,22,657,52,709,7.3342736248236955
25424,330510905000329,114,137,139,123,99,76,45,31,688,76,764,9.947643979057592
25425,330510905000330,138,104,85,93,73,94,27,28,587,55,642,8.566978193146417
25426,330510905000331,87,102,89,81,77,71,38,38,507,76,583,13.036020583190394
25427,330510905000332,33,29,28,29,16,20,6,8,155,14,169,8.284023668639053
25428,330510905000333,101,107,100,114,104,77,51,26,603,77,680,11.323529411764707
25429,330510905000334,53,65,51,52,65,45,22,14,331,36,367,9.809264305177111
25430,330510905000335,90,112,100,91,113,59,54,24,565,78,643,12.130637636080872
25431,330510905000336,36,55,42,39,45,35,29,17,252,46,298,15.436241610738255
25432,330510905000337,71,95,77,60,61,48,31,19,412,50,462,10.822510822510823
25433,330510905000338,71,75,71,88,47,43,31,13,395,44,439,10.022779043280183
25434,330510905000339,91,117,101,98,87,53,32,37,547,69,616,11.2012987012987
25435,330510905000340,73,95,68,82,60,44,26,21,422,47,469,10.021321961620469
25436,330510905000341,61,98,82,78,81,44,33,34,444,67,511,13.111545988258317
25437,330510905000342,112,121,102,92,84,60,39,21,571,60,631,9.508716323296355
25438,330510905000343,71,91,87,86,63,70,34,30,468,64,532,12.030075187969924
25439,330510905000344,65,84,75,84,58,47,34,14,413,48,461,10.412147505422993
25440,330510905000345,71,93,65,59,47,31,17,18,366,35,401,8.728179551122194
25441,330510905000346,173,176,143,142,126,75,48,23,835,71,906,7.836644591611479
25442,330510905000347,86,83,92,82,73,62,28,17,478,45,523,8.604206500956023
25443,330510905000348,38,61,44,45,41,32,19,13,261,32,293,10.921501706484642
25444,330510905000349,58,78,77,77,72,65,32,24,427,56,483,11.594202898550725
25445,330510905000350,24,31,62,44,38,28,28,15,227,43,270,15.925925925925926
25446,330510905000351,21,40,47,31,30,33,19,13,202,32,234,13.675213675213675
25447,330510905000353,30,48,37,38,41,35,16,22,229,38,267,14.232209737827715
25448,330510905000354,39,41,28,47,33,31,24,8,219,32,251,12.749003984063744
25449,330510905000355,68,75,60,66,56,45,26,20,370,46,416,11.057692307692308
25450,330510905000356,23,40,22,24,29,12,11,11,150,22,172,12.790697674418604
25451,330510905000357,35,52,50,45,49,44,20,10,275,30,305,9.836065573770492
25452,330510905000358,131,120,101,80,81,37,31,15,550,46,596,7.718120805369128
25453,330510905000359,80,72,68,71,48,41,12,20,380,32,412,7.766990291262136
25454,330510905000360,26,31,22,23,19,11,10,7,132,17,149,11.409395973154362
25455,330510905000361,76,64,66,75,53,45,31,17,379,48,427,11.241217798594848
25456,330510905000362,59,69,52,77,35,30,10,5,322,15,337,4.451038575667655
25457,330510905000363,80,83,76,60,75,38,33,22,412,55,467,11.777301927194861
25458,330510905000364,122,110,90,77,45,34,26,4,478,30,508,5.905511811023622
25459,330510905000365,20,21,41,25,31,28,20,15,166,35,201,17.412935323383085
25460,330510905000366,105,89,95,108,85,70,48,25,552,73,625,11.68
25461,330510905000367,41,29,26,31,24,22,7,5,173,12,185,6.486486486486487
25462,330510905000368,124,132,103,106,73,67,33,33,605,66,671,9.836065573770492
25463,330510905000369,86,82,97,76,67,57,34,21,465,55,520,10.576923076923077
25464,330510905000370,61,83,70,80,50,42,16,18,386,34,420,8.095238095238095
25465,330510905000371,77,121,104,92,71,58,32,18,523,50,573,8.726003490401396
25466,330510905000372,51,65,76,51,45,45,28,24,333,52,385,13.506493506493506
25467,330510905000373,71,84,86,57,51,31,9,14,380,23,403,5.707196029776675
25468,330510910000001,89,172,161,158,137,133,90,75,850,165,1015,16.25615763546798
25469,330510910000002,66,92,81,101,103,65,35,30,508,65,573,11.343804537521814
25470,330510910000003,87,128,115,82,115,54,44,22,581,66,647,10.200927357032457
25471,330510910000004,30,44,57,66,66,47,26,13,310,39,349,11.174785100286533
25472,330510910000005,82,94,116,112,115,78,32,24,597,56,653,8.575803981623277
25473,330510910000006,59,83,90,69,55,82,30,34,438,64,502,12.749003984063744
25474,330510910000007,86,103,96,117,93,87,42,36,582,78,660,11.818181818181818
25475,330510910000008,86,104,109,119,65,85,59,40,568,99,667,14.842578710644677
25476,330510910000009,119,131,129,108,93,65,52,34,645,86,731,11.764705882352942
25477,330510910000010,86,125,128,110,93,92,62,38,634,100,734,13.623978201634877
25478,330510910000011,125,127,148,147,122,118,61,42,787,103,890,11.573033707865168
25479,330510910000012,131,129,143,144,110,130,72,38,787,110,897,12.263099219620958
25480,330510910000013,73,84,80,92,87,82,44,31,498,75,573,13.089005235602095
25481,330510910000014,99,103,110,93,98,60,39,19,563,58,621,9.339774557165862
25482,330510910000015,127,162,130,141,158,124,52,43,842,95,937,10.138740661686233
25483,330510910000016,59,59,79,61,59,45,23,16,362,39,401,9.72568578553616
25484,330510910000017,63,93,94,92,97,76,48,49,515,97,612,15.84967320261438
25485,330510910000018,50,77,103,77,68,74,25,25,449,50,499,10.02004008016032
25486,330510910000019,48,91,81,97,62,50,41,27,429,68,497,13.682092555331993
25487,330510910000020,66,70,96,81,84,50,34,26,447,60,507,11.834319526627219
25488,330510910000021,102,98,125,101,103,78,50,43,607,93,700,13.285714285714286
25489,330510910000022,103,150,133,106,120,54,49,31,666,80,746,10.723860589812332
25490,330510910000023,97,147,166,135,121,115,47,40,781,87,868,10.023041474654377
25491,330510910000024,88,118,103,97,85,69,24,43,560,67,627,10.685805422647528
25492,330510910000025,68,101,99,91,86,65,32,30,510,62,572,10.839160839160838
25493,330510910000026,92,116,129,121,81,114,51,33,653,84,737,11.397557666214382
25494,330510910000027,84,125,127,108,84,88,43,39,616,82,698,11.74785100286533
25495,330510910000028,70,74,79,88,96,83,35,32,490,67,557,12.028725314183124
25496,330510910000029,117,178,129,132,117,91,38,38,764,76,840,9.047619047619047
25497,330510910000030,86,90,90,114,79,59,42,25,518,67,585,11.452991452991453
25498,330510910000031,112,114,137,137,109,101,48,45,710,93,803,11.581569115815691
25499,330510910000032,148,138,123,123,128,71,38,41,731,79,810,9.753086419753087
25500,330510910000033,135,135,134,137,109,90,49,35,740,84,824,10.194174757281553
25501,330510910000034,131,140,140,115,118,89,43,33,733,76,809,9.394313967861557
25502,330510910000035,142,155,180,170,119,93,71,44,859,115,974,11.806981519507186
25503,330510910000036,171,214,194,178,139,111,62,33,1007,95,1102,8.620689655172415
25504,330510910000037,192,208,181,158,128,108,57,34,975,91,1066,8.536585365853659
25505,330510910000038,60,79,77,90,74,56,52,27,436,79,515,15.339805825242719
25506,330510910000039,28,62,38,42,37,29,16,14,236,30,266,11.278195488721805
25507,330510910000040,89,92,133,115,85,108,49,19,622,68,690,9.855072463768115
25508,330510910000041,70,109,119,76,95,89,31,42,558,73,631,11.568938193343898
25509,330510910000042,86,110,110,103,99,91,37,38,599,75,674,11.127596439169139
25510,330510910000043,129,177,177,121,145,107,45,39,856,84,940,8.936170212765957
25511,330510910000044,106,116,108,112,109,88,43,32,639,75,714,10.504201680672269
25512,330510910000045,135,152,168,137,129,105,60,35,826,95,921,10.31487513572204
25513,330510910000046,92,110,109,107,116,61,37,38,595,75,670,11.194029850746269
25514,330510910000047,69,95,79,63,81,59,35,30,446,65,511,12.720156555772995
25515,330510910000048,67,81,77,73,63,38,29,30,399,59,458,12.882096069868995
25516,330510910000049,60,78,79,86,62,52,34,28,417,62,479,12.943632567849686
25517,330510910000050,122,108,153,119,99,125,60,29,726,89,815,10.920245398773005
25518,330510910000051,90,124,115,86,91,74,24,40,580,64,644,9.937888198757763
25519,330510910000052,122,183,153,114,141,71,44,18,784,62,846,7.328605200945627
25520,330510910000053,170,198,215,133,119,82,38,24,917,62,979,6.332992849846782
25521,330510910000054,101,101,117,128,72,72,40,28,591,68,659,10.318664643399089
25522,330510910000055,130,174,161,170,117,67,67,35,819,102,921,11.074918566775244
25523,330510910000056,112,111,122,111,67,62,44,30,585,74,659,11.229135053110774
25524,330510910000057,44,56,66,44,58,62,27,21,330,48,378,12.698412698412698
25525,330510910000058,130,148,145,129,108,100,47,37,760,84,844,9.95260663507109
25526,330510910000059,90,86,106,79,77,63,18,21,501,39,540,7.222222222222222
25527,330510910000060,64,76,85,69,60,55,33,21,409,54,463,11.663066954643629
25528,330510910000061,130,171,140,141,130,83,65,40,795,105,900,11.666666666666666
25529,330510910000062,114,116,129,115,100,75,43,40,649,83,732,11.33879781420765
25530,330510910000063,67,107,79,110,104,83,49,35,550,84,634,13.249211356466876
25531,330510910000064,70,99,77,80,108,87,47,27,521,74,595,12.436974789915967
25532,330510910000065,77,64,100,102,122,79,44,31,544,75,619,12.116316639741518
25533,330510910000066,107,137,118,110,118,92,53,34,682,87,769,11.31339401820546
25534,330510910000067,105,133,134,125,94,105,54,41,696,95,791,12.010113780025284
25535,330510910000068,84,119,95,100,84,59,46,24,541,70,611,11.456628477905074
25536,330510910000069,126,173,143,145,127,101,61,43,815,104,919,11.31664853101197
25537,330510910000070,77,142,122,135,109,108,46,41,693,87,780,11.153846153846153
25538,330510910000071,76,111,97,97,105,78,47,56,564,103,667,15.442278860569715
25539,330510910000072,100,87,91,102,78,80,40,27,538,67,605,11.074380165289256
25540,330510910000073,103,119,100,104,83,83,40,34,592,74,666,11.11111111111111
25541,330510910000074,68,68,81,77,52,46,33,25,392,58,450,12.88888888888889
25542,330510910000075,67,100,88,91,70,61,35,20,477,55,532,10.338345864661655
25543,330510910000076,89,97,119,119,85,88,52,39,597,91,688,13.226744186046512
25544,330510910000077,99,149,136,168,119,85,75,48,756,123,879,13.993174061433447
25545,330510910000078,108,133,127,123,92,80,50,30,663,80,743,10.767160161507402
25546,330510910000079,69,120,82,130,62,66,43,24,529,67,596,11.241610738255034
25547,330510910000080,74,116,108,109,116,82,51,36,605,87,692,12.572254335260116
25548,330510910000081,79,118,115,101,92,61,51,39,566,90,656,13.71951219512195
25549,330510910000082,78,116,109,134,115,75,59,37,627,96,723,13.278008298755188
25550,330510910000083,59,83,85,120,61,71,46,15,479,61,540,11.296296296296296
25551,330510910000084,43,63,68,99,82,85,60,42,440,102,542,18.819188191881917
25552,330510910000085,85,99,89,124,97,62,64,45,556,109,665,16.39097744360902
25553,330510910000086,49,55,62,62,73,44,44,23,345,67,412,16.262135922330096
25554,330510910000087,84,120,115,93,91,79,30,21,582,51,633,8.056872037914692
25555,330510910000088,88,122,117,90,108,85,52,38,610,90,700,12.857142857142858
25556,330510910000089,65,87,74,82,74,54,22,34,436,56,492,11.382113821138212
25557,330510910000090,72,83,109,74,78,93,45,34,509,79,588,13.435374149659864
25558,330510910000091,51,53,66,67,76,36,33,40,349,73,422,17.298578199052134
25559,330510910000092,93,106,116,120,74,99,57,50,608,107,715,14.965034965034965
25560,330510910000093,83,73,70,59,65,51,36,25,401,61,462,13.203463203463203
25561,330510910000094,76,69,94,87,67,97,43,53,490,96,586,16.38225255972696
25562,330510910000095,96,137,122,116,124,85,58,46,680,104,784,13.26530612244898
25563,330510910000096,75,86,97,69,88,60,32,33,475,65,540,12.037037037037036
25564,330510910000097,135,177,182,144,146,108,60,39,892,99,991,9.989909182643794
25565,330510910000098,114,149,127,112,138,90,67,42,730,109,839,12.991656734207389
25566,330510910000099,103,163,135,107,109,76,52,25,693,77,770,10.0
25567,330510910000100,121,127,160,118,109,86,66,35,721,101,822,12.287104622871047
25568,330510910000101,134,148,150,137,116,111,62,41,796,103,899,11.457174638487208
25569,330510910000102,147,185,192,156,142,145,76,46,967,122,1089,11.202938475665748
25570,330510910000103,140,183,155,158,136,103,52,33,875,85,960,8.854166666666666
25571,330510910000104,100,126,105,114,112,78,48,31,635,79,714,11.064425770308123
25572,330510910000105,61,86,40,86,70,59,36,19,402,55,457,12.035010940919037
25573,330510910000106,145,161,149,153,101,86,49,43,795,92,887,10.372040586245772
25574,330510910000107,124,130,110,124,99,74,70,40,661,110,771,14.267185473411155
25575,330510910000108,105,138,101,94,87,82,35,22,607,57,664,8.58433734939759
25576,330510910000109,89,111,102,87,97,49,20,19,535,39,574,6.794425087108014
25577,330510910000110,129,184,110,157,110,113,53,42,803,95,898,10.579064587973274
25578,330510910000111,98,101,131,108,79,97,42,41,614,83,697,11.908177905308465
25579,330510910000112,138,169,146,150,104,94,43,29,801,72,873,8.24742268041237
25580,330510910000113,119,174,179,150,155,114,72,45,891,117,1008,11.607142857142858
25581,330510910000114,92,112,87,96,90,84,36,31,561,67,628,10.668789808917197
25582,330510910000115,86,138,117,142,114,89,66,50,686,116,802,14.463840399002494
25583,330510910000116,54,83,82,72,84,76,42,40,451,82,533,15.384615384615385
25584,330510910000117,129,156,180,148,148,117,71,47,878,118,996,11.847389558232932
25585,330510910000118,134,156,181,146,140,132,65,58,889,123,1012,12.154150197628459
25586,330510910000119,106,130,121,120,107,97,51,37,681,88,769,11.443433029908972
25587,330510910000120,88,123,108,120,96,102,50,42,637,92,729,12.62002743484225
25588,330510910000121,94,135,102,131,101,81,60,43,644,103,747,13.788487282463185
25589,330510910000122,110,134,123,100,89,70,48,36,626,84,710,11.830985915492958
25590,330510910000123,87,126,97,102,101,76,47,31,589,78,667,11.694152923538232
25591,330510910000124,66,86,84,82,71,56,29,18,445,47,492,9.552845528455284
25592,330510910000125,100,87,100,71,52,59,32,36,469,68,537,12.66294227188082
25593,330510910000126,143,174,135,134,119,88,52,36,793,88,881,9.988649262202044
25594,330510910000127,138,151,120,134,86,54,51,19,683,70,753,9.296148738379815
25595,330510910000128,108,112,103,100,86,72,33,28,581,61,642,9.501557632398754
25596,330510910000129,147,200,141,151,123,98,49,30,860,79,939,8.413205537806176
25597,330510910000130,57,78,64,105,76,62,65,41,442,106,548,19.343065693430656
25598,330510910000131,90,97,92,92,100,54,32,31,525,63,588,10.714285714285714
25599,330510910000132,81,56,84,77,57,41,38,24,396,62,458,13.537117903930131
25600,330510910000133,146,200,194,197,138,136,63,38,1011,101,1112,9.082733812949641
25601,330510910000134,71,82,87,76,72,77,31,24,465,55,520,10.576923076923077
25602,330510910000135,109,126,126,122,102,101,62,33,686,95,781,12.163892445582587
25603,330510910000136,50,85,105,75,100,72,46,37,487,83,570,14.56140350877193
25604,330510910000137,106,112,125,107,112,101,58,42,663,100,763,13.106159895150721
25605,330510910000138,78,104,107,94,100,84,40,44,567,84,651,12.903225806451612
25606,330510910000139,81,100,140,101,86,77,32,24,585,56,641,8.736349453978159
25607,330510910000140,63,88,91,77,89,94,48,46,502,94,596,15.771812080536913
25608,330510910000141,79,79,127,104,88,78,42,34,555,76,631,12.044374009508717
25609,330510910000142,92,95,149,118,128,102,61,48,684,109,793,13.745271122320302
25610,330510910000143,59,72,72,74,48,59,31,13,384,44,428,10.280373831775702
25611,330510910000144,66,68,64,87,62,48,30,20,395,50,445,11.235955056179776
25612,330510910000145,124,180,168,169,142,116,57,42,899,99,998,9.919839679358718
25613,330510910000146,46,56,59,60,53,50,33,21,324,54,378,14.285714285714286
25614,330510910000147,48,57,73,52,51,56,26,26,337,52,389,13.367609254498715
25615,330510910000148,127,174,163,163,151,111,67,51,889,118,1007,11.717974180734856
25616,330510910000149,94,115,144,120,114,102,74,44,689,118,807,14.622057001239158
25617,330510910000150,89,132,81,86,72,42,32,14,502,46,548,8.394160583941606
25618,330510910000151,77,99,95,73,69,38,14,8,451,22,473,4.651162790697675
25619,330510910000152,130,182,159,165,118,78,55,25,832,80,912,8.771929824561404
25620,330510910000153,54,106,89,90,94,75,47,37,508,84,592,14.18918918918919
25621,330510910000154,37,40,52,51,38,30,29,14,248,43,291,14.776632302405499
25622,330510910000155,20,25,40,17,39,37,17,24,178,41,219,18.72146118721461
25623,330510910000156,117,141,159,133,122,100,59,45,772,104,876,11.872146118721462
25624,330510910000157,90,90,133,100,92,93,69,48,598,117,715,16.363636363636363
25625,330510910000158,45,77,64,52,51,76,49,24,365,73,438,16.666666666666668
25626,330510910000159,96,133,120,123,122,99,53,52,693,105,798,13.157894736842104
25627,330510910000160,148,206,169,169,201,118,64,55,1011,119,1130,10.530973451327434
25628,330510910000161,81,95,82,115,76,75,45,22,524,67,591,11.336717428087987
25629,330510910000162,45,80,88,95,94,106,55,33,508,88,596,14.765100671140939
25630,330510910000163,123,145,149,149,112,88,70,46,766,116,882,13.151927437641723
25631,330510910000164,108,126,138,188,114,118,93,57,792,150,942,15.92356687898089
25632,330510910000165,58,63,76,83,68,58,37,20,406,57,463,12.311015118790497
25633,330510910000166,84,120,129,111,129,89,58,60,662,118,780,15.128205128205128
25634,330510910000167,104,119,120,110,128,100,52,39,681,91,772,11.787564766839377
25635,330510910000168,115,120,139,113,131,97,51,41,715,92,807,11.400247831474598
25636,330510910000169,73,124,117,85,92,87,32,43,578,75,653,11.485451761102603
25637,330510910000170,117,150,125,136,135,84,73,56,747,129,876,14.726027397260275
25638,330510910000171,70,70,91,65,68,68,41,18,432,59,491,12.016293279022403
25639,330510910000172,146,157,147,156,129,100,48,56,835,104,939,11.075612353567625
25640,330510910000173,85,113,96,98,90,66,41,20,548,61,609,10.016420361247947
25641,330510910000174,142,157,157,164,133,109,74,40,862,114,976,11.680327868852459
25642,330510910000175,107,111,126,105,120,94,45,25,663,70,733,9.549795361527968
25643,330510910000176,75,111,77,71,48,44,23,9,426,32,458,6.986899563318778
25644,330510910000177,97,100,108,106,76,67,40,16,554,56,610,9.180327868852459
25645,330510910000178,66,63,56,57,45,36,22,13,323,35,358,9.776536312849162
25646,330510910000179,83,108,117,99,92,50,39,22,549,61,610,10.0
25647,330510910000180,111,125,110,100,88,65,33,19,599,52,651,7.987711213517665
25648,330510910000181,118,128,120,116,105,67,42,32,654,74,728,10.164835164835164
25649,330510910000182,79,202,191,180,150,85,47,24,887,71,958,7.411273486430063
25650,330510910000183,91,125,126,92,101,83,55,32,618,87,705,12.340425531914894
25651,330510910000184,99,145,100,194,132,79,54,30,749,84,833,10.084033613445378
25652,330510910000185,57,96,94,83,77,86,60,29,493,89,582,15.292096219931272
25653,330510910000186,116,130,126,102,98,74,51,32,646,83,729,11.385459533607682
25654,330510910000187,23,31,19,36,27,24,20,17,160,37,197,18.781725888324875
25655,330510910000188,69,73,72,74,82,66,25,35,436,60,496,12.096774193548388
25656,330510910000189,70,104,135,73,54,43,37,18,479,55,534,10.299625468164795
25657,330510910000190,90,99,124,122,79,74,27,33,588,60,648,9.25925925925926
25658,330510910000191,68,121,84,98,86,55,33,22,512,55,567,9.700176366843033
25659,330510910000192,75,88,94,105,68,59,33,31,489,64,553,11.573236889692586
25660,330510910000193,149,203,208,143,159,104,56,27,966,83,1049,7.912297426120114
25661,330510910000194,146,191,141,118,85,60,28,22,741,50,791,6.321112515802781
25662,330510910000195,77,94,92,113,68,58,43,25,502,68,570,11.929824561403509
25663,330510910000196,125,106,150,132,90,87,80,37,690,117,807,14.49814126394052
25664,330510910000197,32,53,61,66,72,51,34,32,335,66,401,16.458852867830423
25665,330510910000198,53,69,78,65,64,62,29,40,391,69,460,15.0
25666,330510910000199,140,148,156,191,151,118,71,53,904,124,1028,12.062256809338521
25667,330510910000200,69,86,85,108,80,62,49,33,490,82,572,14.335664335664335
25668,330510910000201,61,78,83,121,53,55,44,23,451,67,518,12.934362934362934
25669,330510910000202,86,105,116,121,111,93,50,41,632,91,723,12.586445366528354
25670,330510910000203,83,113,87,108,98,66,44,25,555,69,624,11.057692307692308
25671,330510910000204,73,85,108,112,66,81,57,24,525,81,606,13.366336633663366
25672,330510910000205,27,44,57,41,46,52,18,22,267,40,307,13.029315960912053
25673,330510910000206,54,86,92,92,101,72,57,55,497,112,609,18.39080459770115
25674,330510910000207,85,119,133,94,129,108,53,43,668,96,764,12.565445026178011
25675,330510910000208,83,96,72,73,54,40,35,14,418,49,467,10.492505353319057
25676,330510910000209,67,83,79,48,49,30,21,12,356,33,389,8.483290488431876
25677,330510910000210,107,120,106,104,80,70,39,27,587,66,653,10.10719754977029
25678,330510910000211,112,114,122,116,82,75,49,29,621,78,699,11.158798283261802
25679,330510910000212,145,143,168,167,104,73,49,36,800,85,885,9.6045197740113
25680,330510910000213,105,114,123,121,113,92,55,54,668,109,777,14.028314028314028
25681,330510910000214,69,82,123,94,94,61,47,22,523,69,592,11.655405405405405
25682,330510910000215,158,208,187,165,152,110,39,44,980,83,1063,7.808090310442145
25683,330510910000216,67,105,106,111,81,49,31,36,519,67,586,11.433447098976108
25684,330510910000217,100,96,110,98,73,89,42,30,566,72,638,11.285266457680251
25685,330510910000218,79,100,115,97,66,47,25,12,504,37,541,6.839186691312385
25686,330510910000219,67,101,82,80,95,61,29,30,486,59,545,10.825688073394495
25687,330510910000220,94,139,136,122,129,108,72,31,728,103,831,12.394705174488568
25688,330510910000221,99,145,117,116,107,91,48,13,675,61,736,8.28804347826087
25689,330510910000222,95,133,124,134,97,71,47,21,654,68,722,9.418282548476455
25690,330510910000223,41,57,53,60,62,48,28,27,321,55,376,14.627659574468085
25691,330510910000224,105,91,109,89,81,71,44,30,546,74,620,11.935483870967742
25692,330510910000225,48,47,64,51,56,46,37,16,312,53,365,14.520547945205479
25693,330510910000226,76,108,90,83,100,74,50,27,531,77,608,12.664473684210526
25694,330510910000227,77,106,68,104,85,71,67,36,511,103,614,16.775244299674267
25695,330510910000228,68,99,66,91,58,44,36,23,426,59,485,12.164948453608247
25696,330510910000229,90,102,104,81,61,60,34,20,498,54,552,9.782608695652174
25697,330510910000230,79,81,102,93,82,68,37,31,505,68,573,11.8673647469459
25698,330510910000231,59,72,81,71,70,62,35,27,415,62,477,12.9979035639413
25699,330510910000232,68,87,89,89,90,57,47,47,480,94,574,16.37630662020906
25700,330510910000233,126,128,138,152,106,90,68,32,740,100,840,11.904761904761905
25701,330510910000234,122,127,132,119,105,71,43,36,676,79,755,10.463576158940397
25702,330510910000235,58,70,82,57,72,38,39,18,377,57,434,13.133640552995391
25703,330510910000236,61,66,59,67,59,63,30,26,375,56,431,12.993039443155453
25704,330510910000237,89,136,135,115,93,72,63,27,640,90,730,12.32876712328767
25705,330510910000238,49,105,71,90,67,67,35,28,449,63,512,12.3046875
25706,330510910000239,51,52,70,92,70,47,34,9,382,43,425,10.117647058823529
25707,330510910000240,32,100,62,71,87,41,21,31,393,52,445,11.685393258426966
25708,330510910000241,78,108,112,86,102,79,43,42,565,85,650,13.076923076923077
25709,330510910000242,87,131,110,109,98,64,31,18,599,49,648,7.561728395061729
25710,330510910000243,90,103,108,114,114,92,65,34,621,99,720,13.75
25711,330510910000244,94,132,117,114,118,65,35,29,640,64,704,9.090909090909092
25712,330510910000245,25,41,51,37,18,35,14,16,207,30,237,12.658227848101266
25713,330510910000246,15,35,16,13,19,15,8,4,113,12,125,9.6
25714,330510910000247,22,33,21,37,23,14,9,9,150,18,168,10.714285714285714
25715,330510910000248,82,120,94,90,58,41,26,11,485,37,522,7.088122605363985
25716,330510910000249,22,41,48,55,24,26,16,7,216,23,239,9.623430962343097
25717,330510910000250,33,64,57,48,46,34,24,17,282,41,323,12.693498452012383
25718,330510910000251,23,31,41,35,33,20,10,6,183,16,199,8.040201005025125
25719,330510910000252,62,90,64,82,45,44,30,10,387,40,427,9.36768149882904
25720,330510910000253,48,96,63,66,61,41,32,14,375,46,421,10.926365795724466
25721,330510910000254,96,186,69,120,114,41,31,18,626,49,675,7.2592592592592595
25722,330510915000001,43,73,83,40,53,72,23,33,364,56,420,13.333333333333334
25723,330510915000002,64,85,72,71,72,60,37,26,424,63,487,12.936344969199178
25724,330510915000003,91,110,106,112,75,74,48,42,568,90,658,13.677811550151976
25725,330510915000004,117,129,141,120,105,86,48,45,698,93,791,11.757269279393173
25726,330510915000005,156,171,135,188,86,81,65,37,817,102,919,11.099020674646354
25727,330510915000006,76,90,85,89,66,74,56,28,480,84,564,14.893617021276595
25728,330510915000007,58,67,62,47,70,32,19,16,336,35,371,9.433962264150944
25729,330510915000008,60,82,80,60,69,38,31,22,389,53,442,11.990950226244344
25730,330510915000009,76,68,71,70,59,45,32,27,389,59,448,13.169642857142858
25731,330510915000010,99,103,105,95,69,59,39,40,530,79,609,12.97208538587849
25732,330510915000011,68,96,98,91,104,61,45,32,518,77,595,12.941176470588236
25733,330510915000012,90,127,103,124,96,78,42,53,618,95,713,13.32398316970547
25734,330510915000013,121,120,135,125,91,96,58,53,688,111,799,13.892365456821027
25735,330510915000014,50,84,63,52,49,43,22,17,341,39,380,10.263157894736842
25736,330510915000015,66,59,76,80,56,51,41,36,388,77,465,16.559139784946236
25737,330510915000016,46,66,54,53,44,57,30,26,320,56,376,14.893617021276595
25738,330510915000017,123,116,155,151,147,95,50,30,787,80,867,9.22722029988466
25739,330510915000018,69,82,65,58,75,44,23,16,393,39,432,9.027777777777779
25740,330510915000019,121,141,113,143,101,75,45,30,694,75,769,9.75292587776333
25741,330510915000020,34,32,39,48,22,28,14,9,203,23,226,10.176991150442477
25742,330510915000021,120,127,142,131,121,112,55,37,753,92,845,10.887573964497042
25743,330510915000022,53,49,58,58,56,49,23,24,323,47,370,12.702702702702704
25744,330510915000023,122,140,142,129,109,83,45,34,725,79,804,9.82587064676617
25745,330510915000024,105,136,118,90,101,50,32,27,600,59,659,8.952959028831563
25746,330510915000025,103,139,104,115,114,71,44,28,646,72,718,10.027855153203342
25747,330510915000026,141,175,137,142,116,83,63,33,794,96,890,10.786516853932584
25748,330510915000027,56,78,70,64,59,58,38,26,385,64,449,14.25389755011136
25749,330510915000028,89,118,120,111,93,97,72,31,628,103,731,14.090287277701778
25750,330510915000029,85,125,96,84,88,74,50,25,552,75,627,11.961722488038278
25751,330510915000030,71,102,97,67,76,63,27,24,476,51,527,9.67741935483871
25752,330510915000031,69,94,84,79,67,63,31,33,456,64,520,12.307692307692308
25753,330510915000032,65,71,84,61,53,54,25,23,388,48,436,11.009174311926605
25754,330510915000033,70,70,70,78,58,48,19,10,394,29,423,6.855791962174941
25755,330510915000034,120,146,128,119,114,71,67,39,698,106,804,13.18407960199005
25756,330510915000035,134,145,111,138,79,74,38,25,681,63,744,8.46774193548387
25757,330510915000036,150,161,157,149,101,88,59,22,806,81,887,9.131905298759865
25758,330510915000037,115,136,123,120,122,109,72,34,725,106,831,12.755716004813477
25759,330510915000038,135,165,138,135,115,90,63,43,778,106,884,11.990950226244344
25760,330510915000039,69,101,98,81,74,54,30,16,477,46,523,8.795411089866157
25761,330510915000040,117,137,139,127,98,81,38,22,699,60,759,7.905138339920948
25762,330510915000041,92,137,99,100,105,77,39,27,610,66,676,9.763313609467456
25763,330510915000042,70,88,88,63,88,54,31,23,451,54,505,10.693069306930694
25764,330510915000043,114,133,112,83,81,57,21,15,580,36,616,5.8441558441558445
25765,330510915000044,151,180,158,160,131,108,56,40,888,96,984,9.75609756097561
25766,330510915000045,118,139,159,116,90,87,60,22,709,82,791,10.366624525916562
25767,330510915000046,97,102,110,117,93,72,71,33,591,104,695,14.964028776978417
25768,330510915000047,59,70,69,60,60,41,21,20,359,41,400,10.25
25769,330510915000048,120,136,113,97,106,78,47,26,650,73,723,10.096818810511756
25770,330510915000049,96,121,123,126,86,77,41,27,629,68,697,9.75609756097561
25771,330510915000050,57,71,85,63,61,49,20,10,386,30,416,7.211538461538462
25772,330510915000051,76,98,84,83,58,50,55,24,449,79,528,14.962121212121213
25773,330510915000052,38,60,63,51,51,33,13,24,296,37,333,11.11111111111111
25774,330510915000053,154,176,167,155,94,95,46,30,841,76,917,8.287895310796074
25775,330510915000054,78,104,129,112,97,92,37,42,612,79,691,11.432706222865413
25776,330510915000055,112,161,171,152,130,116,67,50,842,117,959,12.200208550573514
25777,330510915000056,49,90,75,76,82,61,46,24,433,70,503,13.916500994035784
25778,330510915000057,113,153,150,137,116,100,59,42,769,101,870,11.60919540229885
25779,330510915000058,67,96,76,88,81,88,46,23,496,69,565,12.212389380530974
25780,330510915000059,82,98,100,99,96,90,57,44,565,101,666,15.165165165165165
25781,330510915000060,116,152,161,116,110,94,45,26,749,71,820,8.658536585365853
25782,330510915000061,73,81,78,71,78,46,21,20,427,41,468,8.760683760683762
25783,330510915000062,106,123,146,106,127,86,31,44,694,75,769,9.75292587776333
25784,330510915000063,130,168,179,153,140,89,55,39,859,94,953,9.863588667366212
25785,330510915000064,120,168,122,149,125,105,51,39,789,90,879,10.238907849829351
25786,330510915000065,112,151,144,126,131,100,54,39,764,93,857,10.851808634772462
25787,330510915000066,84,102,107,108,99,70,45,34,570,79,649,12.172573189522343
25788,330510915000067,74,110,82,84,92,57,37,25,499,62,561,11.05169340463458
25789,330510915000068,132,153,131,157,116,81,61,41,770,102,872,11.697247706422019
25790,330510915000069,101,143,136,97,107,89,46,26,673,72,745,9.664429530201343
25791,330510915000070,88,81,88,72,76,60,34,31,465,65,530,12.264150943396226
25792,330510915000071,52,59,68,71,32,49,42,13,331,55,386,14.248704663212436
25793,330510915000072,67,79,85,74,61,51,18,18,417,36,453,7.947019867549669
25794,330510915000073,58,87,67,82,57,50,19,22,401,41,442,9.276018099547512
25795,330510915000074,148,215,165,147,155,100,52,39,930,91,1021,8.9128305582762
25796,330510915000075,116,144,138,106,103,75,53,29,682,82,764,10.732984293193716
25797,330510915000076,46,64,63,48,46,38,31,19,305,50,355,14.084507042253522
25798,330510915000077,89,127,114,88,71,62,20,19,551,39,590,6.610169491525424
25799,330510915000078,83,103,68,90,56,52,21,17,452,38,490,7.755102040816326
25800,330510915000079,68,82,80,72,50,38,29,9,390,38,428,8.878504672897197
25801,330510915000080,62,60,51,64,44,48,23,17,329,40,369,10.840108401084011
25802,330510915000081,59,82,66,57,55,29,19,17,348,36,384,9.375
25803,330510915000082,98,115,108,103,92,76,45,20,592,65,657,9.89345509893455
25804,330510915000083,99,110,122,91,131,75,48,31,628,79,707,11.173974540311175
25805,330510915000084,76,103,76,74,72,66,34,27,467,61,528,11.553030303030303
25806,330510915000085,22,21,24,17,31,15,10,8,130,18,148,12.162162162162161
25807,330510915000086,26,37,33,38,36,49,22,10,219,32,251,12.749003984063744
25808,330510915000087,50,60,60,56,43,37,19,15,306,34,340,10.0
25809,330510915000088,61,74,58,59,43,45,19,8,340,27,367,7.356948228882834
25810,330510915000089,61,72,71,52,59,42,30,16,357,46,403,11.41439205955335
25811,330510915000090,48,68,55,54,61,33,30,19,319,49,368,13.315217391304348
25812,330510915000091,40,80,60,60,65,30,21,9,335,30,365,8.219178082191782
25813,330510915000092,60,70,67,48,42,52,17,12,339,29,368,7.880434782608695
25814,330510915000093,47,80,74,56,59,40,20,17,356,37,393,9.414758269720101
25815,330510915000094,73,90,85,62,49,58,30,19,417,49,466,10.515021459227468
25816,330513305000001,24,28,42,31,22,31,25,18,178,43,221,19.457013574660632
25817,330513305000002,102,99,125,98,95,66,55,57,585,112,697,16.068866571018653
25818,330513305000003,64,104,108,93,83,76,36,33,528,69,597,11.557788944723619
25819,330513305000004,56,72,57,72,82,56,26,31,395,57,452,12.610619469026549
25820,330513305000005,56,57,57,62,73,37,40,22,342,62,404,15.346534653465346
25821,330513305000006,57,67,79,57,98,62,42,38,420,80,500,16.0
25822,330513305000007,104,133,124,147,101,81,72,51,690,123,813,15.129151291512915
25823,330513305000008,59,65,72,74,69,48,30,18,387,48,435,11.03448275862069
25824,330513305000009,57,104,84,81,76,49,44,31,451,75,526,14.258555133079849
25825,330513305000010,65,77,83,87,80,48,41,37,440,78,518,15.057915057915057
25826,330513305000011,17,37,22,21,26,20,10,6,143,16,159,10.062893081761006
25827,330513305000012,55,87,74,83,86,74,59,32,459,91,550,16.545454545454547
25828,330513305000013,62,91,68,90,76,44,32,19,431,51,482,10.58091286307054
25829,330513305000014,104,87,110,120,91,65,36,36,577,72,649,11.093990755007704
25830,330515805000001,49,52,98,82,50,82,56,27,413,83,496,16.733870967741936
25831,330515805000002,71,104,95,98,111,63,39,43,542,82,624,13.14102564102564
25832,330515805000003,45,82,75,63,75,51,34,28,391,62,453,13.686534216335541
25833,330515805000004,40,72,68,63,61,52,35,25,356,60,416,14.423076923076923
25834,330515805000005,95,123,118,99,96,55,45,42,586,87,673,12.927191679049034
25835,330515805000006,148,192,185,155,148,128,72,61,956,133,1089,12.213039485766759
25836,330515805000007,53,75,40,68,45,23,15,22,304,37,341,10.850439882697946
25837,330515805000008,87,111,112,101,110,64,33,35,585,68,653,10.413476263399694
25838,330515805000009,68,118,87,89,83,61,46,36,506,82,588,13.945578231292517
25839,330515805000010,84,113,80,104,107,60,57,29,548,86,634,13.564668769716087
25840,330515805000011,70,104,121,82,114,82,68,42,573,110,683,16.105417276720353
25841,330515805000012,57,89,78,80,79,67,35,27,450,62,512,12.109375
25842,330515805000013,108,128,103,85,91,63,35,28,578,63,641,9.82839313572543
25843,330515805000014,102,133,118,99,102,78,41,34,632,75,707,10.608203677510609
25844,330515805000015,115,142,90,95,68,41,23,17,551,40,591,6.768189509306261
25845,330515805000016,79,95,105,96,90,58,29,26,523,55,578,9.515570934256056
25846,330515805000017,77,80,90,81,68,64,24,19,460,43,503,8.548707753479125
25847,330515805000018,81,93,80,73,62,48,30,28,437,58,495,11.717171717171718
25848,330515805000019,86,108,83,80,94,53,23,18,504,41,545,7.522935779816514
25849,330515805000020,8,9,15,13,14,6,5,6,65,11,76,14.473684210526315
25850,330515805000021,22,33,23,25,23,20,7,4,146,11,157,7.006369426751593
25851,330515805000022,67,101,74,78,64,42,24,29,426,53,479,11.064718162839249
25852,330515805000023,129,133,133,132,93,52,50,31,672,81,753,10.756972111553784
25853,330515805000024,32,78,61,71,61,50,22,13,353,35,388,9.02061855670103
25854,330515805000025,58,79,74,70,77,50,39,23,408,62,470,13.191489361702128
25855,330515805000026,111,150,116,128,98,74,35,21,677,56,733,7.639836289222374
25856,330515805000027,101,129,130,120,93,90,46,28,663,74,737,10.040705563093622
25857,330515805000028,30,39,23,38,13,12,13,5,155,18,173,10.404624277456648
25858,330515805000029,38,46,45,52,52,32,12,5,265,17,282,6.028368794326241
25859,330515805000030,46,74,57,59,40,53,22,17,329,39,368,10.597826086956522
25860,330515805000031,16,34,24,21,14,20,7,1,129,8,137,5.839416058394161
25861,330515805000032,100,114,120,118,84,73,44,20,609,64,673,9.50965824665676
25862,330515805000033,67,87,85,70,86,58,28,16,453,44,497,8.853118712273641
25863,330515805000034,42,37,42,47,31,28,23,8,227,31,258,12.015503875968992
25864,330515805000035,62,82,81,66,68,35,31,14,394,45,439,10.250569476082005
25865,330515805000036,105,119,97,93,102,47,38,27,563,65,628,10.35031847133758
25866,330515805000037,58,64,56,59,41,31,23,13,309,36,345,10.434782608695652
25867,330515805000038,82,139,95,94,90,56,30,16,556,46,602,7.641196013289036
25868,330515805000039,39,53,38,38,31,24,11,13,223,24,247,9.7165991902834
25869,330515805000040,24,30,30,26,22,13,7,7,145,14,159,8.80503144654088
25870,330515805000041,64,64,73,70,65,30,36,26,366,62,428,14.485981308411215
25871,330520805000001,76,103,99,100,86,73,36,35,537,71,608,11.677631578947368
25872,330520805000002,60,85,59,53,51,42,22,24,350,46,396,11.616161616161616
25873,330520805000003,129,126,117,102,70,48,31,24,592,55,647,8.500772797527048
25874,330520805000004,92,103,74,71,90,37,17,16,467,33,500,6.6
25875,330520805000005,14,13,6,4,15,9,7,1,61,8,69,11.594202898550725
25876,330520805000006,20,23,15,20,12,15,5,6,105,11,116,9.482758620689655
25877,330520805000007,35,40,31,22,18,20,11,16,166,27,193,13.989637305699482
25878,330520805000008,60,76,79,47,57,49,52,21,368,73,441,16.55328798185941
25879,330520805000009,0,2,2,3,3,5,2,2,15,4,19,21.05263157894737
25880,330520805000010,89,99,60,65,68,45,27,20,426,47,473,9.936575052854122
25881,330520805000011,61,103,88,67,58,49,31,21,426,52,478,10.878661087866108
25882,330520805000012,47,89,37,41,43,30,17,11,287,28,315,8.88888888888889
25883,330520805000013,22,24,32,19,13,18,8,4,128,12,140,8.571428571428571
25884,330520805000014,63,91,71,56,63,52,21,27,396,48,444,10.81081081081081
25886,330520805000016,51,78,66,53,62,35,19,27,345,46,391,11.764705882352942
25889,330520805000019,25,47,47,36,33,24,17,11,212,28,240,11.666666666666666
25890,330520805000020,22,41,24,25,16,19,9,17,147,26,173,15.028901734104046
25891,330520805000021,12,15,12,5,9,10,1,3,63,4,67,5.970149253731344
25892,330520805060001,17,30,34,36,34,37,23,35,188,58,246,23.577235772357724
25893,330520805060002,9,10,17,21,9,21,15,18,87,33,120,27.5
25894,330520805060003,20,23,45,31,29,32,29,29,180,58,238,24.369747899159663
25895,330520805060004,5,7,6,3,4,3,5,5,28,10,38,26.31578947368421
25896,330520805060005,48,70,60,60,83,50,39,28,371,67,438,15.296803652968036
25897,330520805060006,31,52,69,49,64,57,42,39,322,81,403,20.09925558312655
25898,330520805060007,34,60,47,47,64,51,29,32,303,61,364,16.75824175824176
25899,330520805060008,54,66,63,62,66,45,59,28,356,87,443,19.63882618510158
25900,330520805060009,54,71,75,67,90,99,55,46,456,101,557,18.132854578096946
25901,330520805060010,0,1,6,2,6,5,4,9,20,13,33,39.39393939393939
25902,330520805060011,16,13,16,17,19,12,10,6,93,16,109,14.678899082568808
25904,330520805060014,28,46,23,37,37,32,20,26,203,46,249,18.473895582329316
25906,330520805060016,64,79,85,69,89,71,69,60,457,129,586,22.013651877133107
25907,330520805060017,79,87,114,91,100,74,43,35,545,78,623,12.520064205457464
25908,330520805060018,33,48,45,35,48,28,22,16,237,38,275,13.818181818181818
25909,330520805060019,134,153,96,158,100,98,65,48,739,113,852,13.262910798122066
25910,330520805060020,36,58,43,54,55,47,21,23,293,44,337,13.056379821958457
25911,330520805060021,43,41,47,58,47,50,32,35,286,67,353,18.980169971671387
25912,330520805060022,75,109,92,89,82,75,47,23,522,70,592,11.824324324324325
25913,330520805060023,127,158,165,133,102,97,44,38,782,82,864,9.49074074074074
25914,330520805060024,18,21,22,14,12,8,5,3,95,8,103,7.766990291262136
25915,330520805060025,1,6,1,1,4,1,2,1,14,3,17,17.647058823529413
25916,330520805060026,10,9,6,10,2,8,3,1,45,4,49,8.16326530612245
25917,330520805060027,56,66,74,56,64,53,44,30,369,74,443,16.704288939051917
25918,330520805060028,58,70,61,60,72,41,34,23,362,57,419,13.60381861575179
25919,330520805060029,43,61,71,37,66,60,34,26,338,60,398,15.075376884422111
25920,330520805060030,42,50,54,56,52,42,29,19,296,48,344,13.953488372093023
25921,330520805060031,31,27,26,24,34,13,12,18,155,30,185,16.216216216216218
25922,330520805060033,54,63,68,58,78,58,48,25,379,73,452,16.150442477876105
25923,330520805060034,77,97,109,127,114,93,52,16,617,68,685,9.927007299270073
25924,330520805060035,0,2,1,1,6,4,0,1,14,1,15,6.666666666666667
25925,330520805060036,9,10,17,19,9,11,4,1,75,5,80,6.25
25926,330520805060037,11,16,8,11,16,17,8,4,79,12,91,13.186813186813186
25928,330520805060039,11,16,18,13,24,19,21,18,101,39,140,27.857142857142858
25929,330520805060040,15,18,13,17,18,7,13,9,88,22,110,20.0
25931,330520805060042,6,2,1,0,5,3,1,7,17,8,25,32.0
25934,330520805060045,60,90,56,80,93,57,35,29,436,64,500,12.8
25935,330520805060047,55,59,72,95,67,59,39,33,407,72,479,15.031315240083508
25936,330520805060048,31,31,29,23,20,17,6,4,151,10,161,6.211180124223603
25937,330520805060049,14,17,20,27,18,11,6,3,107,9,116,7.758620689655173
25938,330520805070001,52,65,54,67,55,42,34,13,335,47,382,12.303664921465968
25939,330520805070002,45,65,67,71,61,55,40,28,364,68,432,15.74074074074074
25940,330520805070003,60,72,65,87,81,75,50,64,440,114,554,20.577617328519857
25941,330520805070004,66,96,88,78,99,64,42,35,491,77,568,13.556338028169014
25942,330520805070005,43,47,50,73,40,34,19,23,287,42,329,12.76595744680851
25943,330520805070006,24,22,20,23,19,11,10,5,119,15,134,11.194029850746269
25944,330520805070007,4,7,25,6,8,4,3,7,54,10,64,15.625
25946,330520805070009,53,60,75,48,71,52,31,21,359,52,411,12.652068126520682
25947,330520805070010,69,94,64,110,67,44,23,16,448,39,487,8.008213552361397
25949,330520805070013,32,51,50,38,51,46,26,11,268,37,305,12.131147540983607
25950,330520805070014,78,103,103,118,100,60,52,39,562,91,653,13.935681470137826
25951,330520805070015,72,94,121,99,83,73,40,14,542,54,596,9.060402684563758
25952,330520805070016,25,39,42,40,39,29,16,13,214,29,243,11.934156378600823
25953,330520805070017,2,1,0,2,1,2,2,3,8,5,13,38.46153846153846
25954,330520805070018,42,83,68,63,80,44,32,20,380,52,432,12.037037037037036
25955,330520805070019,62,89,73,82,64,50,21,9,420,30,450,6.666666666666667
25956,330520805070020,54,78,62,64,66,25,19,16,349,35,384,9.114583333333334
25959,330520805070023,73,32,29,95,42,8,1,1,279,2,281,0.7117437722419929
25960,330520805070024,235,227,215,251,201,10,4,8,1139,12,1151,1.0425716768027802
25961,330520805070025,75,74,60,88,70,48,39,29,415,68,483,14.078674948240165
25964,330520805070028,44,38,76,98,45,52,30,9,353,39,392,9.948979591836734
25965,330520805070029,85,90,84,94,68,65,40,26,486,66,552,11.956521739130435
25966,330520805070031,23,20,17,13,12,9,6,8,94,14,108,12.962962962962964
25969,330520805070034,4,3,18,21,13,17,13,6,76,19,95,20.0
25972,330520805070037,14,12,20,13,7,8,4,3,74,7,81,8.641975308641975
25973,330520805070038,6,14,10,9,11,11,5,6,61,11,72,15.277777777777779
25974,330520805070039,169,173,155,150,122,69,48,32,838,80,918,8.714596949891067
25975,330520805070040,24,36,34,41,32,16,11,11,183,22,205,10.731707317073171
25976,330520805070042,78,103,83,71,58,34,26,19,427,45,472,9.533898305084746
25977,330520805070043,113,150,100,147,88,89,54,35,687,89,776,11.469072164948454
25978,330520805070044,22,29,8,18,6,9,3,4,92,7,99,7.070707070707071
25979,330520805070045,18,14,36,25,16,10,9,3,119,12,131,9.16030534351145
25980,330520805070046,46,46,37,53,33,32,15,8,247,23,270,8.518518518518519
25981,330520805070048,82,105,60,130,77,47,27,28,501,55,556,9.892086330935252
25982,330520805070049,30,41,27,30,24,19,6,4,171,10,181,5.524861878453039
25983,330520805070051,94,80,101,109,75,40,17,14,499,31,530,5.849056603773585
25984,330520805070052,74,87,107,83,56,58,37,29,465,66,531,12.429378531073446
25985,330520805070053,103,97,83,94,87,36,27,15,500,42,542,7.749077490774908
25986,330520805070054,35,63,47,41,48,15,14,13,249,27,276,9.782608695652174
25987,330520805070055,3,1,4,4,5,1,1,1,18,2,20,10.0
25988,330520805070057,40,45,48,50,50,38,26,11,271,37,308,12.012987012987013
25989,330520805070058,4,4,5,5,5,9,4,0,32,4,36,11.11111111111111
25990,330520805070059,33,47,50,42,44,21,11,9,237,20,257,7.782101167315175
25991,330520805070060,72,56,40,61,24,18,7,15,271,22,293,7.508532423208191
25992,330520805070061,198,250,179,142,161,95,43,25,1025,68,1093,6.221408966148216
25993,330520805070062,45,79,51,57,67,38,18,12,337,30,367,8.174386920980927
25994,330520805070064,44,61,98,87,53,61,31,9,404,40,444,9.00900900900901
25995,330520805070065,44,56,50,67,39,34,27,13,290,40,330,12.121212121212121
25996,330520805080001,41,47,26,54,51,49,30,27,268,57,325,17.53846153846154
25997,330520805080002,34,37,33,51,38,24,16,7,217,23,240,9.583333333333334
25998,330520805080003,24,22,24,31,32,29,17,48,162,65,227,28.634361233480178
25999,330520805080004,17,24,12,25,20,20,15,14,118,29,147,19.727891156462587
26000,330520805080005,44,46,50,68,37,42,32,32,287,64,351,18.233618233618234
26001,330520805080006,26,31,10,37,28,23,10,16,155,26,181,14.3646408839779
26002,330520805080007,9,7,3,13,10,7,6,5,49,11,60,18.333333333333332
26003,330520805080008,40,61,57,70,70,49,57,23,347,80,427,18.73536299765808
26004,330520805080009,21,15,18,18,20,12,9,6,104,15,119,12.605042016806722
26006,330520805080011,26,24,28,25,28,32,32,19,163,51,214,23.83177570093458
26007,330520805080012,9,20,20,23,29,31,26,13,132,39,171,22.80701754385965
26008,330520805080013,8,6,9,10,11,23,22,14,67,36,103,34.95145631067961
26009,330520805080014,41,61,35,50,37,41,20,12,265,32,297,10.774410774410775
26010,330520805080015,54,58,51,51,31,24,17,9,269,26,295,8.813559322033898
26011,330520805080016,19,45,33,25,19,7,2,3,148,5,153,3.2679738562091503
26012,330520805080017,22,40,37,40,27,26,11,11,192,22,214,10.280373831775702
26014,330520805080020,1,0,3,1,1,0,4,2,6,6,12,50.0
26015,330520805080021,122,109,114,98,83,72,29,31,598,60,658,9.118541033434651
26016,330520805080022,97,102,102,85,75,61,27,17,522,44,566,7.773851590106007
26017,330520805080023,40,51,50,38,50,26,21,14,255,35,290,12.068965517241379
26018,330520805080024,33,45,57,49,61,60,30,30,305,60,365,16.438356164383563
26019,330520805080025,41,43,44,48,31,43,16,21,250,37,287,12.89198606271777
26020,330520805080026,21,30,19,12,14,8,3,3,104,6,110,5.454545454545454
26021,330520805080027,21,23,10,17,9,4,3,3,84,6,90,6.666666666666667
26022,330520805080028,3,4,1,2,2,2,0,3,14,3,17,17.647058823529413
26023,330520805080029,20,18,17,25,25,13,11,5,118,16,134,11.940298507462687
26024,330520805080030,146,137,118,110,92,65,31,24,668,55,723,7.607192254495159
26025,330520805080031,16,13,13,11,9,4,2,1,66,3,69,4.3478260869565215
26026,330520805080032,29,42,28,32,31,22,15,9,184,24,208,11.538461538461538
26027,330520805080033,13,27,20,10,22,11,4,6,103,10,113,8.849557522123893
26028,330520805080034,72,103,87,95,91,63,50,27,511,77,588,13.095238095238095
26029,330520805080035,133,105,141,125,114,87,54,21,705,75,780,9.615384615384615
26030,330520805080036,22,20,26,19,20,16,9,15,123,24,147,16.3265306122449
26031,330520805080037,83,81,100,93,72,69,37,32,498,69,567,12.16931216931217
26032,330520805080038,68,69,59,47,55,38,34,21,336,55,391,14.066496163682864
26033,330520805080039,8,9,7,7,7,3,4,4,41,8,49,16.3265306122449
26036,330520805080042,3,3,5,2,4,4,0,0,21,0,21,0.0
26037,330520805080043,8,6,3,3,2,3,2,0,25,2,27,7.407407407407407
26038,330520805080045,48,69,64,31,65,30,28,18,307,46,353,13.031161473087819
26039,330520805080046,65,85,85,63,74,54,32,18,426,50,476,10.504201680672269
26040,330520805080047,51,88,70,55,73,43,40,31,380,71,451,15.742793791574279
26041,330520805080048,66,47,87,104,44,33,23,12,381,35,416,8.413461538461538
26042,330520805090001,87,105,122,99,101,78,51,29,592,80,672,11.904761904761905
26043,330520805090002,93,102,108,92,102,54,30,25,551,55,606,9.075907590759076
26044,330520805090003,75,102,111,105,92,77,54,33,562,87,649,13.405238828967642
26045,330520805090004,136,144,166,157,144,97,52,38,844,90,934,9.635974304068522
26046,330520805090005,53,47,61,65,57,47,53,27,330,80,410,19.51219512195122
26047,330520805090006,10,17,14,11,18,18,11,10,88,21,109,19.26605504587156
26048,330520805090007,50,61,61,67,53,49,40,20,341,60,401,14.962593516209477
26049,330520805090008,1,0,2,3,0,2,4,2,8,6,14,42.857142857142854
26050,330520805090009,97,109,83,85,84,35,25,18,493,43,536,8.022388059701493
26051,330520805090010,140,145,149,149,111,101,52,28,795,80,875,9.142857142857142
26052,330520805090011,55,77,94,86,68,81,31,20,461,51,512,9.9609375
26053,330520805090012,94,121,89,99,78,50,28,5,531,33,564,5.851063829787234
26054,330520805090013,11,10,7,5,13,4,2,2,50,4,54,7.407407407407407
26055,330520805090014,136,147,120,131,87,50,21,15,671,36,707,5.091937765205092
26056,330520805090015,194,210,167,151,160,74,35,21,956,56,1012,5.533596837944664
26057,330520805090016,87,123,96,83,66,37,34,12,492,46,538,8.550185873605948
26058,330520805090017,19,27,19,25,14,3,5,0,107,5,112,4.464285714285714
26059,330520805090018,80,82,81,87,61,42,26,9,433,35,468,7.478632478632479
26060,330520805090019,89,115,94,108,89,68,34,22,563,56,619,9.046849757673668
26061,330520805090020,102,111,98,114,78,77,32,18,580,50,630,7.936507936507937
26062,330520805090021,60,99,79,78,61,51,37,25,428,62,490,12.653061224489797
26063,330520805090022,106,118,122,133,96,80,50,25,655,75,730,10.273972602739725
26064,330520805090023,141,145,152,142,122,82,33,31,784,64,848,7.547169811320755
26065,330520805090024,99,137,129,118,112,89,51,47,684,98,782,12.531969309462916
26066,330520805090025,76,71,89,83,63,41,17,3,423,20,443,4.514672686230249
26067,330520805090026,107,136,147,115,115,80,48,30,700,78,778,10.025706940874036
26068,330520805090027,23,17,20,15,5,7,2,4,87,6,93,6.451612903225806
26069,330520805090028,190,233,193,227,135,106,38,21,1084,59,1143,5.16185476815398
26072,330520805090032,36,47,27,36,20,24,9,10,190,19,209,9.090909090909092
26073,330520805090033,112,149,117,122,111,63,43,17,674,60,734,8.174386920980927
26074,330520805090034,77,104,104,92,94,69,44,24,540,68,608,11.18421052631579
26075,330520805090035,79,68,85,86,51,37,38,27,406,65,471,13.800424628450106
26076,330520805090036,51,56,69,82,59,41,40,28,358,68,426,15.96244131455399
26077,330520805090037,43,59,53,65,63,33,35,30,316,65,381,17.060367454068242
26078,330520805090038,95,112,117,99,102,64,43,27,589,70,659,10.622154779969652
26080,330520805090041,57,70,47,37,50,28,20,16,289,36,325,11.076923076923077
26081,330520805090042,60,105,55,60,60,45,17,14,385,31,416,7.451923076923077
26082,330520805090043,172,169,141,109,98,65,28,18,754,46,800,5.75
26084,330520805090045,0,7,1,3,4,2,3,0,17,3,20,15.0
26086,330520805090048,89,102,73,82,56,42,23,24,444,47,491,9.572301425661914
26087,330520805090049,3,6,1,5,5,1,0,0,21,0,21,0.0
26088,330520805090050,140,166,135,152,97,60,31,16,750,47,797,5.89711417816813
26089,330520805090051,67,111,71,69,69,64,27,19,451,46,497,9.25553319919517
26090,330520805090052,73,85,79,73,60,40,22,10,410,32,442,7.239819004524887
26091,330520805090053,121,128,84,93,91,48,18,9,565,27,592,4.5608108108108105
26092,330520805090054,101,131,120,128,105,81,41,24,666,65,731,8.891928864569083
26093,330520805090055,115,96,113,97,97,67,47,32,585,79,664,11.897590361445783
26094,330520805090056,4,9,2,4,7,7,3,6,33,9,42,21.428571428571427
26095,330520805090057,10,14,9,16,8,10,3,0,67,3,70,4.285714285714286
26096,330520805090058,74,62,50,67,52,22,5,15,327,20,347,5.763688760806916
26097,330520805090059,38,35,32,26,22,9,5,2,162,7,169,4.1420118343195265
26098,330520805090060,43,55,49,51,43,24,13,10,265,23,288,7.986111111111111
26099,330520805090061,39,54,30,48,32,25,12,5,228,17,245,6.938775510204081
26100,330520805090062,41,68,42,36,33,33,25,10,253,35,288,12.152777777777779
26101,330520805090063,2,1,0,3,2,3,3,0,11,3,14,21.428571428571427
26102,330520805090064,67,64,69,57,69,42,34,10,368,44,412,10.679611650485437
26103,330520805090065,132,125,121,85,107,54,35,32,624,67,691,9.696092619392186
26104,330520805090066,61,55,65,55,46,47,21,18,329,39,368,10.597826086956522
26107,330520805090069,21,24,20,36,26,16,15,12,143,27,170,15.882352941176471
26108,330520805090070,69,96,87,87,92,62,44,24,493,68,561,12.121212121212121
26109,330520805090071,117,160,156,125,148,105,73,39,811,112,923,12.134344528710725
26110,330520805090072,16,32,20,12,24,19,9,3,123,12,135,8.88888888888889
26111,330520805090073,30,37,34,40,35,27,26,18,203,44,247,17.813765182186234
26112,330520805090074,134,159,149,171,120,90,52,24,823,76,899,8.453837597330367
26113,330520805090075,87,89,83,69,72,61,40,26,461,66,527,12.523719165085389
26116,330520805090078,78,95,59,53,56,28,21,13,369,34,403,8.436724565756824
26117,330520805090079,2,3,3,3,3,2,0,1,16,1,17,5.882352941176471
26118,330520805090080,198,219,169,168,115,65,25,20,934,45,979,4.59652706843718
26119,330520805090081,72,68,57,46,35,10,12,4,288,16,304,5.2631578947368425
26120,330520805090082,8,10,8,7,4,2,2,2,39,4,43,9.30232558139535
26121,330520805090083,94,96,61,72,67,29,18,15,419,33,452,7.300884955752212
26122,330520805090084,51,61,61,44,37,22,15,12,276,27,303,8.910891089108912
26123,330520805090085,21,28,18,12,15,10,4,2,104,6,110,5.454545454545454
26125,330520805090087,11,5,8,9,8,7,3,1,48,4,52,7.6923076923076925
26126,330520805090088,14,30,13,16,20,12,6,1,105,7,112,6.25
26127,330520805090089,15,18,13,9,12,6,1,3,73,4,77,5.194805194805195
26128,330520805090090,12,11,10,7,9,5,2,1,54,3,57,5.2631578947368425
26129,330520805090092,60,81,73,78,99,53,32,20,444,52,496,10.483870967741936
26130,330520805090093,130,156,155,119,131,83,52,26,774,78,852,9.154929577464788
26131,330520805090094,204,200,116,130,83,48,19,9,781,28,809,3.4610630407911
26132,330520805090095,131,135,155,123,125,79,37,21,748,58,806,7.196029776674938
26133,330520805090096,11,14,4,9,10,4,4,2,52,6,58,10.344827586206897
26134,330520805090097,70,66,68,74,62,40,36,15,380,51,431,11.832946635730858
26135,330520805090098,64,75,64,59,48,39,15,15,349,30,379,7.915567282321899
26136,330520805090099,19,22,14,23,16,9,3,1,103,4,107,3.7383177570093458
26137,330520805090100,33,14,33,43,20,10,7,3,153,10,163,6.134969325153374
26138,330530705000001,221,220,211,219,158,118,56,62,1147,118,1265,9.328063241106719
26139,330530705000002,92,113,129,127,119,100,59,73,680,132,812,16.25615763546798
26140,330530705000003,61,86,61,44,50,48,45,21,350,66,416,15.865384615384615
26141,330530705000004,37,35,38,33,39,30,16,19,212,35,247,14.17004048582996
26142,330530705000005,39,66,50,65,54,46,19,30,320,49,369,13.279132791327914
26143,330530705000006,51,69,41,42,53,55,25,25,311,50,361,13.850415512465373
26144,330530707000001,80,96,83,106,95,84,76,54,544,130,674,19.287833827893174
26145,330530707000002,69,97,106,101,107,95,45,57,575,102,677,15.066469719350074
26146,330530707000003,38,54,54,45,66,40,14,31,297,45,342,13.157894736842104
26147,330530707000004,66,86,97,90,95,70,63,36,504,99,603,16.417910447761194
26148,330530710000001,102,98,97,96,99,81,30,52,573,82,655,12.51908396946565
26149,330530710000002,77,85,105,81,89,80,62,56,517,118,635,18.58267716535433
26150,330530710000003,67,73,67,88,73,60,52,29,428,81,509,15.913555992141454
26151,330530710000004,92,124,130,105,106,93,53,52,650,105,755,13.907284768211921
26152,330530710000005,82,68,91,90,69,73,51,47,473,98,571,17.162872154115586
26153,330540605000001,40,49,75,58,49,72,62,41,343,103,446,23.094170403587444
26154,330540605000002,40,60,64,66,60,65,40,35,355,75,430,17.441860465116278
26155,330540605000003,50,68,67,71,88,59,37,29,403,66,469,14.072494669509595
26156,330540605000004,105,132,115,121,92,77,51,20,642,71,713,9.957924263674615
26157,330540605000005,124,141,145,129,112,95,58,56,746,114,860,13.255813953488373
26158,330540605000006,70,94,71,90,76,76,53,37,477,90,567,15.873015873015873
26159,330540605000007,91,114,95,101,124,80,54,44,605,98,703,13.940256045519204
26160,330540605000008,73,76,53,61,48,46,28,20,357,48,405,11.851851851851851
26161,330540605000009,39,48,47,49,24,19,6,4,226,10,236,4.237288135593221
26162,330540605000010,71,78,68,71,73,50,29,22,411,51,462,11.03896103896104
26163,330540605000015,64,71,82,64,73,59,34,22,413,56,469,11.940298507462687
26164,330540605000016,132,133,121,117,91,72,46,33,666,79,745,10.604026845637584
26165,330540610000001,89,116,118,107,105,97,49,34,632,83,715,11.608391608391608
26166,330540610000002,71,94,88,63,90,66,48,59,472,107,579,18.48013816925734
26167,330540610000003,72,91,102,67,99,89,48,48,520,96,616,15.584415584415584
26168,330540610000004,69,78,103,76,82,56,28,27,464,55,519,10.597302504816955
26169,330540610000006,26,43,30,38,42,39,25,17,218,42,260,16.153846153846153
26170,330540610000008,67,108,93,79,101,67,48,29,515,77,592,13.006756756756756
26171,330540610000009,66,85,83,68,74,44,30,23,420,53,473,11.20507399577167
26172,330540615000001,92,63,89,86,66,62,30,33,458,63,521,12.092130518234166
26173,330540615000002,24,36,37,29,36,43,27,18,205,45,250,18.0
26174,330540615000003,64,50,54,58,70,46,29,21,342,50,392,12.755102040816327
26175,330540615000004,69,131,121,106,101,73,28,21,601,49,650,7.538461538461538
26176,330540615000005,73,83,99,83,83,73,42,39,494,81,575,14.08695652173913
26177,330540615000006,43,56,32,49,42,27,22,16,249,38,287,13.240418118466899
26178,330540615000007,18,39,29,27,47,32,33,9,192,42,234,17.94871794871795
26179,330540615000008,81,112,100,114,118,81,45,32,606,77,683,11.273792093704246
26180,330540615000009,55,79,69,70,57,49,32,41,379,73,452,16.150442477876105
26181,330540620000001,67,91,74,85,75,63,42,64,455,106,561,18.89483065953654
26183,330540620000004,96,119,56,82,73,56,45,27,482,72,554,12.99638989169675
26185,330540620000006,27,47,57,31,35,42,32,17,239,49,288,17.01388888888889
26186,330540625000001,22,37,16,25,27,25,8,6,152,14,166,8.433734939759036
26187,330540625000002,104,105,96,106,65,35,27,21,511,48,559,8.586762075134168
26188,330540625000003,81,102,80,92,76,50,23,26,481,49,530,9.245283018867925
26189,330540625000004,56,80,82,63,66,48,26,26,395,52,447,11.6331096196868
26190,330550505000001,24,26,33,29,28,34,35,26,174,61,235,25.95744680851064
26191,330550505000002,27,31,19,23,32,36,24,24,168,48,216,22.22222222222222
26192,330550505000003,28,49,28,34,46,33,29,31,218,60,278,21.58273381294964
26193,330550505000004,41,71,58,65,53,57,37,26,345,63,408,15.441176470588236
26194,330550505000005,14,41,19,19,40,33,14,43,166,57,223,25.56053811659193
26196,330550505000008,24,47,24,22,43,23,16,20,183,36,219,16.438356164383563
26197,330550505000009,10,16,17,6,31,20,10,18,100,28,128,21.875
26198,330550505000010,19,37,22,31,33,25,28,32,167,60,227,26.431718061674008
26199,330550505000011,55,48,70,51,50,47,25,21,321,46,367,12.534059945504087
26200,330550505000012,22,33,30,21,19,32,18,16,157,34,191,17.801047120418847
26201,330550505000013,34,42,29,29,39,32,22,10,205,32,237,13.50210970464135
26202,330550505000014,27,39,27,47,37,27,23,27,204,50,254,19.68503937007874
26203,330550505000015,51,81,52,66,42,47,30,17,339,47,386,12.176165803108809
26204,330550505000016,45,43,49,37,29,42,18,16,245,34,279,12.186379928315413
26205,330550505000017,5,12,5,8,9,12,8,7,51,15,66,22.727272727272727
26206,330550505000018,12,12,19,5,16,15,5,10,79,15,94,15.957446808510639
26207,330550505000019,40,51,24,34,39,29,24,10,217,34,251,13.54581673306773
26208,330550505000020,13,31,20,17,30,23,16,16,134,32,166,19.27710843373494
26209,330550505000021,61,69,81,61,62,40,29,17,374,46,420,10.952380952380953
26210,330550505000022,25,26,46,18,26,8,8,8,149,16,165,9.696969696969697
26211,330550505000023,43,50,53,34,47,23,16,21,250,37,287,12.89198606271777
26212,330550505000024,54,64,41,43,53,40,21,16,295,37,332,11.144578313253012
26213,330550505000025,6,3,8,12,7,7,5,2,43,7,50,14.0
26214,330550505000026,24,25,27,29,27,17,16,8,149,24,173,13.872832369942197
26215,330550505000027,16,17,14,23,17,12,10,3,99,13,112,11.607142857142858
26216,330550505000028,12,26,14,11,26,31,13,16,120,29,149,19.463087248322147
26217,330550505000029,76,119,130,114,102,88,69,27,629,96,725,13.241379310344827
26218,330550505000030,17,37,26,26,24,32,12,6,162,18,180,10.0
26219,330550505000031,151,148,127,127,92,77,46,35,722,81,803,10.08717310087173
26220,330550505000032,53,70,55,53,54,52,34,28,337,62,399,15.538847117794486
26221,330550505000033,66,78,71,74,92,69,46,37,450,83,533,15.572232645403377
26222,330550505000034,36,55,62,36,52,45,28,22,286,50,336,14.880952380952381
26223,330550505000035,25,43,29,51,47,48,46,36,243,82,325,25.23076923076923
26224,330550505000036,5,14,12,14,15,13,4,11,73,15,88,17.045454545454547
26225,330550505000037,58,95,47,57,59,51,23,13,367,36,403,8.933002481389579
26226,330550505000038,63,69,70,67,66,68,49,39,403,88,491,17.922606924643585
26227,330550505000039,32,33,26,30,38,35,32,21,194,53,247,21.45748987854251
26228,330550505000040,30,42,42,37,42,45,35,23,238,58,296,19.594594594594593
26229,330550505000041,21,19,33,26,31,34,30,17,164,47,211,22.274881516587676
26230,330550505000042,25,37,34,31,35,28,25,10,190,35,225,15.555555555555555
26231,330550505000043,17,26,15,24,26,18,27,8,126,35,161,21.73913043478261
26232,330550505000044,8,11,11,16,15,20,16,7,81,23,104,22.115384615384617
26233,330550505000045,29,32,27,36,35,40,26,29,199,55,254,21.653543307086615
26234,330550505000046,30,35,35,28,37,53,34,16,218,50,268,18.65671641791045
26235,330550505000047,5,11,6,4,8,9,5,4,43,9,52,17.307692307692307
26236,330550505000048,14,21,14,11,15,10,12,0,85,12,97,12.371134020618557
26237,330550505000050,15,27,14,17,22,22,22,13,117,35,152,23.026315789473685
26238,330550505000051,6,18,21,13,21,18,17,16,97,33,130,25.384615384615383
26239,330550505000052,21,31,31,34,31,35,28,17,183,45,228,19.736842105263158
26240,330550505000053,35,55,39,39,63,18,8,8,249,16,265,6.037735849056604
26241,330550505000054,17,25,47,48,35,41,19,6,213,25,238,10.504201680672269
26242,330550505000055,52,62,52,47,46,28,31,15,287,46,333,13.813813813813814
26243,330550505000056,78,95,59,74,68,33,30,19,407,49,456,10.74561403508772
26244,330550505000057,40,35,50,39,36,23,12,8,223,20,243,8.23045267489712
26245,330550505000058,6,6,5,8,7,11,5,7,43,12,55,21.818181818181817
26246,330550505000059,268,106,310,150,77,64,36,23,975,59,1034,5.705996131528046
26247,330550505000060,15,21,20,13,28,29,14,8,126,22,148,14.864864864864865
26248,330550505000061,12,26,36,19,19,22,19,10,134,29,163,17.791411042944784
26249,330550505000062,38,45,41,39,56,36,11,11,255,22,277,7.9422382671480145
26250,330550505000063,39,39,36,25,16,16,16,11,171,27,198,13.636363636363637
26251,330550505000064,13,14,9,15,19,17,23,8,87,31,118,26.271186440677965
26252,330550505000065,21,22,18,16,11,23,17,3,111,20,131,15.267175572519085
26253,330550505000066,29,35,33,34,42,41,42,32,214,74,288,25.694444444444443
26254,330550505000067,7,20,12,14,22,13,22,24,88,46,134,34.32835820895522
26255,330550505000068,27,29,32,36,34,32,15,17,190,32,222,14.414414414414415
26257,330550505000070,30,60,41,46,54,35,29,22,266,51,317,16.08832807570978
26258,330550505000071,8,18,12,20,19,15,14,23,92,37,129,28.68217054263566
26259,330550505000072,15,25,12,22,14,15,13,15,103,28,131,21.374045801526716
26260,330550505000073,22,45,28,28,44,29,10,31,196,41,237,17.29957805907173
26261,330550505000074,11,16,14,10,14,22,13,12,87,25,112,22.321428571428573
26262,330550505000075,10,33,18,14,37,31,23,17,143,40,183,21.85792349726776
26263,330550505000076,16,24,15,23,24,29,21,24,131,45,176,25.568181818181817
26264,330550505000077,62,69,80,63,48,45,28,27,367,55,422,13.033175355450236
26265,330550505000078,5,16,10,18,28,29,26,14,106,40,146,27.397260273972602
26266,330550505000079,6,13,7,14,19,20,29,16,79,45,124,36.29032258064516
26267,330550505000080,38,44,34,29,33,33,21,16,211,37,248,14.919354838709678
26268,330550505000081,54,46,53,42,33,42,23,14,270,37,307,12.052117263843648
26269,330550505000082,18,25,15,19,14,24,10,12,115,22,137,16.05839416058394
26270,330550505000083,21,39,27,41,49,53,27,12,230,39,269,14.49814126394052
26271,330550505000085,21,27,25,29,33,21,28,18,156,46,202,22.77227722772277
26272,330550505000086,46,53,43,47,54,44,27,27,287,54,341,15.835777126099707
26273,330550505000087,27,21,25,16,26,18,11,14,133,25,158,15.822784810126583
26274,330550505000088,309,227,392,183,116,64,24,19,1291,43,1334,3.2233883058470765
26275,330550505000089,81,120,133,132,93,84,48,37,643,85,728,11.675824175824175
26276,330550505000090,59,87,36,59,68,57,33,17,366,50,416,12.01923076923077
26277,330550505000091,7,13,6,2,21,6,2,3,55,5,60,8.333333333333334
26278,330550505000092,13,20,21,23,27,28,15,2,132,17,149,11.409395973154362
26279,330550505000093,23,18,29,26,36,32,21,13,164,34,198,17.171717171717173
26280,330550505000094,31,34,32,30,15,22,13,7,164,20,184,10.869565217391305
26281,330550505000095,36,42,42,76,62,41,24,8,299,32,331,9.667673716012084
26282,330550505000096,45,52,62,65,53,31,17,13,308,30,338,8.875739644970414
26283,330550505000097,13,10,10,8,5,3,4,0,49,4,53,7.547169811320755
26285,330550505000099,9,18,13,24,17,10,6,1,91,7,98,7.142857142857143
26287,330550505000101,61,58,54,56,43,42,20,19,314,39,353,11.048158640226628
26288,330550505000102,46,62,54,53,31,32,31,12,278,43,321,13.39563862928349
26289,330550505000103,57,54,43,45,36,19,14,9,254,23,277,8.303249097472925
26290,330550505000104,30,47,48,27,49,39,19,21,240,40,280,14.285714285714286
26291,330550505000105,27,29,22,20,19,17,12,7,134,19,153,12.418300653594772
26292,330550505000106,17,13,25,19,11,28,6,5,113,11,124,8.870967741935484
26293,330550505000107,28,35,49,46,44,31,19,7,233,26,259,10.038610038610038
26294,330550505000108,48,71,61,87,55,39,34,15,361,49,410,11.951219512195122
26295,330550505000109,19,23,33,16,21,31,18,8,143,26,169,15.384615384615385
26296,330550510000001,51,40,60,40,65,57,40,28,313,68,381,17.84776902887139
26297,330550510000002,16,18,23,29,21,17,24,14,124,38,162,23.45679012345679
26299,330550510000004,41,54,45,55,48,32,34,15,275,49,324,15.123456790123457
26300,330550510000005,50,66,89,52,47,53,23,27,357,50,407,12.285012285012286
26301,330550510000006,20,25,25,25,21,14,10,11,130,21,151,13.907284768211921
26302,330550510000007,26,38,47,28,36,44,12,14,219,26,245,10.612244897959183
26303,330550510000008,30,33,70,44,52,51,37,24,280,61,341,17.88856304985337
26304,330550510000009,52,89,59,70,59,43,29,13,372,42,414,10.144927536231885
26305,330550510000010,77,99,67,65,53,35,25,26,396,51,447,11.409395973154362
26306,330550510000011,110,107,123,111,73,60,30,23,584,53,637,8.320251177394034
26307,330550510000012,63,72,56,83,47,41,25,12,362,37,399,9.273182957393484
26308,330550510000013,79,84,68,86,51,54,21,22,422,43,465,9.24731182795699
26309,330550510000014,36,43,30,30,45,43,28,22,227,50,277,18.050541516245488
26310,330550510000015,4,13,17,4,14,12,7,1,64,8,72,11.11111111111111
26311,330550510000016,30,37,47,27,27,28,14,8,196,22,218,10.091743119266056
26312,330550510000017,104,195,146,112,150,114,84,43,821,127,948,13.396624472573839
26313,330550510000018,26,40,18,36,42,21,17,18,183,35,218,16.05504587155963
26314,330550510000019,34,60,65,55,41,39,24,11,294,35,329,10.638297872340425
26315,330550510000020,53,91,71,62,52,40,33,22,369,55,424,12.971698113207546
26316,330550510000021,31,47,52,39,31,21,16,14,221,30,251,11.952191235059761
26317,330550510000022,26,32,36,36,23,19,17,12,172,29,201,14.427860696517413
26318,330550510000023,85,74,92,52,57,50,23,12,410,35,445,7.865168539325842
26319,330550510000024,87,77,92,65,61,40,35,17,422,52,474,10.970464135021096
26320,330550510000025,52,94,102,78,70,83,49,37,479,86,565,15.221238938053098
26321,330550510000026,73,87,94,87,81,52,43,30,474,73,547,13.345521023765997
26322,330550510000027,28,32,46,37,40,40,26,16,223,42,265,15.849056603773585
26323,330550510000028,195,155,388,124,62,89,40,28,1013,68,1081,6.290471785383904
26324,330550510000029,64,73,89,68,77,73,46,36,444,82,526,15.5893536121673
26325,330550510000030,54,87,83,85,81,55,32,26,445,58,503,11.530815109343937
26326,330550510000031,11,21,31,42,41,33,30,30,179,60,239,25.10460251046025
26327,330550510000032,60,50,39,46,47,26,17,18,268,35,303,11.551155115511552
26328,330550510000033,63,66,58,59,43,45,23,12,334,35,369,9.48509485094851
26329,330550510000034,17,29,19,17,22,24,12,5,128,17,145,11.724137931034482
26330,330550510000035,50,77,61,62,75,40,31,27,365,58,423,13.711583924349881
26331,330550510000036,103,97,95,80,68,58,28,19,501,47,548,8.576642335766424
26332,330550510000037,44,48,50,55,42,31,21,20,270,41,311,13.183279742765274
26333,330550510000038,6,5,4,7,1,2,5,0,25,5,30,16.666666666666668
26334,330550510000039,20,30,31,36,19,29,12,15,165,27,192,14.0625
26335,330550510000040,58,78,58,50,59,33,28,20,336,48,384,12.5
26336,330550510000041,66,61,74,65,68,35,42,37,369,79,448,17.633928571428573
26337,330550510000042,33,26,25,41,24,24,24,18,173,42,215,19.53488372093023
26338,330550510000043,64,64,74,58,52,51,24,27,363,51,414,12.318840579710145
26339,330550510000044,20,11,25,11,9,11,11,3,87,14,101,13.861386138613861
26340,330550510000045,8,31,28,26,27,22,7,15,142,22,164,13.414634146341463
26341,330550510000046,72,97,89,88,77,69,39,31,492,70,562,12.455516014234876
26342,330550510000047,24,35,34,37,48,32,29,16,210,45,255,17.647058823529413
26343,330550510000048,50,69,45,64,61,38,39,23,327,62,389,15.938303341902314
26344,330550510000049,19,30,37,33,36,35,37,5,190,42,232,18.103448275862068
26345,330550510000050,22,39,23,25,38,16,14,15,163,29,192,15.104166666666666
26346,330550510000051,7,15,17,16,21,13,6,7,89,13,102,12.745098039215685
26347,330550510000052,58,67,77,49,45,56,26,36,352,62,414,14.97584541062802
26348,330550510000053,32,46,48,38,42,39,18,16,245,34,279,12.186379928315413
26349,330550510000054,35,48,43,46,47,36,24,15,255,39,294,13.26530612244898
26350,330550510000055,32,31,22,30,11,13,5,2,139,7,146,4.794520547945205
26351,330550510000056,38,58,36,51,48,34,28,18,265,46,311,14.790996784565916
26352,330550510000057,33,39,45,37,32,49,24,20,235,44,279,15.770609318996415
26353,330550510000058,72,73,88,66,56,43,20,24,398,44,442,9.95475113122172
26354,330550510000059,105,69,131,86,58,37,37,31,486,68,554,12.274368231046932
26355,330550510000060,109,77,127,77,71,37,27,27,498,54,552,9.782608695652174
26356,330550510000061,37,58,43,47,50,43,36,34,278,70,348,20.114942528735632
26357,330550510000062,30,48,42,35,52,33,19,11,240,30,270,11.11111111111111
26359,330550510000064,57,93,82,70,68,63,42,26,433,68,501,13.572854291417165
26360,330550510000065,53,49,71,57,42,60,34,23,332,57,389,14.652956298200515
26361,330550510000066,64,84,78,66,76,50,31,24,418,55,473,11.627906976744185
26362,330550510000067,34,36,27,27,22,22,15,5,168,20,188,10.638297872340425
26363,330550510000068,13,26,24,23,25,14,10,7,125,17,142,11.971830985915492
26364,330550510000069,50,67,57,47,53,44,27,13,318,40,358,11.1731843575419
26365,330550510000070,86,79,77,80,81,48,31,25,451,56,507,11.045364891518737
26366,330550510000071,107,110,115,110,99,82,47,20,623,67,690,9.710144927536232
26367,330550510000072,56,63,64,58,51,42,25,19,334,44,378,11.640211640211641
26368,330550510000073,16,47,40,28,57,30,17,12,218,29,247,11.740890688259109
26369,330550510000074,31,36,29,36,18,20,7,10,170,17,187,9.090909090909092
26370,330550510000075,70,128,83,80,66,45,24,23,472,47,519,9.05587668593449
26373,330550510000078,9,18,10,12,16,6,4,5,71,9,80,11.25
26374,330550510000079,126,141,154,117,134,71,37,66,743,103,846,12.174940898345154
26375,330550510000080,4,16,14,10,15,18,9,8,77,17,94,18.085106382978722
26376,330550510000081,44,49,55,43,46,39,35,16,276,51,327,15.596330275229358
26377,330550510000082,13,15,17,2,7,6,10,10,60,20,80,25.0
26378,330550510000083,60,76,74,46,69,49,33,25,374,58,432,13.425925925925926
26379,330550510000084,49,87,60,50,55,33,26,22,334,48,382,12.565445026178011
26380,330550510000085,22,22,22,20,17,17,10,7,120,17,137,12.408759124087592
26381,330550510000086,9,2,4,6,1,1,3,2,23,5,28,17.857142857142858
26382,330550510000087,33,52,44,45,33,34,21,13,241,34,275,12.363636363636363
26383,330550510000088,19,39,44,41,51,29,17,12,223,29,252,11.507936507936508
26384,330550510000089,127,170,127,163,114,76,60,43,777,103,880,11.704545454545455
26385,330550510000090,34,37,82,60,37,41,20,9,291,29,320,9.0625
26386,330550510000091,71,101,86,67,74,66,35,20,465,55,520,10.576923076923077
26387,330550510000092,95,203,136,104,99,93,68,41,730,109,839,12.991656734207389
26388,330550510000093,28,51,25,34,36,12,14,4,186,18,204,8.823529411764707
26389,330550510000094,39,50,60,23,39,24,29,22,235,51,286,17.832167832167833
26390,330550510000095,61,54,48,20,45,33,24,25,261,49,310,15.806451612903226
26391,330550510000096,56,70,39,29,48,28,18,12,270,30,300,10.0
26392,330550510000097,24,26,33,27,17,18,10,6,145,16,161,9.937888198757763
26393,330550510000098,17,28,20,13,21,14,6,2,113,8,121,6.6115702479338845
26394,330550510000099,58,73,83,68,67,42,30,27,391,57,448,12.723214285714286
26395,330550510000100,24,37,21,35,30,24,21,11,171,32,203,15.763546798029557
26396,330550510000101,3,7,2,6,5,6,2,1,29,3,32,9.375
26397,330550510000102,20,32,25,26,29,17,20,12,149,32,181,17.679558011049725
26398,330550510000103,24,35,22,18,27,12,10,6,138,16,154,10.38961038961039
26399,330550510000104,3,6,3,4,3,0,1,1,19,2,21,9.523809523809524
26400,330550510000105,15,24,26,29,18,17,7,2,129,9,138,6.521739130434782
26401,330550510000106,35,61,60,53,63,55,24,17,327,41,368,11.141304347826088
26402,330550510000107,4,13,13,10,18,9,4,3,67,7,74,9.45945945945946
26403,330550510000108,164,84,261,95,37,43,9,7,684,16,700,2.2857142857142856
26404,330550515000001,122,117,112,93,79,49,43,23,572,66,638,10.344827586206897
26405,330550515000002,78,88,82,74,67,34,24,28,423,52,475,10.947368421052632
26406,330550515000003,103,146,128,115,111,84,50,45,687,95,782,12.148337595907929
26407,330550515000004,91,128,80,91,78,65,46,28,533,74,607,12.191103789126853
26408,330550515000005,24,27,36,32,15,25,19,3,159,22,181,12.154696132596685
26409,330550515000006,46,39,58,38,29,21,21,30,231,51,282,18.085106382978722
26410,330550515000007,8,7,14,9,9,13,6,8,60,14,74,18.91891891891892
26411,330550515000008,42,63,41,47,37,38,24,15,268,39,307,12.703583061889251
26412,330550515000009,12,10,13,6,8,11,3,5,60,8,68,11.764705882352942
26413,330550515000010,7,14,5,8,8,8,5,0,50,5,55,9.090909090909092
26414,330550515000011,10,10,5,10,8,8,8,7,51,15,66,22.727272727272727
26415,330550515000012,26,84,72,120,95,42,26,2,439,28,467,5.995717344753747
26416,330550515000013,6,15,8,9,6,6,5,2,50,7,57,12.280701754385966
26417,330550515000015,32,36,19,36,27,40,25,14,190,39,229,17.03056768558952
26418,330550515000016,17,27,13,18,26,30,16,14,131,30,161,18.633540372670808
26419,330550515000017,111,39,161,32,17,34,6,6,394,12,406,2.955665024630542
26420,330550515000018,15,14,16,16,18,22,22,10,101,32,133,24.06015037593985
26421,330550515000019,19,16,23,10,20,14,14,12,102,26,128,20.3125
26422,330550515000020,14,18,31,31,24,22,19,7,140,26,166,15.662650602409638
26423,330550515000021,60,58,52,46,44,32,14,17,292,31,323,9.597523219814242
26424,330550515000022,1,9,2,0,4,2,4,3,18,7,25,28.0
26425,330550515000023,6,10,10,8,14,8,6,4,56,10,66,15.151515151515152
26426,330550515000024,111,142,92,92,86,48,31,15,571,46,617,7.455429497568882
26427,330550515000025,27,32,25,19,27,21,9,13,151,22,173,12.716763005780347
26428,330550515000026,13,9,13,8,7,19,8,7,69,15,84,17.857142857142858
26429,330550515000027,40,51,37,46,30,23,28,15,227,43,270,15.925925925925926
26430,330550515000028,24,80,50,28,61,18,9,4,261,13,274,4.744525547445256
26431,330550515000029,19,18,23,16,17,17,5,1,110,6,116,5.172413793103448
26432,330550515000030,8,17,12,16,12,9,12,7,74,19,93,20.43010752688172
26433,330550515000031,11,6,15,12,10,9,3,3,63,6,69,8.695652173913043
26434,330550515000032,44,48,40,40,37,31,15,11,240,26,266,9.774436090225564
26435,330550515000033,69,118,85,108,74,88,48,35,542,83,625,13.28
26436,330550515000034,1,7,4,9,4,7,2,1,32,3,35,8.571428571428571
26437,330550515000035,28,30,16,18,21,12,12,7,125,19,144,13.194444444444445
26438,330550515000036,1,9,2,4,4,3,1,1,23,2,25,8.0
26439,330550515000037,11,14,10,14,15,12,5,6,76,11,87,12.64367816091954
26440,330550515000038,34,46,38,31,29,17,13,13,195,26,221,11.764705882352942
26441,330550515000039,41,54,59,30,41,49,11,9,274,20,294,6.802721088435374
26442,330550515000040,68,90,57,59,55,34,18,6,363,24,387,6.2015503875969
26443,330550515000041,36,61,38,27,29,23,25,9,214,34,248,13.709677419354838
26444,330550515000042,13,14,18,9,14,17,7,1,85,8,93,8.602150537634408
26445,330550515000043,20,32,22,38,28,13,18,2,153,20,173,11.560693641618498
26446,330550515000044,3,20,14,14,22,16,20,18,89,38,127,29.921259842519685
26447,330550515000045,17,17,26,26,13,22,10,11,121,21,142,14.788732394366198
26448,330550515000046,12,22,12,24,17,26,14,3,113,17,130,13.076923076923077
26449,330550515000047,25,41,35,26,34,24,20,12,185,32,217,14.746543778801843
26450,330550515000048,9,11,14,8,12,16,1,7,70,8,78,10.256410256410257
26451,330550515000049,30,28,19,27,31,22,29,9,157,38,195,19.487179487179485
26452,330550515000050,4,5,3,5,8,10,12,7,35,19,54,35.18518518518518
26453,330550515000051,23,17,22,23,29,17,20,20,131,40,171,23.391812865497077
26454,330550515000052,12,21,19,21,24,23,19,15,120,34,154,22.07792207792208
26455,330550515000053,46,48,35,38,42,28,23,11,237,34,271,12.546125461254613
26456,330550515000054,25,33,33,21,23,30,17,9,165,26,191,13.612565445026178
26457,330555405000001,50,114,243,98,79,67,40,38,651,78,729,10.699588477366255
26458,330555405000002,69,93,120,91,87,73,49,25,533,74,607,12.191103789126853
26459,330555405000003,36,80,102,60,54,41,39,30,373,69,442,15.610859728506787
26460,330555405000004,46,62,81,52,57,51,35,30,349,65,414,15.70048309178744
26461,330555405000005,80,110,181,106,112,72,56,55,661,111,772,14.378238341968911
26462,330555405000006,41,48,75,52,39,50,33,18,305,51,356,14.325842696629213
26463,330555405000007,51,64,61,71,41,53,37,12,341,49,390,12.564102564102564
26464,330555405000008,49,101,169,88,69,96,46,39,572,85,657,12.937595129375952
26465,330555405000009,111,127,132,103,111,73,42,25,657,67,724,9.25414364640884
26466,330555405000010,157,208,137,137,152,55,51,33,846,84,930,9.03225806451613
26467,330555405000011,70,115,80,116,108,65,34,25,554,59,613,9.624796084828711
26468,330555405000012,105,117,127,103,74,76,41,37,602,78,680,11.470588235294118
26469,330555405000013,196,246,192,182,144,116,51,47,1076,98,1174,8.347529812606474
26470,330555405000014,98,135,149,103,148,103,46,47,736,93,829,11.218335343787697
26471,330555405000015,102,164,185,151,149,97,69,45,848,114,962,11.85031185031185
26472,330555405000016,27,55,60,39,61,51,29,26,293,55,348,15.804597701149426
26473,330555405000017,67,101,132,87,74,74,45,28,535,73,608,12.006578947368421
26474,330555405000018,93,130,133,125,160,92,77,62,733,139,872,15.940366972477063
26475,330555405000019,45,102,159,62,74,75,51,37,517,88,605,14.545454545454545
26476,330555405000020,41,58,79,58,56,44,22,23,336,45,381,11.811023622047244
26477,330555405000021,96,144,134,137,118,87,51,46,716,97,813,11.931119311193111
26478,330555405000022,86,141,154,113,113,100,54,49,707,103,810,12.716049382716049
26479,330555405000023,94,133,151,124,88,72,50,38,662,88,750,11.733333333333333
26480,330555405000024,167,204,215,180,147,107,50,38,1020,88,1108,7.9422382671480145
26481,330555405000025,64,71,87,72,65,58,25,14,417,39,456,8.552631578947368
26482,330555405000026,108,149,152,136,108,97,45,36,750,81,831,9.747292418772563
26483,330555405000027,106,135,111,117,88,60,52,19,617,71,688,10.319767441860465
26484,330555405000028,231,251,269,254,170,176,78,49,1351,127,1478,8.592692828146143
26485,330555405000029,64,114,144,88,134,167,70,31,711,101,812,12.438423645320198
26486,330555405000030,81,117,121,93,122,91,42,51,625,93,718,12.952646239554317
26487,330555405000031,52,77,64,51,77,50,30,35,371,65,436,14.908256880733944
26488,330555405000032,67,195,556,84,93,153,43,23,1148,66,1214,5.436573311367381
26489,330555405000033,40,43,22,48,26,25,15,14,204,29,233,12.446351931330472
26490,330555405000034,63,137,84,102,107,64,28,35,557,63,620,10.161290322580646
26491,330555405000035,109,168,141,127,139,110,39,34,794,73,867,8.419838523644753
26492,330555405000036,73,101,89,91,81,53,46,22,488,68,556,12.23021582733813
26493,330555405000037,20,24,18,15,20,27,11,8,124,19,143,13.286713286713287
26494,330555405000038,1,2,0,1,2,0,0,0,6,0,6,0.0
26495,330555405000039,56,77,61,54,46,31,21,13,325,34,359,9.470752089136491
26496,330555405000040,142,177,143,132,117,99,57,38,810,95,905,10.497237569060774
26497,330555405000041,79,91,95,81,75,52,43,25,473,68,541,12.569316081330868
26498,330555405000042,142,165,176,155,101,103,37,37,842,74,916,8.078602620087336
26499,330555405000043,109,128,118,124,103,57,43,32,639,75,714,10.504201680672269
26500,330555405000044,74,84,101,83,77,66,29,32,485,61,546,11.172161172161172
26501,330555405000045,184,259,185,171,181,116,55,65,1096,120,1216,9.868421052631579
26502,330555405000046,151,161,166,140,110,95,46,30,823,76,899,8.453837597330367
26503,330555405000047,100,125,115,133,117,86,37,32,676,69,745,9.261744966442953
26504,330555405000048,96,134,110,78,105,67,33,20,590,53,643,8.242612752721618
26505,330555405000049,128,178,136,125,105,98,46,33,770,79,849,9.305064782096585
26506,330555405000050,163,239,158,175,110,80,45,27,925,72,997,7.2216649949849545
26507,330555405000051,80,97,78,62,62,42,30,23,421,53,474,11.181434599156118
26508,330555405000052,102,97,90,90,50,47,50,34,476,84,560,15.0
26509,330555405000053,167,180,125,125,109,106,58,37,812,95,907,10.474090407938258
26510,330555405000054,72,113,84,91,89,68,52,37,517,89,606,14.686468646864686
26511,330555405000055,130,156,136,98,83,69,29,34,672,63,735,8.571428571428571
26512,330555405000056,100,117,123,116,86,71,45,46,613,91,704,12.926136363636363
26513,330555405000057,112,161,127,114,114,76,42,30,704,72,776,9.278350515463918
26514,330555405000058,118,147,120,115,104,72,38,41,676,79,755,10.463576158940397
26515,330555405000059,80,125,69,98,54,56,45,33,482,78,560,13.928571428571429
26516,330555405000060,166,191,133,171,117,65,48,27,843,75,918,8.169934640522875
26517,330555405000061,150,167,159,161,116,95,46,34,848,80,928,8.620689655172415
26518,330555405000062,119,159,117,123,100,68,37,18,686,55,741,7.422402159244265
26519,330555405000063,83,100,116,86,103,80,49,21,568,70,638,10.9717868338558
26520,330555405000064,82,91,105,113,86,73,53,32,550,85,635,13.385826771653543
26521,330555405000065,98,141,130,105,122,98,44,41,694,85,779,10.911424903722722
26522,330555405000066,55,111,103,78,89,72,35,32,508,67,575,11.652173913043478
26523,330555405000067,69,107,126,79,110,97,39,49,588,88,676,13.017751479289942
26524,330555405000068,57,54,54,37,52,38,16,15,292,31,323,9.597523219814242
26525,330555405000069,136,157,165,174,117,113,55,41,862,96,958,10.020876826722338
26526,330555405000070,69,91,83,78,65,64,26,28,450,54,504,10.714285714285714
26527,330555405000071,84,109,103,98,109,57,34,35,560,69,629,10.9697933227345
26528,330555405000072,87,86,81,93,85,47,33,16,479,49,528,9.280303030303031
26529,330555405000073,200,290,242,215,214,149,50,42,1310,92,1402,6.562054208273895
26530,330555405000074,125,155,147,136,109,67,40,44,739,84,823,10.206561360874849
26531,330555405000075,192,220,174,168,131,95,54,25,980,79,1059,7.459867799811143
26532,330555405000076,158,164,162,153,122,78,47,38,837,85,922,9.219088937093275
26533,330555405000077,69,86,53,65,33,21,14,7,327,21,348,6.0344827586206895
26534,330555405000078,81,99,98,66,75,50,25,19,469,44,513,8.576998050682262
26535,330555405000079,79,137,95,111,83,51,26,24,556,50,606,8.250825082508252
26536,330555405000080,106,136,132,131,98,59,35,31,662,66,728,9.065934065934066
26537,330555405000081,115,105,105,98,72,78,32,37,573,69,642,10.74766355140187
26538,330555405000082,79,109,66,79,72,36,30,25,441,55,496,11.088709677419354
26539,330555405000083,109,136,105,116,105,67,21,37,638,58,696,8.333333333333334
26540,330555405000084,270,328,261,234,198,149,78,47,1440,125,1565,7.987220447284345
26541,330555405000085,46,30,26,27,22,18,10,8,169,18,187,9.62566844919786
26542,330555405000086,182,208,185,188,127,106,50,37,996,87,1083,8.033240997229917
26543,330555405000087,97,102,123,124,88,84,60,24,618,84,702,11.965811965811966
26544,330555405000088,102,118,139,102,81,92,48,36,634,84,718,11.699164345403899
26545,330555405000089,95,123,125,80,84,90,57,32,597,89,686,12.973760932944606
26546,330555405000090,130,142,140,104,61,76,57,44,653,101,754,13.39522546419098
26547,330555405000091,207,271,186,146,128,89,48,31,1027,79,1106,7.142857142857143
26548,330555405000092,166,176,137,112,82,68,35,37,741,72,813,8.85608856088561
26549,330555405000093,124,196,162,123,90,102,60,39,797,99,896,11.049107142857142
26550,330555405000094,151,159,148,122,84,76,68,42,740,110,850,12.941176470588236
26551,330555405000095,107,107,118,103,82,60,32,27,577,59,636,9.276729559748428
26552,330555405000096,115,136,132,117,102,73,36,29,675,65,740,8.783783783783784
26553,330555405000097,80,87,67,36,46,30,17,16,346,33,379,8.70712401055409
26554,330555405000098,20,23,16,18,21,13,6,10,111,16,127,12.598425196850394
26555,330555405000099,34,35,39,36,31,18,16,7,193,23,216,10.648148148148149
26556,330555405000100,16,12,9,8,6,2,7,2,53,9,62,14.516129032258064
26557,330555405000101,47,43,51,29,38,26,13,10,234,23,257,8.949416342412452
26558,330555405000102,46,65,69,110,83,59,22,18,432,40,472,8.474576271186441
26559,330555405000103,42,92,39,76,64,31,11,16,344,27,371,7.277628032345014
26560,330555405000104,177,180,177,185,143,145,51,62,1007,113,1120,10.089285714285714
26561,330555405000105,46,68,62,59,61,62,30,14,358,44,402,10.945273631840797
26562,330555405000106,34,51,38,30,46,35,17,19,234,36,270,13.333333333333334
26563,330555405000107,54,78,74,56,59,52,21,19,373,40,413,9.685230024213075
26564,330555405000108,126,163,133,143,113,81,38,31,759,69,828,8.333333333333334
26565,330555405000109,100,115,95,97,64,54,16,30,525,46,571,8.056042031523642
26566,330555405000110,90,117,99,106,77,56,35,13,545,48,593,8.094435075885329
26567,330555405000111,54,82,68,72,61,35,23,19,372,42,414,10.144927536231885
26568,330555405000112,93,111,76,80,87,54,38,29,501,67,568,11.795774647887324
26569,330555405000113,114,104,90,82,61,63,39,19,514,58,572,10.13986013986014
26570,330555405000114,117,143,113,87,76,82,32,26,618,58,676,8.579881656804734
26571,330555405000115,64,85,89,61,78,60,37,30,437,67,504,13.293650793650794
26572,330555405000116,86,98,76,93,71,53,39,10,477,49,526,9.315589353612168
26573,330560405000001,147,162,158,120,131,101,51,50,819,101,920,10.978260869565217
26574,330560405000002,49,67,48,40,43,31,16,25,278,41,319,12.852664576802507
26575,330560405000003,65,93,72,48,38,36,22,11,352,33,385,8.571428571428571
26576,330560405000004,106,141,120,101,86,70,30,31,624,61,685,8.905109489051094
26577,330560405000005,108,123,119,113,81,71,35,39,615,74,689,10.740203193033382
26578,330560405000006,90,117,111,89,83,81,50,64,571,114,685,16.642335766423358
26579,330560405000007,62,77,67,54,76,53,30,49,389,79,468,16.88034188034188
26580,330560405000008,80,114,107,96,96,62,35,41,555,76,631,12.044374009508717
26581,330560405000009,102,136,107,127,97,66,34,22,635,56,691,8.104196816208393
26582,330560405000010,106,129,127,99,84,61,32,43,606,75,681,11.013215859030836
26583,330560405000011,75,81,85,66,47,40,20,24,394,44,438,10.045662100456621
26584,330560405000012,142,181,135,113,118,54,43,49,743,92,835,11.017964071856287
26585,330560405000013,59,86,65,81,47,46,27,15,384,42,426,9.859154929577464
26586,330560405000014,95,129,143,108,85,75,34,32,635,66,701,9.4151212553495
26587,330560405000015,51,59,82,53,61,50,28,24,356,52,408,12.745098039215685
26588,330560405000016,76,77,82,41,41,30,17,17,347,34,381,8.923884514435695
26589,330560405000017,163,175,152,123,111,69,41,34,793,75,868,8.640552995391705
26590,330560405000018,93,108,94,76,65,51,36,24,487,60,547,10.968921389396709
26591,330560405000019,38,39,45,50,51,41,19,9,264,28,292,9.58904109589041
26592,330560405000020,58,71,69,72,74,40,25,34,384,59,443,13.318284424379232
26593,330560405000021,79,100,87,80,91,53,44,40,490,84,574,14.634146341463415
26594,330560405000022,95,102,69,77,64,43,26,26,450,52,502,10.358565737051793
26595,330560405000023,109,146,94,116,92,46,40,38,603,78,681,11.45374449339207
26596,330560405000024,79,114,71,89,69,41,34,40,463,74,537,13.780260707635009
26597,330560405000025,55,62,63,56,59,38,26,34,333,60,393,15.267175572519085
26598,330560405000026,61,78,91,61,66,41,38,27,398,65,463,14.038876889848812
26599,330560405000027,29,56,37,44,28,44,12,9,238,21,259,8.108108108108109
26600,330560405000028,38,57,45,32,44,15,9,11,231,20,251,7.968127490039841
26601,330560405000029,39,52,29,42,30,22,16,9,214,25,239,10.460251046025105
26602,330560405000030,48,56,62,45,48,51,28,15,310,43,353,12.181303116147308
26603,330560405000031,55,44,44,31,23,24,6,5,221,11,232,4.741379310344827
26604,330560405000032,68,64,53,64,37,47,28,15,333,43,376,11.436170212765957
26605,330560405000033,69,90,66,57,59,44,36,25,385,61,446,13.67713004484305
26606,330560405000034,94,105,91,69,70,65,26,26,494,52,546,9.523809523809524
26607,330560405000035,83,109,84,85,57,45,28,18,463,46,509,9.037328094302554
26608,330560405000036,130,146,107,112,83,58,40,34,636,74,710,10.422535211267606
26609,330560405000038,129,168,97,116,64,54,19,24,628,43,671,6.408345752608048
26610,330560405000039,26,42,39,33,35,20,15,11,195,26,221,11.764705882352942
26611,330560410000001,21,17,22,24,16,14,13,8,114,21,135,15.555555555555555
26612,330560410000002,18,34,30,18,29,14,7,1,143,8,151,5.298013245033113
26613,330560410000003,39,35,40,49,42,36,29,12,241,41,282,14.539007092198581
26614,330560415000001,6,7,9,9,10,7,3,3,48,6,54,11.11111111111111
26615,330560415000002,49,64,54,38,37,29,29,17,271,46,317,14.511041009463723
26616,330560415000003,5,14,0,7,5,5,3,0,36,3,39,7.6923076923076925
26617,330560420000001,44,50,72,63,57,50,35,26,336,61,397,15.365239294710328
26619,330560420000004,6,7,6,5,3,4,0,3,31,3,34,8.823529411764707
26620,330560420000005,37,54,37,66,44,35,31,19,273,50,323,15.479876160990711
26622,330560420000007,19,23,16,11,28,27,15,2,124,17,141,12.056737588652481
26623,330570305000001,60,80,115,86,84,88,55,67,513,122,635,19.212598425196852
26624,330570305000002,59,92,109,91,106,66,50,24,523,74,597,12.39530988274707
26625,330570305000003,79,107,102,90,85,58,36,41,521,77,598,12.876254180602007
26626,330570305000004,53,63,83,65,56,40,26,21,360,47,407,11.547911547911548
26627,330570305000005,39,40,35,34,36,23,26,11,207,37,244,15.163934426229508
26628,330570305000006,43,53,56,46,46,42,20,18,286,38,324,11.728395061728396
26629,330570305000007,78,117,95,95,111,71,53,40,567,93,660,14.090909090909092
26630,330570305000008,92,122,132,121,123,96,35,38,686,73,759,9.617918313570488
26631,330570305000009,70,66,64,58,73,63,23,13,394,36,430,8.372093023255815
26632,330570305000010,20,23,28,25,21,21,9,11,138,20,158,12.658227848101266
26633,330570305000011,50,62,76,73,68,63,30,47,392,77,469,16.417910447761194
26634,330570305000012,32,46,55,41,31,39,11,13,244,24,268,8.955223880597014
26635,330570305000013,58,94,70,97,61,53,30,22,433,52,485,10.721649484536082
26636,330570305000014,103,141,158,140,121,90,46,41,753,87,840,10.357142857142858
26637,330570305000015,5,3,4,4,7,3,6,2,26,8,34,23.529411764705884
26638,330570305000016,14,24,28,26,22,17,10,5,131,15,146,10.273972602739725
26639,330570305000017,16,12,25,10,10,17,3,7,90,10,100,10.0
26640,330570305000018,28,33,48,29,40,25,11,11,203,22,225,9.777777777777779
26641,330570310000001,91,92,123,120,80,67,28,16,573,44,617,7.13128038897893
26642,330570310000002,98,103,113,114,73,68,47,28,569,75,644,11.645962732919255
26643,330570310000003,94,148,130,110,113,68,33,22,663,55,718,7.66016713091922
26644,330570310000004,164,175,195,169,136,106,45,40,945,85,1030,8.25242718446602
26645,330570310000005,27,33,37,32,25,19,10,17,173,27,200,13.5
26646,330570310000006,83,97,90,83,66,44,27,23,463,50,513,9.746588693957115
26647,330570315000001,25,25,36,28,44,16,12,9,174,21,195,10.76923076923077
26648,330570315000002,16,35,17,25,20,28,16,14,141,30,171,17.54385964912281
26649,330570315000003,8,20,8,22,17,8,7,4,83,11,94,11.702127659574469
26650,330570315000005,12,23,12,19,18,8,1,2,92,3,95,3.1578947368421053
26651,330570315000006,8,14,6,7,7,2,4,0,44,4,48,8.333333333333334
26652,330570315000007,32,34,27,45,34,17,9,11,189,20,209,9.569377990430622
26653,330570315000008,17,31,21,22,22,14,7,7,127,14,141,9.929078014184396
26654,330570325000001,8,9,6,16,5,2,3,1,46,4,50,8.0
26655,330570325000002,21,20,21,27,23,10,12,7,122,19,141,13.47517730496454
26656,330570325000003,115,151,146,128,113,67,34,19,720,53,773,6.85640362225097
26657,330570325000004,135,157,140,147,133,58,34,38,770,72,842,8.551068883610451
26658,330570325000005,35,36,44,34,27,27,14,7,203,21,224,9.375
26659,330570325000006,124,115,118,96,87,50,27,14,590,41,631,6.497622820919176
26660,330570325000007,37,35,31,22,26,21,6,7,172,13,185,7.027027027027027
26661,330575205000001,60,70,81,75,53,44,33,30,383,63,446,14.125560538116591
26662,330575205000002,51,71,57,80,37,47,26,17,343,43,386,11.139896373056995
26663,330575205000003,131,164,179,159,131,85,50,36,849,86,935,9.197860962566844
26664,330575205000004,102,98,103,117,89,65,53,26,574,79,653,12.09800918836141
26665,330575205000005,135,195,160,173,121,102,40,37,886,77,963,7.995846313603323
26666,330575205000006,118,108,121,135,109,69,64,43,660,107,767,13.95045632333768
26667,330575205000007,46,79,58,85,75,49,36,39,392,75,467,16.059957173447536
26668,330575205000008,55,56,59,60,58,32,23,17,320,40,360,11.11111111111111
26669,330575205000009,55,64,86,88,59,36,31,24,388,55,443,12.415349887133182
26670,330575205000010,121,121,145,133,108,90,51,46,718,97,815,11.901840490797547
26671,330575205000011,123,143,147,147,125,78,29,21,763,50,813,6.150061500615006
26672,330575205000012,14,16,10,14,5,9,3,0,68,3,71,4.225352112676056
26673,330575205000013,127,168,174,161,145,104,60,42,879,102,981,10.397553516819572
26674,330575205000014,15,35,11,24,19,15,19,14,119,33,152,21.710526315789473
26675,330575205000015,120,159,126,118,103,85,49,37,711,86,797,10.790464240903388
26676,330575205000016,67,87,89,70,73,56,28,24,442,52,494,10.526315789473685
26677,330575205000017,143,155,141,130,101,93,56,32,763,88,851,10.340775558166863
26678,330575205000018,61,54,92,59,42,42,31,18,350,49,399,12.280701754385966
26679,330575205000019,159,172,127,158,113,67,41,24,796,65,861,7.549361207897793
26680,330575205000020,226,260,229,222,148,106,72,30,1191,102,1293,7.888631090487239
26681,330575205000021,119,115,115,120,94,67,28,31,630,59,689,8.563134978229318
26682,330575205000022,102,97,120,102,91,67,53,26,579,79,658,12.006079027355623
26683,330575205000023,63,92,85,96,99,72,25,28,507,53,560,9.464285714285714
26684,330575205000024,18,17,35,16,19,20,6,6,125,12,137,8.75912408759124
26685,330575205000025,227,206,240,202,149,129,48,44,1153,92,1245,7.389558232931727
26686,330575205000026,57,80,85,74,46,32,19,7,374,26,400,6.5
26687,330575205000027,171,206,164,149,103,73,57,20,866,77,943,8.16542948038176
26688,330575205000028,20,36,23,20,23,19,12,5,141,17,158,10.759493670886076
26689,330575205000029,120,132,110,123,87,52,25,15,624,40,664,6.024096385542169
26690,330575205000030,147,178,164,161,109,77,47,39,836,86,922,9.327548806941431
26691,330575205000031,19,38,21,30,21,11,7,7,140,14,154,9.090909090909092
26692,330575205000032,21,27,46,34,23,33,11,22,184,33,217,15.2073732718894
26693,330575205000033,56,82,87,118,93,96,62,22,532,84,616,13.636363636363637
26694,330575205000034,88,95,122,70,109,77,30,19,561,49,610,8.032786885245901
26695,330575205000035,49,77,54,52,53,32,22,24,317,46,363,12.672176308539944
26696,330575205000036,66,94,57,70,50,29,22,13,366,35,401,8.728179551122194
26697,330575205000037,88,110,112,104,88,60,39,18,562,57,619,9.208400646203554
26698,330575205000038,81,76,86,89,68,56,36,25,456,61,517,11.798839458413926
26699,330575205000039,67,99,78,90,69,61,26,25,464,51,515,9.902912621359222
26700,330575205000040,65,68,47,80,49,33,23,14,342,37,379,9.762532981530343
26701,330575205000041,70,102,64,106,64,38,27,20,444,47,491,9.572301425661914
26702,330575205000042,31,30,37,40,25,32,26,14,195,40,235,17.02127659574468
26703,330575205000043,27,48,47,39,36,26,19,15,223,34,257,13.229571984435797
26704,330575205000044,59,85,88,82,79,56,47,47,449,94,543,17.311233885819522
26705,330575205000045,20,31,39,31,43,32,27,29,196,56,252,22.22222222222222
26706,330575205000046,30,37,43,33,45,21,15,18,209,33,242,13.636363636363637
26707,330575205000047,97,129,117,124,102,83,61,40,652,101,753,13.413014608233732
26708,330575205000048,51,77,61,65,68,58,43,39,380,82,462,17.748917748917748
26709,330575205000049,23,30,21,29,28,23,16,3,154,19,173,10.982658959537572
26710,330575205000050,33,51,32,42,40,18,33,13,216,46,262,17.557251908396946
26711,330575205000051,4,13,4,7,12,5,2,3,45,5,50,10.0
26712,330575205000053,27,45,20,33,29,15,8,8,169,16,185,8.64864864864865
26714,330575205000055,114,120,123,113,76,73,61,47,619,108,727,14.855570839064649
26715,330575205000056,89,97,88,72,56,46,39,27,448,66,514,12.84046692607004
26716,330575205000057,13,20,10,17,8,5,1,3,73,4,77,5.194805194805195
26717,330575205000058,5,5,7,6,6,9,5,2,38,7,45,15.555555555555555
26719,330575205000060,23,25,23,24,20,16,12,3,131,15,146,10.273972602739725
26721,330575205000062,13,7,11,7,11,8,3,0,57,3,60,5.0
26722,330575205000063,35,53,47,59,37,34,21,11,265,32,297,10.774410774410775
26724,330575205000065,3,9,8,4,8,4,6,0,36,6,42,14.285714285714286
26725,330575205000066,48,65,60,50,52,37,27,21,312,48,360,13.333333333333334
26726,330575205000067,12,37,35,35,28,36,21,15,183,36,219,16.438356164383563
26727,330575205000068,18,16,20,19,15,11,14,9,99,23,122,18.852459016393443
26728,330575205000069,1,13,5,7,11,7,5,1,44,6,50,12.0
26729,330575205000070,55,63,45,63,28,18,12,3,272,15,287,5.2264808362369335
26730,330580205000001,84,106,85,106,97,71,64,67,549,131,680,19.264705882352942
26731,330580205000002,61,58,69,101,61,70,55,75,420,130,550,23.636363636363637
26732,330580205000003,38,72,88,58,68,74,83,96,398,179,577,31.022530329289427
26733,330580205000004,33,52,45,57,65,58,39,50,310,89,399,22.305764411027567
26734,330580205000005,25,27,46,35,36,42,37,64,211,101,312,32.37179487179487
26735,330580205000006,69,97,68,73,113,75,77,97,495,174,669,26.00896860986547
26736,330580205000007,41,81,90,91,112,70,75,85,485,160,645,24.8062015503876
26737,330580205000008,39,71,81,62,70,80,62,67,403,129,532,24.24812030075188
26738,330580205000009,38,65,64,64,89,86,94,138,406,232,638,36.36363636363637
26739,330580205000010,39,47,75,70,52,78,46,74,361,120,481,24.948024948024948
26740,330580205000011,53,48,62,72,42,62,38,45,339,83,422,19.66824644549763
26741,330580205000012,65,72,91,86,98,101,71,78,513,149,662,22.507552870090635
26742,330580205000013,39,45,77,88,55,68,62,52,372,114,486,23.45679012345679
26743,330580205000014,23,24,45,30,41,59,48,77,222,125,347,36.023054755043226
26744,330580205000015,34,52,51,55,62,67,49,57,321,106,427,24.824355971896956
26745,330580205000016,9,16,26,17,29,25,22,37,122,59,181,32.59668508287293
26746,330580205000017,55,52,69,76,79,51,35,46,382,81,463,17.49460043196544
26747,330580205000018,42,77,71,67,62,42,48,44,361,92,453,20.309050772626932
26748,330580205000019,21,31,74,39,34,31,17,23,230,40,270,14.814814814814815
26749,330580205000020,16,31,121,36,45,25,29,32,274,61,335,18.208955223880597
26750,330580205000021,69,98,155,135,136,104,149,125,697,274,971,28.218331616889806
26751,330580205000022,17,63,129,32,48,31,22,42,320,64,384,16.666666666666668
26752,330580205000023,22,84,123,40,57,46,39,56,372,95,467,20.342612419700213
26753,330580205000024,40,65,105,47,69,41,27,26,367,53,420,12.619047619047619
26754,330580205000025,79,109,120,106,105,71,68,42,590,110,700,15.714285714285714
26755,330580205000026,8,35,47,23,28,37,26,22,178,48,226,21.238938053097346
26756,330580205000027,37,50,47,45,39,33,17,23,251,40,291,13.745704467353951
26757,330580205000028,9,18,39,19,25,26,22,34,136,56,192,29.166666666666668
26758,330580205000029,26,52,58,33,39,54,44,42,262,86,348,24.71264367816092
26759,330580205000030,22,39,36,43,55,44,34,51,239,85,324,26.234567901234566
26760,330580205000031,40,62,45,49,53,31,27,15,280,42,322,13.043478260869565
26761,330580205000032,120,131,163,169,141,92,92,83,816,175,991,17.658930373360242
26762,330580205000033,235,320,220,194,143,134,87,52,1246,139,1385,10.036101083032491
26763,330580205000034,74,97,104,92,99,59,39,24,525,63,588,10.714285714285714
26764,330580205000035,87,120,124,127,113,97,75,87,668,162,830,19.518072289156628
26765,330580205000036,130,178,141,131,129,108,64,58,817,122,939,12.992545260915868
26766,330580205000037,116,122,187,171,137,136,101,75,869,176,1045,16.842105263157894
26767,330580205000038,87,105,122,95,123,94,73,66,626,139,765,18.169934640522875
26768,330580205000039,96,111,100,107,90,68,62,29,572,91,663,13.72549019607843
26769,330580205000040,120,162,157,123,111,65,45,32,738,77,815,9.447852760736197
26770,330580205000041,357,323,431,221,138,122,79,67,1592,146,1738,8.400460299194476
26771,330580205000042,75,108,77,79,55,41,29,23,435,52,487,10.677618069815194
26772,330580205000043,179,212,154,130,133,78,43,24,886,67,953,7.030430220356768
26773,330580205000044,83,107,76,97,85,73,52,57,521,109,630,17.3015873015873
26774,330580205000045,97,136,133,127,112,91,64,45,696,109,805,13.540372670807454
26775,330580205000046,87,111,67,104,100,95,70,47,564,117,681,17.180616740088105
26776,330580205000047,114,146,148,151,158,121,97,91,838,188,1026,18.323586744639375
26777,330580205000048,188,187,201,189,165,133,80,57,1063,137,1200,11.416666666666666
26778,330580205000049,109,164,233,170,145,102,84,73,923,157,1080,14.537037037037036
26779,330580205000050,120,135,139,162,157,115,120,63,828,183,1011,18.100890207715132
26780,330580205000051,87,163,145,157,157,177,111,125,886,236,1122,21.033868092691623
26781,330580205000052,74,92,108,105,111,90,55,32,580,87,667,13.043478260869565
26782,330580205000053,49,92,110,81,94,71,45,40,497,85,582,14.604810996563574
26783,330580205000054,88,137,104,122,151,119,72,54,721,126,847,14.87603305785124
26784,330580205000055,149,201,134,135,157,90,51,30,866,81,947,8.553326293558607
26785,330580205000056,128,174,149,132,92,90,49,33,765,82,847,9.681227863046045
26786,330580205000057,98,198,282,280,246,168,81,39,1272,120,1392,8.620689655172415
26787,330580205000058,43,62,50,54,50,35,36,21,294,57,351,16.23931623931624
26788,330580205000060,24,30,25,23,23,23,26,28,148,54,202,26.73267326732673
26789,330580205000061,39,57,68,57,69,89,41,35,379,76,455,16.703296703296704
26790,330580205000062,27,48,43,34,64,66,44,28,282,72,354,20.338983050847457
26791,330580205000063,214,264,221,199,176,117,75,55,1191,130,1321,9.841029523088569
26792,330580205000064,217,331,280,317,347,141,148,152,1633,300,1933,15.519917227108122
26793,330580205000065,58,63,72,74,66,49,28,21,382,49,431,11.368909512761022
26794,330580205000067,126,152,118,118,98,67,37,20,679,57,736,7.744565217391305
26795,330580205000068,160,202,206,258,197,173,100,80,1196,180,1376,13.081395348837209
26796,330580205000069,102,124,131,113,124,89,48,43,683,91,774,11.757105943152455
26797,330580205000070,133,165,199,209,138,137,75,75,981,150,1131,13.26259946949602
26798,330580205000071,149,159,169,169,144,111,56,52,901,108,1009,10.70366699702676
26799,330580205000072,152,237,220,199,185,146,84,64,1139,148,1287,11.4996114996115
26800,330580205000073,66,54,74,59,52,50,33,35,355,68,423,16.07565011820331
26801,330580205000074,39,39,46,61,69,67,42,46,321,88,409,21.5158924205379
26802,330580205000075,152,184,165,171,157,139,74,47,968,121,1089,11.11111111111111
26803,330580205000076,144,161,157,163,153,121,70,56,899,126,1025,12.292682926829269
26806,330580205000079,112,102,100,126,87,82,59,40,609,99,708,13.983050847457626
26807,330580205000080,119,151,144,145,140,142,67,58,841,125,966,12.939958592132506
26808,330580205000081,116,156,110,133,131,88,66,30,734,96,830,11.566265060240964
26809,330580205000082,36,88,44,53,92,58,51,32,371,83,454,18.281938325991188
26810,330580205000083,21,35,33,34,40,38,27,16,201,43,244,17.62295081967213
26811,330580205000084,56,83,67,90,104,72,62,49,472,111,583,19.039451114922812
26812,330580205000085,47,79,76,58,65,49,20,11,374,31,405,7.654320987654321
26813,330580205000086,98,139,131,127,121,98,55,54,714,109,823,13.24422843256379
26814,330580205000087,34,47,53,56,47,43,42,50,280,92,372,24.731182795698924
26815,330580205000088,191,213,229,222,153,139,85,39,1147,124,1271,9.75609756097561
26816,330580205000089,106,191,161,150,149,103,75,59,860,134,994,13.480885311871228
26817,330580205000090,88,146,93,122,146,118,67,84,713,151,864,17.47685185185185
26818,330580205000091,73,95,112,112,117,114,117,104,623,221,844,26.18483412322275
26819,330580205000092,57,74,65,76,80,53,45,51,405,96,501,19.161676646706585
26820,330580205000093,82,65,71,107,108,90,91,113,523,204,727,28.060522696011002
26821,330580205000094,36,45,48,51,55,50,29,40,285,69,354,19.491525423728813
26822,330580205000095,49,66,47,64,69,69,48,72,364,120,484,24.793388429752067
26823,330580205000096,41,41,48,61,56,67,64,81,314,145,459,31.59041394335512
26824,330580205000097,32,74,66,63,64,67,31,40,366,71,437,16.247139588100687
26825,330580205000098,72,81,80,94,78,65,39,52,470,91,561,16.221033868092693
26826,330580205000099,156,202,218,187,211,149,82,66,1123,148,1271,11.644374508261212
26827,330580205000100,42,45,50,45,69,47,27,24,298,51,349,14.613180515759312
26828,330580205000101,34,41,50,41,39,42,39,29,247,68,315,21.58730158730159
26829,330580205000102,61,97,82,82,68,48,35,17,438,52,490,10.612244897959183
26830,330580205000103,61,82,60,81,93,61,62,40,438,102,540,18.88888888888889
26831,330580205000104,68,81,96,132,132,99,56,49,608,105,713,14.726507713884994
26832,330580205000105,157,188,210,197,193,166,88,71,1111,159,1270,12.51968503937008
26833,330580205000106,73,113,193,109,111,113,68,71,712,139,851,16.333725029377202
26834,330580205000107,74,104,139,124,145,110,80,89,696,169,865,19.53757225433526
26835,330580205000108,122,171,144,175,153,134,85,90,899,175,1074,16.294227188081937
26836,330580205000109,135,235,200,164,233,113,50,86,1080,136,1216,11.18421052631579
26837,330580205000110,31,39,33,34,40,18,26,20,195,46,241,19.08713692946058
26838,330580205000111,42,60,62,41,66,65,35,37,336,72,408,17.647058823529413
26839,330580205000112,146,152,135,126,109,102,45,62,770,107,877,12.200684150513112
26840,330580205000113,63,109,55,105,135,103,79,25,570,104,674,15.43026706231454
26841,330580205000114,91,138,97,96,91,98,44,33,611,77,688,11.19186046511628
26842,330580205000115,157,158,167,203,165,132,90,74,982,164,1146,14.31064572425829
26843,330580205000116,160,170,136,140,118,74,50,21,798,71,869,8.170310701956272
26844,330580205000117,173,178,155,150,135,99,53,52,890,105,995,10.552763819095478
26845,330580205000118,27,59,30,38,47,21,24,6,222,30,252,11.904761904761905
26846,330580205000119,164,215,252,232,151,174,140,54,1188,194,1382,14.037626628075254
26847,330580205000120,35,63,43,47,68,47,38,28,303,66,369,17.88617886178862
26848,330580205000121,39,61,48,57,66,52,39,17,323,56,379,14.775725593667547
26849,330580205000122,54,57,52,61,46,36,23,11,306,34,340,10.0
26850,330580205000123,156,210,197,145,131,112,70,45,951,115,1066,10.787992495309568
26851,330580205000124,181,214,211,219,189,149,95,33,1163,128,1291,9.914794732765298
26852,330580205000125,355,461,370,348,285,239,126,82,2058,208,2266,9.179170344218887
26853,330580205000126,124,160,124,136,126,85,50,31,755,81,836,9.688995215311005
26854,330580205000127,54,65,62,85,68,52,40,25,386,65,451,14.412416851441241
26855,330580205000128,240,278,229,220,183,116,66,45,1266,111,1377,8.061002178649238
26856,330580205000129,164,226,192,148,144,96,54,26,970,80,1050,7.619047619047619
26857,330580205000130,93,155,116,132,106,89,56,32,691,88,779,11.296534017971759
26858,330580205000131,96,126,193,150,136,124,60,28,825,88,913,9.63855421686747
26859,330580205000132,132,143,147,117,119,76,47,29,734,76,810,9.382716049382717
26860,330580205000133,31,31,32,23,23,19,7,6,159,13,172,7.558139534883721
26861,330580205000134,40,62,60,60,67,50,40,40,339,80,419,19.09307875894988
26862,330580205000135,69,89,75,67,58,35,25,16,393,41,434,9.44700460829493
26863,330580205000136,81,119,97,84,91,63,35,24,535,59,594,9.932659932659933
26864,330580205000137,86,82,106,73,91,63,47,28,501,75,576,13.020833333333334
26865,330580205000138,156,176,189,179,138,104,71,44,942,115,1057,10.879848628192999
26866,330580205000139,55,79,69,74,75,74,45,42,426,87,513,16.95906432748538
26867,330580205000140,97,138,125,140,117,128,84,56,745,140,885,15.819209039548022
26868,330580205000141,85,109,97,99,96,63,44,37,549,81,630,12.857142857142858
26869,330580205000142,298,335,268,246,212,138,57,52,1497,109,1606,6.787048567870485
26870,330580205000143,115,137,125,82,98,77,44,31,634,75,709,10.578279266572638
26871,330580205000144,102,131,111,131,88,82,54,34,645,88,733,12.005457025920872
26872,330580205000145,149,196,190,211,175,156,109,92,1077,201,1278,15.727699530516432
26873,330580205000146,73,105,113,99,111,76,62,50,577,112,689,16.25544267053701
26874,330580205000147,95,121,126,129,114,101,68,52,686,120,806,14.88833746898263
26875,330580205000148,70,75,94,110,71,75,51,51,495,102,597,17.08542713567839
26876,330580205000149,304,378,350,293,232,141,112,56,1698,168,1866,9.003215434083602
26877,330580205000150,173,227,236,168,133,115,68,45,1052,113,1165,9.699570815450643
26878,330580205000151,90,91,122,86,65,58,26,23,512,49,561,8.73440285204991
26879,330580205000152,359,404,373,257,244,176,89,49,1813,138,1951,7.073295745771399
26880,330580205000153,81,125,120,112,125,103,55,54,666,109,775,14.064516129032258
26881,330580205000154,88,161,124,131,143,105,61,50,752,111,863,12.862108922363847
26882,330580205000155,145,177,141,135,125,96,60,39,819,99,918,10.784313725490197
26883,330580205000156,533,795,611,535,602,318,317,122,3394,439,3833,11.453169840855727
26884,330580205000157,91,91,107,130,78,62,37,14,559,51,610,8.360655737704919
26885,330580205000158,152,175,165,154,142,103,65,40,891,105,996,10.542168674698795
26886,330580205000159,373,433,339,322,268,200,116,64,1935,180,2115,8.51063829787234
26887,330580205000160,247,278,251,224,196,165,71,48,1361,119,1480,8.04054054054054
26888,330580205000161,62,81,64,85,51,35,27,15,378,42,420,10.0
26889,330580205000162,216,196,156,149,111,77,47,46,905,93,998,9.318637274549099
26890,330580205000163,195,218,182,184,171,92,59,31,1042,90,1132,7.950530035335689
26891,330580205000165,135,162,154,122,119,94,55,29,786,84,870,9.655172413793103
26892,330580205000166,127,150,137,150,124,98,50,41,786,91,877,10.376282782212087
26893,330580205000167,66,89,98,88,84,72,41,25,497,66,563,11.72291296625222
26894,330580205000168,25,26,19,23,31,30,23,6,154,29,183,15.846994535519126
26895,330580205000169,45,67,47,55,54,40,18,10,308,28,336,8.333333333333334
26896,330580205000170,128,136,147,148,129,100,60,37,788,97,885,10.96045197740113
26898,330580205000172,45,53,54,71,63,46,24,30,332,54,386,13.989637305699482
26899,330580205000173,57,75,66,68,54,45,24,23,365,47,412,11.407766990291263
26900,330580205000174,33,45,54,38,37,53,35,26,260,61,321,19.003115264797508
26901,330580205000175,95,105,96,88,88,69,36,31,541,67,608,11.019736842105264
26902,330580205000176,21,36,22,52,80,75,84,37,286,121,407,29.72972972972973
26903,330580205000177,19,34,37,30,55,55,21,26,230,47,277,16.967509025270758
26904,330580205000178,3,11,1,19,22,6,7,0,62,7,69,10.144927536231885
26905,330580205000179,64,95,90,61,60,22,16,9,392,25,417,5.995203836930456
26906,330580205000180,76,89,82,60,54,36,20,20,397,40,437,9.153318077803204
26907,330580205000181,76,97,69,68,68,65,40,30,443,70,513,13.645224171539962
26908,330580205000182,56,63,69,70,68,69,53,61,395,114,509,22.396856581532415
26909,330580205000183,37,67,48,61,65,49,38,37,327,75,402,18.65671641791045
26910,330580205000184,32,37,35,33,51,42,23,23,230,46,276,16.666666666666668
26911,330580205000185,110,142,134,124,114,108,60,46,732,106,838,12.649164677804295
26912,330580205000186,29,27,19,33,39,25,21,20,172,41,213,19.248826291079812
26913,330580210000001,88,116,74,94,95,43,33,35,510,68,578,11.764705882352942
26914,330580210000002,159,179,152,198,153,113,64,48,954,112,1066,10.50656660412758
26915,330580210000003,85,114,103,82,104,53,38,24,541,62,603,10.281923714759536
26916,330580210000004,50,76,69,63,66,45,27,22,369,49,418,11.722488038277511
26917,330580210000005,72,84,84,82,95,56,29,27,473,56,529,10.58601134215501
26918,330580210000006,24,35,20,36,25,7,4,0,147,4,151,2.6490066225165565
26919,330580210000007,23,27,13,21,14,8,4,4,106,8,114,7.017543859649122
26920,330580210000008,18,18,16,16,16,11,2,5,95,7,102,6.862745098039215
26921,330580210000009,40,44,45,28,18,15,9,9,190,18,208,8.653846153846153
26922,330580210000010,33,44,37,41,42,28,18,17,225,35,260,13.461538461538462
26923,330580210000011,149,209,206,178,129,86,41,37,957,78,1035,7.536231884057971
26924,330580210000012,163,208,188,175,165,114,38,44,1013,82,1095,7.488584474885845
26925,330580210000013,107,142,100,116,101,72,21,26,638,47,685,6.861313868613139
26926,330580210000014,119,125,96,97,66,62,21,25,565,46,611,7.528641571194763
26927,330580210000015,81,106,63,75,63,33,15,14,421,29,450,6.444444444444445
26928,330580210000016,78,91,85,64,73,43,14,15,434,29,463,6.263498920086393
26929,330580210000017,1,11,6,30,15,16,9,0,79,9,88,10.227272727272727
26931,330580210000019,73,143,102,85,106,65,47,38,574,85,659,12.898330804248863
26932,330580210000020,112,156,83,150,134,65,34,25,700,59,759,7.7733860342556
26933,330580210000021,79,105,110,91,93,60,29,23,538,52,590,8.813559322033898
26934,330580210000022,85,121,92,76,82,54,24,23,510,47,557,8.43806104129264
26935,330580210000023,60,82,64,69,53,38,20,11,366,31,397,7.8085642317380355
26936,330580210000024,111,135,123,113,118,77,42,45,677,87,764,11.387434554973822
26937,330580210000025,285,302,307,278,219,147,64,61,1538,125,1663,7.516536380036079
26938,330580210000026,153,177,150,176,137,92,71,35,885,106,991,10.696266397578205
26939,330580210000027,261,260,248,213,169,150,85,71,1301,156,1457,10.706932052161976
26940,330580215000001,365,339,335,254,168,144,88,90,1605,178,1783,9.983174425126192
26941,330580215000002,35,52,28,27,22,22,9,10,186,19,205,9.268292682926829
26942,330580215000003,126,156,121,139,130,113,61,61,785,122,907,13.450937155457552
26943,330580215000004,103,96,82,67,43,56,30,16,447,46,493,9.330628803245435
26944,330580215000005,53,66,47,53,41,37,30,18,297,48,345,13.91304347826087
26945,330580215000006,18,12,30,24,16,13,9,12,113,21,134,15.671641791044776
26946,330580215000007,41,52,52,44,35,40,9,8,264,17,281,6.049822064056939
26947,330580215000008,24,33,22,31,21,20,14,11,151,25,176,14.204545454545455
26948,330580215000009,219,245,225,172,200,119,60,41,1180,101,1281,7.884465261514442
26949,330580215000010,160,264,194,190,240,120,71,34,1168,105,1273,8.248232521602514
26950,330580215000011,94,103,93,100,70,69,36,16,529,52,581,8.950086058519794
26951,330580215000012,17,23,18,42,40,25,17,10,165,27,192,14.0625
26952,330580215000013,31,35,40,46,39,28,17,11,219,28,247,11.336032388663968
26953,330580215000014,24,28,41,44,27,15,11,2,179,13,192,6.770833333333333
26954,330580215000015,61,85,97,87,77,58,31,22,465,53,518,10.231660231660232
26955,330580215000016,68,73,85,73,55,34,15,21,388,36,424,8.49056603773585
26956,330580215000017,74,88,76,71,61,44,21,18,414,39,453,8.609271523178808
26957,330580215000018,72,79,97,83,78,48,33,29,457,62,519,11.946050096339114
26958,330580215000019,63,102,83,140,121,64,57,37,573,94,667,14.09295352323838
26959,330580215000020,74,81,88,76,54,50,35,25,423,60,483,12.422360248447205
26960,330580215000021,49,69,59,54,66,34,14,16,331,30,361,8.310249307479225
26961,330580215000022,44,56,50,44,47,27,18,9,268,27,295,9.152542372881356
26962,330580215000023,14,22,27,12,22,23,9,8,120,17,137,12.408759124087592
26963,330590105000001,83,86,77,78,89,58,49,41,471,90,561,16.0427807486631
26964,330590105000002,91,108,117,109,107,86,55,43,618,98,716,13.687150837988828
26965,330590105000003,88,111,127,95,108,65,33,31,594,64,658,9.72644376899696
26966,330590105000004,17,20,15,17,14,14,8,8,97,16,113,14.15929203539823
26967,330590105000005,65,66,75,56,75,51,33,31,388,64,452,14.15929203539823
26968,330590105000006,53,87,68,57,67,53,45,34,385,79,464,17.025862068965516
26969,330590105000007,110,135,122,114,132,87,45,70,700,115,815,14.110429447852761
26970,330590110000001,35,37,30,38,23,20,14,8,183,22,205,10.731707317073171
26971,330590110000002,24,32,35,26,20,22,16,13,159,29,188,15.425531914893616
26972,330590110000003,13,35,32,21,24,23,12,15,148,27,175,15.428571428571429
26973,330590110000004,18,18,11,17,13,13,9,2,90,11,101,10.891089108910892
26974,330590110000005,87,116,88,100,86,61,52,33,538,85,623,13.643659711075442
26975,330590115000001,58,71,60,82,82,54,51,34,407,85,492,17.276422764227643
26976,330590115000002,10,19,16,9,19,18,8,8,91,16,107,14.953271028037383
26977,330590115000003,16,11,10,9,12,17,3,1,75,4,79,5.063291139240507
26978,330590120000001,79,94,85,88,87,63,56,53,496,109,605,18.016528925619834
26979,330590120000002,124,162,130,154,147,133,85,76,850,161,1011,15.92482690405539
26980,330590120000003,31,47,23,46,40,31,22,18,218,40,258,15.503875968992247
26981,330590120000004,36,65,53,43,62,42,34,29,301,63,364,17.307692307692307
26982,330590125000001,138,145,167,120,130,86,68,68,786,136,922,14.750542299349242
26983,330590125000002,52,60,69,35,48,28,18,15,292,33,325,10.153846153846153
26984,330590125000003,32,32,41,29,35,21,17,24,190,41,231,17.748917748917748
26985,330590125000004,94,90,74,68,50,46,32,28,422,60,482,12.448132780082988
26986,330590125000005,29,51,49,48,68,38,25,34,283,59,342,17.251461988304094
26987,330600805000001,61,89,65,99,94,80,77,77,488,154,642,23.98753894080997
26988,330600805000002,63,74,93,84,84,92,48,56,490,104,594,17.50841750841751
26989,330600805000003,65,91,109,81,101,101,66,66,548,132,680,19.41176470588235
26990,330600805000004,54,89,73,85,114,79,67,65,494,132,626,21.08626198083067
26991,330600805000005,52,90,105,85,105,124,84,95,561,179,740,24.18918918918919
26992,330600805000006,49,88,87,72,91,92,79,81,479,160,639,25.039123630672925
26993,330600805000007,40,66,90,68,83,88,74,77,435,151,586,25.7679180887372
26994,330600805000008,66,100,97,130,123,102,107,87,618,194,812,23.891625615763548
26995,330600805000009,50,103,96,100,119,89,65,71,557,136,693,19.624819624819626
26996,330600805000010,57,81,94,93,99,104,97,68,528,165,693,23.80952380952381
26997,330600805000011,26,37,37,37,44,50,29,29,231,58,289,20.069204152249135
26998,330600805000012,113,158,155,152,164,138,76,96,880,172,1052,16.34980988593156
26999,330600805000013,68,80,129,109,117,129,75,74,632,149,781,19.07810499359795
27000,330600805000014,62,82,94,81,109,112,96,100,540,196,736,26.630434782608695
27001,330600805000015,86,96,113,115,104,96,70,40,610,110,720,15.277777777777779
27002,330600805000016,82,91,100,90,73,98,43,27,534,70,604,11.589403973509933
27003,330600805000017,118,125,122,129,119,77,59,42,690,101,791,12.768647281921618
27004,330600805000018,57,90,98,82,114,89,58,57,530,115,645,17.829457364341085
27005,330600805000019,121,132,158,128,124,119,65,34,782,99,881,11.237230419977298
27006,330600805000020,89,114,101,89,87,90,50,35,570,85,655,12.977099236641221
27007,330600805000021,97,102,131,112,122,80,64,34,644,98,742,13.20754716981132
27008,330600805000022,87,143,119,107,110,112,44,35,678,79,757,10.435931307793924
27009,330600805000023,173,191,219,144,170,128,76,64,1025,140,1165,12.017167381974248
27010,330600805000024,117,106,129,130,116,69,56,48,667,104,771,13.488975356679637
27011,330600805000025,131,157,172,147,120,117,53,30,844,83,927,8.95361380798274
27012,330600805000026,92,103,118,108,97,79,41,31,597,72,669,10.762331838565023
27013,330600805000027,102,130,155,123,123,151,78,29,784,107,891,12.008978675645343
27014,330600805000028,87,109,127,113,109,123,62,62,668,124,792,15.656565656565656
27015,330600805000029,119,174,140,150,152,129,79,57,864,136,1000,13.6
27016,330600805000030,60,79,91,77,82,66,32,22,455,54,509,10.609037328094303
27017,330600805000031,91,91,97,77,82,78,28,32,516,60,576,10.416666666666666
27018,330600805000032,101,145,172,98,163,144,84,67,823,151,974,15.503080082135524
27019,330600805000033,91,112,123,101,104,94,57,47,625,104,729,14.266117969821673
27020,330600805000034,83,101,128,81,101,78,52,36,572,88,660,13.333333333333334
27021,330600805000035,117,138,104,113,76,74,46,19,622,65,687,9.461426491994178
27022,330600805000036,104,114,105,97,79,68,53,37,567,90,657,13.698630136986301
27023,330600805000037,111,144,135,116,106,71,47,25,683,72,755,9.536423841059603
27024,330600805000038,98,99,126,95,85,72,44,46,575,90,665,13.533834586466165
27025,330600805000039,115,124,126,96,93,62,31,25,616,56,672,8.333333333333334
27026,330600805000040,88,100,75,75,65,37,26,14,440,40,480,8.333333333333334
27027,330600805000041,69,57,70,37,62,29,22,8,324,30,354,8.474576271186441
27028,330600805000042,130,130,105,92,86,52,31,11,595,42,637,6.593406593406593
27029,330600805000043,81,111,105,96,75,70,40,31,538,71,609,11.658456486042693
27030,330600805000044,105,120,111,112,83,61,34,23,592,57,649,8.782742681047766
27031,330600805000045,71,81,91,88,93,75,59,29,499,88,587,14.991482112436115
27032,330600805000046,64,117,78,87,84,55,53,36,485,89,574,15.505226480836237
27033,330600805000047,62,86,68,65,62,35,19,8,378,27,405,6.666666666666667
27034,330600805000048,71,80,70,58,53,37,26,12,369,38,407,9.336609336609337
27035,330600805000049,92,83,121,81,57,58,19,18,492,37,529,6.994328922495274
27036,330600805000050,121,113,113,133,123,87,65,38,690,103,793,12.988650693568726
27037,330600805000051,151,169,174,162,159,109,55,49,924,104,1028,10.116731517509727
27038,330600805000052,50,65,78,51,69,43,50,26,356,76,432,17.59259259259259
27039,330600805000053,77,83,115,79,97,101,38,36,552,74,626,11.821086261980831
27040,330600805000054,70,118,71,69,110,75,67,50,513,117,630,18.571428571428573
27041,330600805000055,96,101,166,189,85,93,38,23,730,61,791,7.711757269279393
27042,330600805000056,78,88,78,78,70,38,37,17,430,54,484,11.15702479338843
27043,330600805000057,149,164,161,148,141,101,53,54,864,107,971,11.019567456230691
27044,330600805000058,76,121,103,104,101,112,46,58,617,104,721,14.424410540915396
27045,330600805000059,94,119,99,81,108,91,57,42,592,99,691,14.327062228654125
27046,330600805000060,107,124,131,110,109,110,74,52,691,126,817,15.422276621787026
27047,330600805000061,121,134,153,121,110,116,45,37,755,82,837,9.79689366786141
27048,330600805000062,112,136,149,111,141,93,44,37,742,81,823,9.842041312272174
27049,330600805000063,117,157,170,142,126,116,55,34,828,89,917,9.70556161395856
27050,330600805000064,146,150,155,141,131,93,60,42,816,102,918,11.11111111111111
27051,330600805000065,55,99,101,66,92,75,43,32,488,75,563,13.321492007104796
27052,330600805000066,78,116,103,95,83,54,38,23,529,61,590,10.338983050847459
27053,330600805000067,99,122,116,109,95,72,37,42,613,79,692,11.416184971098266
27054,330600805000068,162,171,132,168,123,95,58,35,851,93,944,9.851694915254237
27055,330600805000069,81,100,88,65,59,29,15,13,422,28,450,6.222222222222222
27056,330600805000070,82,122,118,103,78,93,52,35,596,87,683,12.73792093704246
27057,330600805000071,87,95,101,66,70,67,35,27,486,62,548,11.313868613138686
27058,330600805000072,86,131,104,99,118,68,54,41,606,95,701,13.552068473609129
27059,330600805000073,88,117,96,100,99,80,52,30,580,82,662,12.386706948640484
27060,330600805000074,117,160,119,132,98,70,40,24,696,64,760,8.421052631578947
27061,330600805000075,29,82,67,51,70,50,37,44,349,81,430,18.837209302325583
27062,330600805000076,113,123,118,128,107,83,57,36,672,93,765,12.156862745098039
27063,330600805000077,67,95,106,91,97,75,60,46,531,106,637,16.64050235478807
27064,330600805000078,52,95,71,88,83,59,53,34,448,87,535,16.261682242990656
27065,330600805000079,82,92,125,147,96,102,47,37,644,84,728,11.538461538461538
27066,330600805000080,93,87,127,144,102,62,26,16,615,42,657,6.392694063926941
27067,330600805000081,135,162,91,113,87,48,42,19,636,61,697,8.751793400286944
27068,330600805000082,161,178,168,139,125,103,56,25,874,81,955,8.481675392670157
27069,330600805000083,167,147,129,98,86,59,52,19,686,71,757,9.379128137384413
27070,330600805000084,109,116,131,101,88,74,35,27,619,62,681,9.104258443465492
27071,330600805000085,122,119,156,130,80,72,46,18,679,64,743,8.613728129205922
27072,330600805000086,22,20,19,20,18,13,5,4,112,9,121,7.43801652892562
27073,330600805000087,67,74,65,68,48,49,23,16,371,39,410,9.512195121951219
27074,330600805000088,188,205,178,131,116,90,50,33,908,83,991,8.375378405650858
27075,330600805000089,8,11,4,8,4,7,6,3,42,9,51,17.647058823529413
27077,330600805000091,77,103,74,70,63,53,39,28,440,67,507,13.214990138067062
27078,330600805000092,24,26,25,23,21,15,8,3,134,11,145,7.586206896551724
27079,330600805000093,8,9,15,6,15,7,6,3,60,9,69,13.043478260869565
27080,330600805000095,3,1,2,7,4,1,2,0,18,2,20,10.0
27082,330600805000098,31,27,50,49,42,48,22,27,247,49,296,16.554054054054053
27083,330600805000099,26,42,29,39,62,38,25,43,236,68,304,22.36842105263158
27084,330600805000100,0,0,0,0,0,0,12,24,0,36,36,100.0
27085,330600805000101,49,55,59,86,88,80,48,52,417,100,517,19.342359767891683
27086,330600805000102,2,0,1,1,0,3,17,38,7,55,62,88.70967741935483
27087,330600805000103,80,79,83,92,82,68,23,35,484,58,542,10.70110701107011
27088,330600805000104,114,146,125,117,125,91,38,17,718,55,773,7.115135834411384
27089,330600805000105,54,64,81,75,71,81,35,42,426,77,503,15.308151093439363
27090,330600805000106,44,51,72,48,54,65,36,27,334,63,397,15.869017632241814
27091,330600805000107,42,47,54,59,45,47,24,25,294,49,343,14.285714285714286
27092,330600805000108,30,24,30,35,28,28,22,13,175,35,210,16.666666666666668
27093,330600805000109,122,107,109,112,69,61,40,34,580,74,654,11.314984709480122
27094,330600805000110,78,93,107,87,161,96,51,35,622,86,708,12.146892655367232
27095,330600805000111,137,193,151,148,118,64,37,21,811,58,869,6.67433831990794
27096,330600805000112,79,87,104,96,80,54,31,20,500,51,551,9.255898366606171
27097,330600805000113,66,91,71,76,66,51,20,11,421,31,452,6.8584070796460175
27098,330600805000114,68,124,103,100,113,62,58,32,570,90,660,13.636363636363637
27099,330600805000115,187,205,194,153,128,85,56,23,952,79,1031,7.662463627546072
27100,330600805000116,68,97,92,73,77,64,43,17,471,60,531,11.299435028248588
27101,330600805000117,81,94,71,59,50,37,13,10,392,23,415,5.542168674698795
27102,330600805000118,105,140,123,107,121,71,42,44,667,86,753,11.420982735723772
27103,330600805000119,81,87,84,96,89,55,33,21,492,54,546,9.89010989010989
27105,330600805000121,83,116,61,52,57,35,11,8,404,19,423,4.491725768321513
27106,330600805000122,82,53,71,67,52,41,25,18,366,43,409,10.513447432762836
27107,330600820000001,137,149,154,143,123,74,71,50,780,121,901,13.429522752497226
27108,330600820000002,86,97,94,101,78,67,41,33,523,74,597,12.39530988274707
27109,330600820000003,37,34,45,36,29,22,16,12,203,28,231,12.121212121212121
27110,330600820000004,41,51,44,39,26,22,11,14,223,25,248,10.080645161290322
27111,330600820000005,83,74,78,84,75,60,44,39,454,83,537,15.456238361266294
27112,330600820000006,47,65,33,45,54,19,11,6,263,17,280,6.071428571428571
27113,330600820000007,64,95,50,58,51,39,17,19,357,36,393,9.16030534351145
27114,330600820000008,72,63,54,62,41,36,13,9,328,22,350,6.285714285714286
27115,330600820000009,32,39,36,23,40,16,19,12,186,31,217,14.285714285714286
27116,330610705000001,18,36,36,28,51,38,28,54,207,82,289,28.37370242214533
27117,330610705000002,42,46,82,57,75,70,49,69,372,118,490,24.081632653061224
27118,330610705000003,48,72,105,78,92,77,75,84,472,159,631,25.198098256735342
27119,330610705000004,60,68,79,89,64,62,80,54,422,134,556,24.100719424460433
27120,330610705000005,58,81,85,66,86,56,34,39,432,73,505,14.455445544554456
27121,330610705000006,59,91,92,97,98,98,67,102,535,169,704,24.005681818181817
27122,330610705000007,38,64,111,49,55,77,56,81,394,137,531,25.800376647834273
27123,330610705000008,45,63,91,87,85,71,50,51,442,101,543,18.60036832412523
27124,330610705000009,88,129,160,128,149,123,67,80,777,147,924,15.909090909090908
27125,330610705000010,43,64,60,60,61,97,61,61,385,122,507,24.06311637080868
27126,330610705000011,48,64,84,63,73,88,59,75,420,134,554,24.187725631768952
27127,330610705000012,51,83,108,73,98,99,106,133,512,239,751,31.824234354194406
27128,330610705000013,56,69,125,80,85,77,69,88,492,157,649,24.19106317411402
27129,330610705000014,64,100,65,105,90,95,72,86,519,158,677,23.338257016248154
27130,330610705000015,8,24,29,19,35,31,15,31,146,46,192,23.958333333333332
27131,330610705000016,66,95,116,88,103,114,78,75,582,153,735,20.816326530612244
27132,330610705000017,110,139,165,158,148,113,75,133,833,208,1041,19.980787704130645
27133,330610705000018,49,71,67,85,75,67,64,61,414,125,539,23.19109461966605
27134,330610705000019,34,45,55,39,64,44,34,48,281,82,363,22.58953168044077
27135,330610705000020,43,68,81,63,58,70,46,52,383,98,481,20.374220374220375
27136,330610705000021,117,125,134,89,104,80,52,43,649,95,744,12.768817204301076
27137,330610705000022,65,100,95,74,85,97,38,68,516,106,622,17.041800643086816
27138,330610705000023,156,200,155,138,162,130,68,27,941,95,1036,9.16988416988417
27139,330610705000024,55,52,56,42,52,33,27,23,290,50,340,14.705882352941176
27140,330610705000025,158,218,176,173,180,118,79,58,1023,137,1160,11.810344827586206
27141,330610705000026,46,62,64,76,67,65,44,31,380,75,455,16.483516483516482
27142,330610705000027,83,112,97,95,107,77,42,36,571,78,649,12.01848998459168
27143,330610705000028,217,242,200,196,182,120,67,54,1157,121,1278,9.4679186228482
27144,330610705000029,46,85,61,65,58,54,22,24,369,46,415,11.08433734939759
27145,330610705000030,54,84,80,59,83,47,27,30,407,57,464,12.28448275862069
27146,330610705000031,121,169,153,173,179,118,83,49,913,132,1045,12.631578947368421
27147,330610705000032,109,147,161,155,200,111,87,39,883,126,1009,12.487611496531219
27148,330610705000033,208,262,182,212,146,115,64,39,1125,103,1228,8.387622149837133
27149,330610705000034,101,115,92,85,61,65,41,24,519,65,584,11.13013698630137
27150,330610705000035,65,83,93,83,76,97,44,41,497,85,582,14.604810996563574
27151,330610705000036,53,81,82,74,69,82,43,43,441,86,527,16.31878557874763
27152,330610705000037,82,102,110,82,84,85,49,22,545,71,616,11.525974025974026
27153,330610705000038,123,176,163,155,141,104,79,54,862,133,995,13.366834170854272
27154,330610705000039,97,178,121,111,135,95,77,70,737,147,884,16.6289592760181
27155,330610705000040,90,94,84,66,90,56,35,17,480,52,532,9.774436090225564
27156,330610705000041,156,134,128,115,84,86,53,37,703,90,793,11.349306431273645
27157,330610705000042,99,115,101,118,96,55,49,25,584,74,658,11.246200607902736
27158,330610705000043,130,170,155,135,138,92,50,52,820,102,922,11.062906724511931
27159,330610705000044,101,125,102,111,73,62,43,33,574,76,650,11.692307692307692
27160,330610705000045,152,179,166,156,115,89,48,26,857,74,931,7.9484425349087005
27161,330610705000046,119,122,111,123,107,70,55,63,652,118,770,15.324675324675324
27162,330610705000047,108,141,154,172,130,169,93,66,874,159,1033,15.392061955469506
27163,330610705000048,41,58,63,47,70,49,55,61,328,116,444,26.126126126126128
27164,330610705000049,79,89,122,136,89,91,80,47,606,127,733,17.32605729877217
27165,330610705000050,45,66,59,49,64,61,42,40,344,82,426,19.248826291079812
27166,330610705000051,31,34,42,34,27,40,17,22,208,39,247,15.789473684210526
27167,330610705000052,101,118,138,76,115,99,44,40,647,84,731,11.49110807113543
27168,330610705000053,99,141,128,115,138,119,73,57,740,130,870,14.942528735632184
27169,330610705000054,134,172,142,133,154,119,75,48,854,123,977,12.589559877175025
27170,330610705000055,136,185,166,154,150,121,78,47,912,125,1037,12.054001928640309
27171,330610705000056,152,177,140,148,137,110,60,46,864,106,970,10.927835051546392
27172,330610705000057,57,74,64,67,57,54,28,22,373,50,423,11.82033096926714
27173,330610705000058,96,111,81,105,90,80,60,42,563,102,665,15.338345864661655
27174,330610705000059,267,267,203,184,121,108,56,27,1150,83,1233,6.73154906731549
27175,330610705000060,170,180,199,146,122,120,57,29,937,86,1023,8.406647116324535
27176,330610705000061,50,70,62,71,71,58,33,24,382,57,439,12.984054669703873
27177,330610705000062,125,148,143,134,135,109,60,58,794,118,912,12.93859649122807
27178,330610705000063,59,99,128,103,106,100,70,66,595,136,731,18.6046511627907
27179,330610705000064,37,56,64,52,66,47,57,47,322,104,426,24.413145539906104
27180,330610705000065,83,84,98,74,68,70,45,40,477,85,562,15.124555160142348
27181,330610705000066,82,94,94,68,51,60,44,22,449,66,515,12.815533980582524
27182,330610705000067,63,99,106,119,91,73,56,34,551,90,641,14.0405616224649
27183,330610705000068,113,101,125,115,106,89,77,64,649,141,790,17.848101265822784
27184,330610705000069,22,19,17,19,17,12,7,9,106,16,122,13.114754098360656
27185,330610705000070,35,24,26,27,29,14,17,9,155,26,181,14.3646408839779
27186,330610705000071,49,40,40,28,30,21,20,10,208,30,238,12.605042016806722
27187,330610705000072,47,61,65,48,68,39,27,19,328,46,374,12.29946524064171
27188,330610705000073,154,183,146,135,158,114,64,46,890,110,1000,11.0
27189,330610705000074,12,20,37,18,18,17,18,19,122,37,159,23.270440251572328
27190,330610705000075,25,32,40,29,29,39,30,35,194,65,259,25.096525096525095
27191,330610705000076,70,101,104,66,94,73,68,49,508,117,625,18.72
27192,330610705000077,14,25,23,27,31,28,16,31,148,47,195,24.102564102564102
27193,330610705000078,23,50,40,41,57,33,43,43,244,86,330,26.060606060606062
27194,330610705000079,60,70,86,89,85,87,61,72,477,133,610,21.80327868852459
27195,330610705000080,53,84,111,78,86,91,58,55,503,113,616,18.344155844155843
27196,330610705000081,70,122,83,104,123,81,45,46,583,91,674,13.501483679525222
27197,330610705000082,69,92,58,68,89,57,32,15,433,47,480,9.791666666666666
27198,330610705000083,100,86,101,84,76,67,44,29,514,73,587,12.43611584327087
27199,330610705000084,83,117,94,95,77,84,49,36,550,85,635,13.385826771653543
27200,330610705000085,148,244,175,107,138,101,46,26,913,72,985,7.309644670050761
27201,330610705000086,56,75,55,41,48,50,31,29,325,60,385,15.584415584415584
27202,330610705000087,16,27,29,31,22,26,18,11,151,29,180,16.11111111111111
27203,330610705000088,22,21,26,17,24,14,11,3,124,14,138,10.144927536231885
27204,330610705000089,34,54,32,34,38,27,14,13,219,27,246,10.975609756097562
27205,330610705000090,100,139,108,101,78,39,38,19,565,57,622,9.163987138263666
27206,330610710000001,57,86,85,71,76,73,46,67,448,113,561,20.142602495543674
27207,330610710000002,152,147,125,147,127,88,67,35,786,102,888,11.486486486486486
27208,330610710000003,31,68,53,44,63,48,27,41,307,68,375,18.133333333333333
27209,330610710000004,180,213,172,153,152,113,71,44,983,115,1098,10.473588342440802
27210,330610710000005,67,58,57,42,50,49,24,26,323,50,373,13.404825737265416
27211,330610710000006,41,45,38,16,39,21,8,15,200,23,223,10.31390134529148
27212,330610710000007,14,10,11,5,19,5,5,6,64,11,75,14.666666666666666
27213,330610710000008,49,77,65,51,79,66,37,31,387,68,455,14.945054945054945
27214,330610710000009,56,72,66,54,64,47,28,24,359,52,411,12.652068126520682
27215,330610710000010,27,33,32,31,38,37,21,22,198,43,241,17.842323651452283
27216,330610715000001,42,59,57,58,71,64,41,49,351,90,441,20.408163265306122
27217,330610715000002,25,40,35,34,33,35,44,29,202,73,275,26.545454545454547
27218,330610715000003,106,123,113,101,125,97,75,108,665,183,848,21.580188679245282
27219,330610715000004,118,143,134,114,128,74,50,39,711,89,800,11.125
27220,330610715000005,92,122,96,101,86,70,40,34,567,74,641,11.544461778471138
27221,330610715000006,147,160,117,125,113,63,49,37,725,86,811,10.604192355117139
27222,330610715000007,57,73,31,49,58,45,36,17,313,53,366,14.480874316939891
27223,330610720000001,84,100,100,89,108,95,71,73,576,144,720,20.0
27224,330610720000002,98,141,131,106,125,128,80,49,729,129,858,15.034965034965035
27225,330610720000003,39,58,50,41,27,39,36,15,254,51,305,16.721311475409838
27226,330610725000001,34,43,42,27,39,38,32,26,223,58,281,20.640569395017792
27227,330610725000002,30,34,49,33,37,38,27,9,221,36,257,14.007782101167315
27228,330610725000003,38,64,44,48,45,51,36,17,290,53,343,15.451895043731778
27229,330610725000004,134,119,109,122,86,75,62,39,645,101,746,13.53887399463807
27230,330610730000001,110,109,111,83,94,82,59,72,589,131,720,18.194444444444443
27231,330610730000002,85,114,86,88,78,76,56,61,527,117,644,18.167701863354036
27232,330610730000003,45,48,52,29,39,49,26,15,262,41,303,13.531353135313532
27233,330610730000004,15,37,12,20,25,12,15,15,121,30,151,19.867549668874172
27234,330610730000005,28,23,30,27,31,20,17,15,159,32,191,16.75392670157068
27235,330610730000006,26,29,20,19,23,25,11,10,142,21,163,12.883435582822086
27236,330610730000007,48,58,49,42,29,15,8,10,241,18,259,6.94980694980695
27237,330615605000001,110,112,134,119,137,70,41,40,682,81,763,10.615989515072084
27238,330615605000002,92,116,119,108,86,79,52,57,600,109,709,15.3737658674189
27239,330615605000003,151,132,149,127,109,95,48,44,763,92,855,10.760233918128655
27240,330615605000004,153,168,154,156,136,80,45,48,847,93,940,9.893617021276595
27241,330615605000005,103,67,71,63,56,34,24,21,394,45,439,10.250569476082005
27242,330615605000006,146,129,143,132,103,83,49,35,736,84,820,10.24390243902439
27243,330615605000007,69,69,89,49,37,55,24,11,368,35,403,8.6848635235732
27244,330615605000008,143,170,113,128,109,101,45,36,764,81,845,9.585798816568047
27245,330615605000009,160,123,227,175,150,53,50,32,888,82,970,8.45360824742268
27246,330615605000010,29,76,44,40,51,16,11,3,256,14,270,5.185185185185185
27247,330615605000011,171,147,142,107,79,67,34,26,713,60,773,7.7619663648124195
27248,330615605000012,89,82,71,41,63,40,17,21,386,38,424,8.962264150943396
27249,330615605000013,134,94,138,102,88,67,51,47,623,98,721,13.592233009708737
27250,330615605000014,82,85,90,109,73,54,30,20,493,50,543,9.208103130755065
27251,330620605000001,16,28,56,25,20,18,13,28,163,41,204,20.098039215686274
27252,330620605000002,20,50,159,66,55,33,35,25,383,60,443,13.544018058690744
27253,330620605000003,66,106,134,87,92,73,51,45,558,96,654,14.678899082568808
27254,330620605000004,29,39,63,53,52,34,38,43,270,81,351,23.076923076923077
27255,330620605000005,41,61,64,43,49,56,30,23,314,53,367,14.44141689373297
27256,330620605000006,36,44,71,49,60,54,40,41,314,81,395,20.50632911392405
27257,330620605000007,72,92,160,122,95,121,58,64,662,122,784,15.561224489795919
27258,330620605000008,87,141,178,123,107,89,51,63,725,114,839,13.587604290822407
27259,330620605000009,72,106,106,99,84,88,57,42,555,99,654,15.137614678899082
27260,330620605000010,118,147,127,132,140,88,62,46,752,108,860,12.55813953488372
27261,330620605000011,59,79,105,90,82,62,53,60,477,113,590,19.152542372881356
27262,330620605000012,98,115,134,132,99,88,62,50,666,112,778,14.395886889460154
27263,330620605000013,33,50,53,40,67,36,36,22,279,58,337,17.2106824925816
27264,330620605000014,116,123,172,130,128,99,78,56,768,134,902,14.855875831485587
27265,330620605000015,76,128,146,122,109,125,73,69,706,142,848,16.745283018867923
27266,330620605000016,15,33,31,22,30,30,27,47,161,74,235,31.48936170212766
27267,330620605000017,90,108,108,91,104,69,62,72,570,134,704,19.03409090909091
27268,330620605000018,91,126,123,93,109,107,45,90,649,135,784,17.21938775510204
27269,330620605000019,49,73,82,72,69,52,40,35,397,75,472,15.889830508474576
27270,330620605000020,99,145,128,110,103,78,42,34,663,76,739,10.284167794316645
27271,330620605000021,88,117,83,76,77,66,33,30,507,63,570,11.052631578947368
27272,330620605000022,96,103,120,98,100,75,48,23,592,71,663,10.708898944193061
27273,330620605000023,108,133,164,121,157,111,66,69,794,135,929,14.531754574811625
27274,330620605000024,72,90,99,80,93,67,46,38,501,84,585,14.35897435897436
27275,330620605000025,117,124,165,127,134,117,67,51,784,118,902,13.082039911308204
27276,330620605000026,143,176,121,147,124,78,58,37,789,95,884,10.746606334841628
27277,330620605000027,127,129,123,102,86,88,54,34,655,88,743,11.843876177658142
27278,330620605000028,111,135,125,76,123,76,41,35,646,76,722,10.526315789473685
27279,330620605000029,143,165,169,130,154,111,65,62,872,127,999,12.712712712712714
27280,330620605000030,138,138,236,172,122,107,61,46,913,107,1020,10.490196078431373
27282,330620605000032,110,137,127,101,115,77,58,37,667,95,762,12.46719160104987
27283,330620605000033,136,185,119,131,134,84,52,57,789,109,898,12.138084632516703
27284,330620605000034,173,161,170,157,133,100,79,69,894,148,1042,14.203454894433781
27286,330620605000036,61,76,57,74,56,60,38,29,384,67,451,14.855875831485587
27287,330620605000037,66,61,49,46,47,39,13,7,308,20,328,6.097560975609756
27288,330620605000038,38,63,33,34,43,39,26,16,250,42,292,14.383561643835616
27289,330620605000039,101,132,100,121,82,90,42,33,626,75,701,10.699001426533524
27290,330620605000040,133,171,101,94,76,48,24,23,623,47,670,7.014925373134329
27291,330620605000041,85,103,89,78,77,58,40,17,490,57,547,10.420475319926874
27292,330620605000042,81,132,112,127,112,88,55,42,652,97,749,12.950600801068092
27293,330620605000043,43,68,78,57,71,45,43,38,362,81,443,18.284424379232505
27294,330620605000044,13,20,24,28,25,22,22,24,132,46,178,25.84269662921348
27295,330620605000045,78,86,87,84,76,82,64,64,493,128,621,20.611916264090176
27296,330620605000046,101,109,93,89,74,39,38,23,505,61,566,10.777385159010601
27297,330620605000047,93,112,117,97,70,48,29,25,537,54,591,9.137055837563452
27298,330620605000048,62,74,60,63,58,31,13,5,348,18,366,4.918032786885246
27299,330620610000001,125,173,142,119,160,104,74,66,823,140,963,14.537902388369679
27300,330620610000002,41,44,46,22,26,30,16,9,209,25,234,10.683760683760683
27301,330620610000003,13,6,7,6,3,4,2,2,39,4,43,9.30232558139535
27302,330620610000004,18,26,27,10,8,14,13,10,103,23,126,18.253968253968253
27303,330620610000005,69,86,49,62,53,36,27,23,355,50,405,12.345679012345679
27304,330620610000006,62,88,73,72,67,55,47,42,417,89,506,17.58893280632411
27305,330620630000001,32,54,38,37,40,32,26,19,233,45,278,16.18705035971223
27306,330620630000002,86,99,84,87,62,63,36,20,481,56,537,10.42830540037244
27307,330620630000003,45,60,49,41,46,24,16,9,265,25,290,8.620689655172415
27308,330620630000004,18,19,14,16,6,9,6,4,82,10,92,10.869565217391305
27309,330620635000001,5,8,4,3,5,3,3,5,28,8,36,22.22222222222222
27310,330620635000002,45,36,28,33,21,25,15,12,188,27,215,12.55813953488372
27311,330620635000003,89,123,148,108,97,111,61,60,676,121,797,15.181932245922209
27312,330620635000004,76,102,73,73,99,54,33,25,477,58,535,10.841121495327103
27313,330630505000001,43,67,83,71,77,76,56,40,417,96,513,18.71345029239766
27314,330630505000002,23,48,62,37,52,58,46,34,280,80,360,22.22222222222222
27315,330630505000003,27,50,63,52,68,56,43,36,316,79,395,20.0
27316,330630505000004,42,82,87,50,95,91,55,48,447,103,550,18.727272727272727
27317,330630505000005,50,81,121,89,81,85,45,62,507,107,614,17.42671009771987
27318,330630505000006,26,41,114,61,67,108,68,56,417,124,541,22.920517560073936
27319,330630505000007,39,42,72,70,55,72,57,58,350,115,465,24.731182795698924
27320,330630505000008,60,94,136,92,133,119,78,44,634,122,756,16.137566137566136
27321,330630505000009,32,46,92,88,57,84,67,37,399,104,503,20.675944333996025
27322,330630505000010,6,12,17,15,9,13,2,3,72,5,77,6.4935064935064934
27323,330630505000011,16,19,25,13,8,14,9,6,95,15,110,13.636363636363637
27324,330630505000012,43,75,82,82,104,108,60,98,494,158,652,24.233128834355828
27325,330630505000013,38,57,103,57,99,152,54,89,506,143,649,22.033898305084747
27326,330630505000014,28,43,62,37,61,83,36,71,314,107,421,25.41567695961995
27327,330630505000016,75,94,137,106,124,103,56,41,639,97,736,13.179347826086957
27328,330630505000017,52,88,88,87,115,78,49,60,508,109,617,17.66612641815235
27329,330630505000018,54,73,78,59,101,64,52,61,429,113,542,20.84870848708487
27330,330630505000019,74,93,107,103,124,126,69,94,627,163,790,20.632911392405063
27331,330630505000020,42,66,91,83,85,80,54,33,447,87,534,16.292134831460675
27332,330630505000021,50,91,89,88,95,99,57,63,512,120,632,18.9873417721519
27333,330630505000022,36,72,89,74,80,84,55,45,435,100,535,18.69158878504673
27334,330630505000023,41,52,68,68,67,87,47,42,383,89,472,18.85593220338983
27335,330630505000024,77,108,162,130,139,129,84,76,745,160,905,17.679558011049725
27336,330630505000025,58,127,145,122,153,128,97,87,733,184,917,20.065430752453654
27337,330630505000026,81,73,127,115,117,113,70,49,626,119,745,15.973154362416107
27338,330630505000027,75,94,131,125,123,135,75,35,683,110,793,13.871374527112232
27339,330630505000029,66,82,109,142,100,98,58,57,597,115,712,16.151685393258425
27340,330630505000030,60,104,97,105,111,97,67,50,574,117,691,16.931982633863964
27341,330630505000032,20,43,49,30,46,33,19,3,221,22,243,9.053497942386832
27342,330630505000033,89,129,146,139,154,148,103,80,805,183,988,18.522267206477732
27343,330630505000034,27,55,48,34,53,61,33,38,278,71,349,20.34383954154728
27344,330630505000035,63,92,119,84,106,75,38,52,539,90,629,14.308426073131956
27345,330630505000037,69,80,160,131,102,162,119,54,704,173,877,19.726339794754846
27346,330630505000038,89,147,199,133,165,236,108,40,969,148,1117,13.24977618621307
27347,330630505000040,74,115,125,95,103,109,53,52,621,105,726,14.462809917355372
27348,330630505000041,76,93,111,115,108,92,40,39,595,79,674,11.72106824925816
27349,330630505000042,25,26,33,22,23,22,8,4,151,12,163,7.361963190184049
27350,330630505000043,18,22,15,27,22,27,11,9,131,20,151,13.245033112582782
27351,330630505000044,65,79,96,82,116,87,55,32,525,87,612,14.215686274509803
27352,330630505000045,49,85,143,98,100,113,63,64,588,127,715,17.762237762237763
27353,330630505000046,44,66,54,38,49,33,17,11,284,28,312,8.974358974358974
27354,330630505000047,54,74,92,86,109,74,36,27,489,63,552,11.41304347826087
27355,330630505000048,164,169,146,192,227,161,60,43,1059,103,1162,8.864027538726335
27356,330630505000049,89,105,123,120,142,133,82,89,712,171,883,19.365798414496037
27357,330630505000050,21,37,42,29,37,38,23,16,204,39,243,16.049382716049383
27358,330630505000051,62,66,106,86,92,60,55,41,472,96,568,16.901408450704224
27359,330630505000052,58,75,146,96,74,105,59,48,554,107,661,16.187594553706504
27360,330630505000053,40,67,110,82,85,121,47,48,505,95,600,15.833333333333334
27361,330630505000054,50,53,67,82,68,76,40,27,396,67,463,14.47084233261339
27362,330630505000055,23,45,103,47,54,77,44,20,349,64,413,15.49636803874092
27363,330630505000056,77,92,99,107,82,102,43,42,559,85,644,13.198757763975156
27364,330630505000057,61,88,62,71,59,45,20,14,386,34,420,8.095238095238095
27365,330630505000058,17,23,21,13,21,12,8,3,107,11,118,9.322033898305085
27366,330630505000059,12,27,35,33,40,45,20,17,192,37,229,16.157205240174672
27367,330630505000060,77,98,126,100,108,124,63,61,633,124,757,16.380449141347423
27368,330630505000061,34,47,65,64,78,76,57,51,364,108,472,22.88135593220339
27369,330630505000062,65,95,107,91,110,104,59,89,572,148,720,20.555555555555557
27370,330630505000063,118,139,183,135,179,141,87,74,895,161,1056,15.246212121212121
27371,330630505000064,203,217,185,156,147,113,52,24,1021,76,1097,6.927985414767548
27372,330630505000065,0,0,0,0,0,3,18,75,3,93,96,96.875
27373,330630505000066,75,136,187,116,148,174,88,99,836,187,1023,18.27956989247312
27374,330630505000067,25,42,67,45,63,61,54,39,303,93,396,23.484848484848484
27375,330630505000068,38,71,87,74,89,95,56,57,454,113,567,19.929453262786595
27376,330630505000069,81,91,149,117,123,138,89,76,699,165,864,19.09722222222222
27377,330630505000070,66,58,127,91,76,115,74,78,533,152,685,22.18978102189781
27378,330630505000071,26,57,99,66,72,103,61,54,423,115,538,21.37546468401487
27379,330630505000072,51,82,116,89,124,148,93,130,610,223,833,26.770708283313326
27380,330630505000073,47,56,82,85,64,68,57,57,402,114,516,22.093023255813954
27381,330630505000080,32,51,83,64,77,95,82,149,402,231,633,36.492890995260666
27382,330630505000081,65,98,113,77,101,136,58,61,590,119,709,16.784203102961918
27383,330630505000082,62,128,154,108,172,189,95,132,813,227,1040,21.826923076923077
27384,330630505000083,64,132,141,95,151,149,86,136,732,222,954,23.270440251572328
27385,330630505000084,32,59,95,50,79,91,49,84,406,133,539,24.675324675324674
27386,330630505000085,76,113,150,136,154,203,90,129,832,219,1051,20.837297811607993
27387,330630505000086,46,80,89,49,87,104,70,86,455,156,611,25.53191489361702
27388,330630505000087,17,78,65,52,88,105,79,135,405,214,619,34.5718901453958
27389,330630505000088,37,107,118,62,108,170,94,140,602,234,836,27.99043062200957
27390,330630505000089,6,39,43,18,46,66,41,111,218,152,370,41.08108108108108
27391,330630505000090,30,46,64,41,62,58,18,45,301,63,364,17.307692307692307
27392,330630505000091,24,48,72,43,60,62,54,53,309,107,416,25.721153846153847
27393,330630505000093,42,82,106,70,120,123,58,67,543,125,668,18.7125748502994
27394,330630505000094,57,85,74,64,95,82,33,55,457,88,545,16.146788990825687
27395,330630505000095,43,77,121,67,106,131,84,92,545,176,721,24.410540915395284
27396,330630505000096,61,99,109,83,140,107,80,103,599,183,782,23.40153452685422
27397,330630505000097,41,57,81,59,66,100,66,71,404,137,541,25.32347504621072
27398,330630505000098,59,70,110,82,113,120,61,92,554,153,707,21.64073550212164
27399,330630505000099,23,41,29,36,28,27,6,10,184,16,200,8.0
27400,330630505000100,69,124,155,126,135,149,92,122,758,214,972,22.016460905349795
27401,330630505000101,69,109,115,91,167,135,76,106,686,182,868,20.967741935483872
27402,330630505000102,91,116,123,81,133,101,42,67,645,109,754,14.456233421750664
27403,330630505000103,93,108,117,94,88,76,38,28,576,66,642,10.280373831775702
27404,330630505000104,25,34,57,28,30,33,18,19,207,37,244,15.163934426229508
27405,330630505000105,24,26,20,7,10,6,7,1,93,8,101,7.920792079207921
27406,330630505000106,86,105,118,119,112,116,93,51,656,144,800,18.0
27407,330630505000107,38,44,48,33,33,21,16,11,217,27,244,11.065573770491802
27408,330630505000108,63,90,111,107,90,78,66,35,539,101,640,15.78125
27409,330630505000109,7,12,10,7,4,11,6,4,51,10,61,16.39344262295082
27410,330630505000110,43,56,70,62,72,52,30,27,355,57,412,13.83495145631068
27411,330630505000111,64,112,100,123,113,98,58,63,610,121,731,16.55266757865937
27412,330630505000112,54,102,108,67,113,98,69,70,542,139,681,20.411160058737153
27413,330630505000113,52,54,81,56,79,70,51,39,392,90,482,18.672199170124482
27414,330630505000114,93,83,101,92,81,92,45,45,542,90,632,14.240506329113924
27415,330630505000115,64,61,87,56,72,79,39,40,419,79,498,15.863453815261044
27416,330630505000116,72,116,109,81,105,86,49,47,569,96,665,14.436090225563909
27417,330630505000117,38,31,27,20,19,14,6,6,149,12,161,7.453416149068323
27418,330630505000118,26,37,54,35,55,50,20,22,257,42,299,14.046822742474916
27419,330630505000119,92,97,140,98,101,116,66,52,644,118,762,15.485564304461942
27420,330630505000120,27,49,54,40,68,44,28,29,282,57,339,16.8141592920354
27421,330630505000121,60,90,88,78,86,62,29,38,464,67,531,12.617702448210922
27422,330630505000122,68,79,78,74,96,76,32,25,471,57,528,10.795454545454545
27423,330630505000123,32,46,49,29,52,48,15,24,256,39,295,13.220338983050848
27424,330630505000124,76,97,113,93,76,96,38,41,551,79,630,12.53968253968254
27425,330630505000125,29,36,70,41,41,61,33,25,278,58,336,17.261904761904763
27426,330630505000126,59,68,78,64,65,69,34,26,403,60,463,12.958963282937365
27427,330630505000127,12,10,15,5,9,9,2,5,60,7,67,10.447761194029852
27428,330630505000128,84,96,143,71,134,93,60,61,621,121,742,16.307277628032345
27429,330630505000129,65,76,72,65,73,55,28,25,406,53,459,11.546840958605664
27430,330630505000130,94,113,120,104,141,136,64,84,708,148,856,17.289719626168225
27431,330630505000131,9,22,37,19,26,28,13,9,141,22,163,13.496932515337424
27432,330630505000132,64,77,124,104,96,86,47,41,551,88,639,13.77151799687011
27433,330630505000133,59,84,123,89,116,102,76,61,573,137,710,19.295774647887324
27434,330630505000134,74,66,79,71,57,65,30,20,412,50,462,10.822510822510823
27435,330630505000135,80,95,125,103,91,108,50,26,602,76,678,11.2094395280236
27436,330630505000136,56,76,120,108,68,141,106,36,569,142,711,19.971870604781998
27437,330630505000137,67,111,114,91,107,90,62,36,580,98,678,14.454277286135694
27439,330630505000139,56,72,71,63,84,70,40,27,416,67,483,13.871635610766045
27440,330630505000140,86,99,164,92,130,118,67,56,689,123,812,15.147783251231527
27441,330630505000141,68,111,95,90,116,81,39,41,561,80,641,12.480499219968799
27442,330630505000143,67,117,129,91,103,94,43,27,601,70,671,10.432190760059612
27443,330630505000144,9,23,20,8,21,7,2,1,88,3,91,3.2967032967032965
27444,330630505000145,101,123,135,86,86,76,44,28,607,72,679,10.603829160530191
27445,330630505000146,2,1,4,4,1,3,4,0,15,4,19,21.05263157894737
27446,330630505000147,107,133,159,130,91,104,56,30,724,86,810,10.617283950617283
27447,330630505000148,108,160,129,170,115,74,58,34,756,92,848,10.849056603773585
27448,330630505000149,131,164,124,157,97,84,48,23,757,71,828,8.57487922705314
27449,330630505000150,161,167,204,189,134,139,71,28,994,99,1093,9.057639524245197
27450,330630505000151,18,27,22,19,26,14,7,11,126,18,144,12.5
27451,330630505000152,139,142,207,173,110,104,56,45,875,101,976,10.348360655737705
27452,330630505000153,82,87,141,88,87,88,51,27,573,78,651,11.981566820276498
27453,330630505000154,114,135,135,123,115,88,43,33,710,76,786,9.669211195928753
27454,330630505000155,102,105,96,96,102,63,24,24,564,48,612,7.8431372549019605
27455,330630505000156,50,64,50,43,35,12,8,10,254,18,272,6.617647058823529
27456,330630505000157,67,64,52,48,34,34,17,8,299,25,324,7.716049382716049
27457,330630505000158,134,183,178,186,169,118,77,55,968,132,1100,12.0
27458,330630505000159,40,72,72,56,74,50,26,20,364,46,410,11.21951219512195
27459,330630505000160,162,185,229,176,164,124,50,30,1040,80,1120,7.142857142857143
27460,330630505000161,158,174,195,168,131,120,55,29,946,84,1030,8.155339805825243
27461,330630505000162,96,117,119,109,75,74,36,27,590,63,653,9.647779479326188
27462,330630505000163,125,129,160,153,119,112,57,45,798,102,900,11.333333333333334
27463,330630505000164,127,156,176,152,140,92,60,34,843,94,937,10.032017075773746
27464,330630505000165,60,80,80,61,52,46,22,10,379,32,411,7.785888077858881
27465,330630505000166,39,49,66,47,44,38,13,7,283,20,303,6.600660066006601
27466,330630505000167,61,62,87,54,58,41,42,12,363,54,417,12.949640287769784
27467,330630505000169,48,58,77,43,52,38,17,10,316,27,343,7.871720116618076
27468,330630505000170,7,6,7,8,6,4,1,1,38,2,40,5.0
27469,330630505000171,72,87,60,60,58,38,21,11,375,32,407,7.862407862407863
27470,330630505000172,223,242,211,159,128,96,41,29,1059,70,1129,6.200177147918512
27471,330630505000173,194,217,217,156,142,93,56,31,1019,87,1106,7.8661844484629295
27472,330630505000174,154,195,209,141,140,94,39,29,933,68,1001,6.793206793206793
27473,330630505000175,139,176,186,125,128,95,54,21,849,75,924,8.116883116883116
27474,330630505000176,32,34,49,44,25,26,16,6,210,22,232,9.482758620689655
27475,330630505000177,12,20,18,17,10,6,13,2,83,15,98,15.306122448979592
27476,330630505000178,31,27,31,28,22,12,9,1,151,10,161,6.211180124223603
27477,330630505000179,66,79,59,71,65,41,18,14,381,32,413,7.74818401937046
27478,330630505000180,22,28,31,24,18,11,5,7,134,12,146,8.219178082191782
27479,330630505000181,44,33,44,38,36,25,23,17,220,40,260,15.384615384615385
27480,330630505000182,11,13,20,23,16,9,5,4,92,9,101,8.910891089108912
27481,330630505000183,27,31,21,16,13,8,7,3,116,10,126,7.936507936507937
27482,330630505000184,82,113,127,93,99,93,42,37,607,79,686,11.51603498542274
27483,330630505000185,39,87,54,52,64,47,13,13,343,26,369,7.046070460704607
27484,330630505000186,60,42,62,46,33,33,17,4,276,21,297,7.070707070707071
27485,330630505000187,84,100,111,97,95,86,46,52,573,98,671,14.605067064083457
27486,330630505000188,97,108,135,136,104,107,56,27,687,83,770,10.779220779220779
27487,330630505000189,40,38,45,42,40,40,19,18,245,37,282,13.120567375886525
27488,330630505000190,54,84,82,80,93,71,32,34,464,66,530,12.452830188679245
27489,330630505000191,88,116,140,100,144,130,33,44,718,77,795,9.685534591194969
27490,330630505000192,133,133,150,136,137,119,52,42,808,94,902,10.42128603104213
27491,330630505000193,54,69,93,70,76,77,31,37,439,68,507,13.41222879684418
27492,330630505000194,35,55,80,60,65,76,37,24,371,61,432,14.12037037037037
27493,330630505000195,35,30,38,38,21,24,18,7,186,25,211,11.848341232227488
27494,330630505000196,65,71,95,80,95,89,48,35,495,83,578,14.359861591695502
27495,330630505000197,93,108,172,131,121,147,44,24,772,68,840,8.095238095238095
27496,330630505000198,114,116,197,124,134,141,67,47,826,114,940,12.127659574468085
27497,330630505000199,18,29,37,27,26,37,25,5,174,30,204,14.705882352941176
27498,330630505000200,96,112,135,157,112,102,63,40,714,103,817,12.607099143206854
27499,330630505000201,76,123,127,109,140,117,69,48,692,117,809,14.46229913473424
27500,330630505000202,80,123,159,144,140,156,74,63,802,137,939,14.589989350372736
27501,330630505000203,54,61,92,70,80,72,40,51,429,91,520,17.5
27502,330630505000204,75,90,85,79,105,74,50,28,508,78,586,13.310580204778157
27503,330630505000205,90,140,144,124,132,111,63,34,741,97,838,11.575178997613365
27504,330630505000206,70,121,118,109,110,92,75,33,620,108,728,14.835164835164836
27505,330630505000207,31,41,51,48,39,24,25,14,234,39,273,14.285714285714286
27506,330630505000208,67,65,71,52,43,26,24,12,324,36,360,10.0
27507,330630505000209,3,1,3,5,2,3,2,3,17,5,22,22.727272727272727
27508,330630505000210,66,69,99,72,102,85,31,40,493,71,564,12.588652482269504
27509,330630505000211,77,102,101,90,87,91,42,48,548,90,638,14.106583072100314
27510,330630505000212,58,85,75,67,88,66,33,45,439,78,517,15.087040618955513
27511,330630505000213,42,34,41,45,32,25,17,6,219,23,242,9.50413223140496
27512,330630505000214,15,20,19,12,18,8,7,2,92,9,101,8.910891089108912
27513,330630505000215,80,99,101,109,109,113,42,45,611,87,698,12.464183381088825
27514,330630505000216,74,109,126,124,117,102,53,45,652,98,750,13.066666666666666
27515,330630505000217,17,23,21,11,20,8,5,7,100,12,112,10.714285714285714
27516,330630505000218,41,48,30,42,27,24,12,5,212,17,229,7.423580786026201
27517,330630505000219,41,51,55,29,55,59,14,39,290,53,343,15.451895043731778
27518,330630505000220,61,92,118,89,86,92,27,43,538,70,608,11.513157894736842
27519,330630505000221,69,76,83,89,75,66,47,13,458,60,518,11.583011583011583
27520,330630505000222,38,34,29,34,16,20,7,6,171,13,184,7.065217391304348
27521,330630505000223,67,120,152,101,136,125,84,60,701,144,845,17.041420118343197
27522,330630505000224,39,81,82,56,105,88,38,51,451,89,540,16.48148148148148
27523,330630505000227,51,56,95,64,62,71,29,43,399,72,471,15.286624203821656
27524,330630505000228,39,68,91,81,79,66,46,48,424,94,518,18.146718146718147
27525,330630505000229,101,137,126,164,141,93,71,52,762,123,885,13.898305084745763
27526,330630505000230,20,26,23,22,16,20,5,2,127,7,134,5.223880597014926
27527,330630505000231,50,84,100,80,88,84,53,37,486,90,576,15.625
27528,330630505000232,72,91,102,86,93,79,57,36,523,93,616,15.097402597402597
27529,330630505000233,73,104,121,91,109,92,25,24,590,49,639,7.668231611893583
27530,330630505000234,74,104,113,107,129,126,62,55,653,117,770,15.194805194805195
27531,330630505000235,36,30,47,30,34,28,15,8,205,23,228,10.087719298245615
27532,330630505000239,58,62,55,59,48,22,23,13,304,36,340,10.588235294117647
27533,330630505000240,14,29,16,20,19,7,9,9,105,18,123,14.634146341463415
27534,330630505000241,77,92,54,67,40,34,23,7,364,30,394,7.614213197969543
27535,330630505000242,163,206,205,161,157,163,67,43,1055,110,1165,9.44206008583691
27536,330630505000243,42,71,48,60,74,50,48,40,345,88,433,20.323325635103927
27537,330630505000245,146,155,155,195,167,133,61,39,951,100,1051,9.514747859181732
27538,330630505000246,99,146,149,139,177,133,89,72,843,161,1004,16.03585657370518
27539,330630505000247,67,88,131,104,96,129,47,42,615,89,704,12.642045454545455
27540,330630505000248,143,164,202,183,163,188,102,73,1043,175,1218,14.367816091954023
27541,330630505000250,51,43,43,57,35,37,26,6,266,32,298,10.738255033557047
27542,330630505000251,122,100,80,89,84,65,22,14,540,36,576,6.25
27543,330630505000252,72,82,74,56,53,42,20,13,379,33,412,8.009708737864077
27544,330630505000253,72,87,132,115,126,105,58,56,637,114,751,15.179760319573901
27545,330630505000254,17,23,35,22,22,28,4,9,147,13,160,8.125
27546,330630505000255,25,34,20,15,20,12,8,5,126,13,139,9.352517985611511
27547,330630505000256,140,174,174,169,158,129,59,44,944,103,1047,9.837631327602674
27548,330630505000258,51,69,60,57,56,46,28,15,339,43,382,11.256544502617801
27549,330630505000259,103,132,145,125,119,112,61,40,736,101,837,12.066905615292711
27550,330630505000260,97,118,135,119,90,111,53,20,670,73,743,9.825033647375506
27551,330630505000261,90,118,143,154,135,171,110,82,811,192,1003,19.14257228315055
27552,330630505000262,82,97,118,81,86,64,23,24,528,47,575,8.173913043478262
27553,330630505000264,46,52,54,37,43,32,11,18,264,29,293,9.897610921501707
27554,330630505000265,72,86,124,72,91,77,44,34,522,78,600,13.0
27555,330630505000266,109,128,107,92,87,78,37,25,601,62,663,9.351432880844646
27556,330630505000267,66,59,137,102,44,157,70,17,565,87,652,13.343558282208589
27557,330630505000268,93,77,150,126,63,182,81,23,691,104,795,13.081761006289309
27558,330630505000269,107,79,115,129,63,144,67,18,637,85,722,11.772853185595569
27559,330630505000270,88,84,126,162,58,163,67,18,681,85,766,11.096605744125327
27560,330630505000271,70,87,105,91,87,72,43,36,512,79,591,13.367174280879865
27561,330630505000272,131,176,133,134,149,91,33,19,814,52,866,6.0046189376443415
27562,330630505000273,144,167,123,145,103,103,31,20,785,51,836,6.100478468899522
27563,330630505000274,81,133,187,125,143,188,67,41,857,108,965,11.191709844559586
27564,330630505000275,44,45,57,50,47,50,14,21,293,35,328,10.670731707317072
27565,330630505000276,140,133,155,146,131,104,69,47,809,116,925,12.54054054054054
27566,330630505000277,113,157,139,117,153,95,50,48,774,98,872,11.238532110091743
27567,330630505000278,95,99,91,151,108,86,89,57,630,146,776,18.814432989690722
27568,330630505000279,59,98,89,81,90,83,77,53,500,130,630,20.634920634920636
27569,330630505000280,64,77,105,93,67,82,31,19,488,50,538,9.293680297397769
27570,330630505000281,33,28,41,28,31,17,14,11,178,25,203,12.31527093596059
27571,330630505000282,52,88,83,62,83,49,21,17,417,38,455,8.351648351648352
27572,330630505000283,75,93,85,98,93,58,46,39,502,85,587,14.480408858603067
27573,330630505000284,20,28,22,16,20,12,7,9,118,16,134,11.940298507462687
27574,330630505000285,101,180,147,128,177,115,50,16,848,66,914,7.2210065645514225
27575,330630505000286,82,165,129,94,190,86,38,21,746,59,805,7.329192546583851
27576,330630505000287,108,178,159,158,172,114,33,15,889,48,937,5.122732123799359
27577,330630505000288,102,141,160,134,150,109,32,19,796,51,847,6.02125147579693
27578,330630505000290,41,54,37,36,27,14,10,4,209,14,223,6.278026905829597
27579,330630505000291,55,73,85,64,94,71,21,28,442,49,491,9.979633401221996
27580,330630505000292,128,107,83,157,107,61,22,10,643,32,675,4.7407407407407405
27581,330630505000293,110,111,89,154,131,85,23,18,680,41,721,5.6865464632454925
27582,330630505000294,76,130,119,109,117,101,54,48,652,102,754,13.52785145888594
27583,330630505000295,79,111,103,92,89,73,38,39,547,77,624,12.33974358974359
27584,330630505000296,27,52,49,36,47,33,27,21,244,48,292,16.438356164383563
27585,330630505000297,80,94,115,82,84,72,30,32,527,62,589,10.526315789473685
27586,330630505000298,150,168,199,135,152,132,71,37,936,108,1044,10.344827586206897
27587,330630505000299,61,54,60,52,38,26,15,8,291,23,314,7.32484076433121
27588,330630505000300,143,187,190,138,107,93,37,19,858,56,914,6.12691466083151
27589,330630505000301,97,104,139,100,87,73,25,23,600,48,648,7.407407407407407
27590,330630505000302,221,266,218,191,178,108,36,14,1182,50,1232,4.058441558441558
27591,330630505000303,58,68,55,55,32,13,7,0,281,7,288,2.4305555555555554
27592,330630505000304,23,26,20,23,15,5,4,1,112,5,117,4.273504273504273
27593,330630505000305,38,38,49,33,43,35,16,8,236,24,260,9.23076923076923
27594,330630505000306,42,38,38,27,27,15,9,1,187,10,197,5.0761421319796955
27595,330630505000307,19,34,26,18,21,13,7,6,131,13,144,9.027777777777779
27596,330630505000308,53,72,68,106,82,38,25,9,419,34,453,7.50551876379691
27597,330630505000309,49,74,66,63,70,62,37,38,384,75,459,16.33986928104575
27598,330630505000310,33,56,69,59,50,60,28,26,327,54,381,14.173228346456693
27599,330630505000311,88,96,106,95,117,94,48,40,596,88,684,12.865497076023392
27600,330630505000312,58,106,135,87,120,103,82,52,609,134,743,18.0349932705249
27601,330630505000313,70,63,99,79,62,65,29,30,438,59,497,11.87122736418511
27602,330630505000314,10,20,10,19,21,10,14,5,90,19,109,17.431192660550458
27603,330630505000316,28,16,43,33,25,29,18,7,174,25,199,12.56281407035176
27604,330630505000317,32,16,31,28,20,12,12,10,139,22,161,13.664596273291925
27605,330630505000318,105,132,172,135,131,112,66,41,787,107,894,11.968680089485458
27606,330630505000319,101,159,136,142,122,114,66,45,774,111,885,12.542372881355933
27607,330630505000320,51,58,61,55,52,31,28,11,308,39,347,11.239193083573488
27608,330630505000321,81,113,121,85,99,87,43,37,586,80,666,12.012012012012011
27609,330630505000322,81,109,94,128,92,96,64,33,600,97,697,13.916786226685796
27610,330630505000323,100,151,160,149,143,124,64,38,827,102,929,10.979547900968784
27611,330630505000324,76,140,170,95,154,151,44,23,786,67,853,7.854630715123095
27612,330630505000325,102,130,163,124,117,145,64,30,781,94,875,10.742857142857142
27613,330630505000326,71,81,99,76,97,65,33,34,489,67,556,12.050359712230216
27614,330630505000327,141,202,185,160,131,110,51,21,929,72,1001,7.192807192807193
27615,330630505000328,105,91,133,100,93,101,61,39,623,100,723,13.831258644536653
27616,330630505000329,79,131,137,135,132,121,73,55,735,128,863,14.831981460023176
27617,330630505000330,78,121,82,82,85,50,35,7,498,42,540,7.777777777777778
27618,330630505000331,59,57,48,89,74,25,8,10,352,18,370,4.864864864864865
27619,330630505000332,49,79,105,90,105,103,41,28,531,69,600,11.5
27620,330630505000333,87,181,139,93,230,129,19,17,859,36,895,4.022346368715084
27621,330630505000334,58,87,141,97,78,196,64,18,657,82,739,11.096075778078484
27622,330630505000335,41,79,143,89,67,185,98,22,604,120,724,16.574585635359117
27623,330630505000336,63,71,74,91,99,67,109,52,465,161,626,25.71884984025559
27624,330630505000337,71,142,125,143,194,86,138,112,761,250,1011,24.727992087042534
27625,330630505000338,72,108,64,91,114,87,16,11,536,27,563,4.7957371225577266
27626,330630505000339,88,129,89,102,122,88,24,4,618,28,646,4.3343653250774
27627,330630505000340,94,114,100,146,140,91,25,21,685,46,731,6.292749658002736
27628,330630505000341,129,140,143,174,155,88,36,24,829,60,889,6.749156355455568
27629,330630505000342,101,142,101,171,157,83,39,19,755,58,813,7.134071340713407
27630,330630505000343,95,129,88,126,143,57,24,10,638,34,672,5.059523809523809
27631,330630505000344,106,124,89,153,165,69,28,9,706,37,743,4.979811574697174
27632,330630505000345,92,163,144,101,188,135,28,31,823,59,882,6.6893424036281175
27633,330630505000346,89,173,168,126,182,136,31,23,874,54,928,5.818965517241379
27634,330630505000347,86,99,98,97,108,72,22,18,560,40,600,6.666666666666667
27635,330630505000348,90,150,138,101,187,118,34,34,784,68,852,7.981220657276995
27636,330630505000349,67,99,103,75,117,92,22,17,553,39,592,6.587837837837838
27637,330630505000350,72,118,132,131,182,120,137,133,755,270,1025,26.341463414634145
27638,330630505000351,90,146,141,128,151,160,136,108,816,244,1060,23.0188679245283
27639,330630505000352,170,218,204,205,162,115,86,50,1074,136,1210,11.239669421487603
27640,330630505000353,30,36,31,40,21,17,14,10,175,24,199,12.06030150753769
27641,330630505000354,136,193,112,142,98,72,30,22,753,52,805,6.459627329192546
27642,330630505000355,106,137,167,140,87,113,57,32,750,89,839,10.607866507747318
27643,330630505000356,146,171,182,193,117,126,91,40,935,131,1066,12.288930581613508
27644,330630505000357,103,96,100,121,68,70,39,17,558,56,614,9.120521172638437
27645,330630505000358,156,184,177,170,167,96,67,43,950,110,1060,10.377358490566039
27646,330630505000359,46,74,67,52,49,35,15,5,323,20,343,5.830903790087463
27647,330630505000360,114,136,135,143,109,103,48,18,740,66,806,8.188585607940446
27648,330630505000361,179,200,207,221,134,168,93,47,1109,140,1249,11.20896717373899
27649,330630505000362,60,80,72,73,55,35,26,17,375,43,418,10.287081339712918
27650,330630505000363,65,83,73,73,56,53,38,12,403,50,453,11.037527593818984
27651,330630505000364,180,236,218,166,142,104,51,24,1046,75,1121,6.6904549509366635
27652,330630505000365,32,30,27,21,13,12,5,3,135,8,143,5.594405594405594
27653,330630505000366,155,217,210,200,152,154,69,59,1088,128,1216,10.526315789473685
27654,330630505000367,22,36,33,28,19,21,12,5,159,17,176,9.659090909090908
27655,330630505000368,20,21,14,24,16,11,6,1,106,7,113,6.1946902654867255
27656,330630505000369,65,67,76,61,53,45,27,20,367,47,414,11.352657004830919
27657,330630505000370,111,131,128,110,95,84,38,29,659,67,726,9.228650137741047
27658,330630505000371,170,139,122,120,78,51,24,6,680,30,710,4.225352112676056
27659,330630505000372,261,286,273,263,169,128,55,32,1380,87,1467,5.930470347648262
27660,330630505000373,24,39,30,35,31,15,10,8,174,18,192,9.375
27661,330630505000374,78,99,86,86,80,55,22,9,484,31,515,6.019417475728155
27662,330630505000375,17,27,22,34,16,24,15,5,140,20,160,12.5
27663,330630505000376,50,73,62,46,58,59,26,21,348,47,395,11.89873417721519
27664,330630505000377,65,85,86,67,71,60,45,20,434,65,499,13.026052104208416
27665,330630505000378,3,9,3,6,2,2,4,0,25,4,29,13.793103448275861
27666,330630505000379,49,94,90,81,81,80,35,30,475,65,540,12.037037037037036
27667,330630505000380,65,96,102,84,77,66,32,35,490,67,557,12.028725314183124
27668,330630505000381,68,62,72,95,36,49,27,15,382,42,424,9.90566037735849
27669,330630505000382,37,49,51,41,47,46,39,12,271,51,322,15.838509316770187
27670,330630505000383,45,71,81,58,70,54,33,18,379,51,430,11.86046511627907
27671,330630505000384,23,17,24,33,18,19,12,10,134,22,156,14.102564102564102
27672,330630505000385,16,16,16,20,12,15,8,8,95,16,111,14.414414414414415
27673,330630505000386,88,101,91,98,60,59,32,11,497,43,540,7.962962962962963
27674,330630505000387,143,188,153,164,128,105,84,55,881,139,1020,13.627450980392156
27675,330630505000388,60,45,61,75,52,36,38,26,329,64,393,16.28498727735369
27676,330630505000389,20,45,46,24,38,26,14,4,199,18,217,8.294930875576037
27677,330630505000390,143,120,133,108,97,69,34,20,670,54,724,7.458563535911602
27678,330630505000391,88,88,68,88,37,37,19,13,406,32,438,7.30593607305936
27679,330630505000392,118,122,98,96,83,83,29,18,600,47,647,7.2642967542503865
27680,330630505000393,40,68,49,45,52,45,19,13,299,32,331,9.667673716012084
27681,330630505000394,21,25,29,22,21,21,10,5,139,15,154,9.74025974025974
27682,330630505000395,29,48,41,38,39,24,22,8,219,30,249,12.048192771084338
27683,330630505000396,113,154,122,105,105,82,35,21,681,56,737,7.598371777476255
27684,330630505000397,156,195,170,144,132,79,46,18,876,64,940,6.808510638297872
27685,330630505000398,59,107,70,52,77,38,23,17,403,40,443,9.029345372460497
27686,330630505000399,206,227,233,175,147,136,75,37,1124,112,1236,9.06148867313916
27688,330630505000402,34,46,34,33,26,17,12,8,190,20,210,9.523809523809524
27689,330630505000403,45,59,52,43,41,25,8,13,265,21,286,7.3426573426573425
27691,330630505000405,98,126,111,93,72,63,26,10,563,36,599,6.010016694490818
27693,330630505000407,171,217,212,179,152,149,77,49,1080,126,1206,10.447761194029852
27694,330630505000408,164,241,192,185,151,112,60,37,1045,97,1142,8.493870402802102
27695,330630505000409,100,118,147,110,116,95,54,45,686,99,785,12.611464968152866
27696,330630505000410,0,0,0,0,1,3,2,33,4,35,39,89.74358974358974
27697,330630505000411,6,12,8,11,14,5,4,6,56,10,66,15.151515151515152
27698,330630505000412,191,240,233,182,157,158,64,42,1161,106,1267,8.366219415943172
27699,330630505000413,69,101,90,98,104,57,35,25,519,60,579,10.362694300518134
27700,330630505000414,86,90,113,78,84,53,37,25,504,62,566,10.954063604240282
27701,330630505000415,138,113,180,144,115,131,67,33,821,100,921,10.857763300760043
27702,330630505000416,100,104,118,104,91,74,47,28,591,75,666,11.26126126126126
27703,330630505000417,58,58,97,53,65,62,31,19,393,50,443,11.286681715575622
27704,330630505000418,62,109,152,76,121,160,37,33,680,70,750,9.333333333333334
27705,330630505000419,90,152,170,104,130,161,70,45,807,115,922,12.472885032537961
27706,330630505000420,171,186,179,124,151,106,35,17,917,52,969,5.366357069143447
27707,330630505000421,205,260,226,193,162,116,52,34,1162,86,1248,6.891025641025641
27708,330630505000422,80,93,138,96,84,81,50,25,572,75,647,11.591962905718702
27709,330630505000423,95,109,144,102,98,120,50,25,668,75,743,10.094212651413189
27710,330630505000424,129,140,181,142,103,103,45,27,798,72,870,8.275862068965518
27711,330630505000425,48,74,68,54,84,46,16,16,374,32,406,7.8817733990147785
27712,330630505000426,109,158,131,80,93,95,30,15,666,45,711,6.329113924050633
27713,330630505000427,80,79,108,106,49,72,31,21,494,52,546,9.523809523809524
27714,330630505000428,82,129,134,78,140,133,48,22,696,70,766,9.138381201044387
27715,330630505000429,18,21,21,14,13,8,8,5,95,13,108,12.037037037037036
27716,330630505000430,5,10,0,0,0,0,0,0,15,0,15,0.0
27717,330630505000432,6,18,19,8,12,4,3,7,67,10,77,12.987012987012987
27718,330630505000433,3,6,3,4,2,7,1,1,25,2,27,7.407407407407407
27719,330630505000434,2,4,1,1,4,1,1,0,13,1,14,7.142857142857143
27720,330630505000435,5,6,2,6,5,1,7,1,25,8,33,24.242424242424242
27721,330630505000437,12,10,9,6,5,5,5,4,47,9,56,16.071428571428573
27722,330630505000438,1,4,5,6,3,8,12,4,27,16,43,37.2093023255814
27723,330630505000444,47,79,74,73,73,53,34,25,399,59,458,12.882096069868995
27724,330630505000446,34,41,27,30,23,16,11,6,171,17,188,9.042553191489361
27725,330630505000447,16,31,23,26,20,15,16,11,131,27,158,17.088607594936708
27726,330630505000448,125,149,128,113,92,90,33,34,697,67,764,8.769633507853403
27727,330630505000449,49,69,65,57,46,42,35,18,328,53,381,13.910761154855644
27728,330630505000450,21,21,24,12,12,14,4,4,104,8,112,7.142857142857143
27729,330630505000451,14,28,16,14,15,18,6,6,105,12,117,10.256410256410257
27730,330630505000452,28,32,66,59,64,48,43,30,297,73,370,19.72972972972973
27731,330630505000453,11,13,19,12,19,18,8,13,92,21,113,18.58407079646018
27732,330630505000454,33,70,109,76,78,68,30,21,434,51,485,10.515463917525773
27733,330630505000455,42,39,83,84,54,48,25,17,350,42,392,10.714285714285714
27734,330630505000456,204,245,134,271,324,137,41,18,1315,59,1374,4.294032023289665
27735,330630505000457,114,130,124,147,180,152,55,50,847,105,952,11.029411764705882
27736,330630505000458,45,66,75,69,60,64,27,32,379,59,438,13.470319634703197
27737,330630505000459,22,47,53,47,61,74,24,52,304,76,380,20.0
27739,330630505000461,22,15,23,21,7,10,6,5,98,11,109,10.091743119266056
27740,330630505000463,98,129,79,83,90,63,26,10,542,36,578,6.228373702422146
27741,330630505000464,58,67,41,55,54,33,12,5,308,17,325,5.230769230769231
27742,330630505000465,68,81,95,92,62,54,50,26,452,76,528,14.393939393939394
27743,330630505000466,26,28,24,28,36,16,18,8,158,26,184,14.130434782608695
27744,330630505000467,45,58,73,66,49,54,29,15,345,44,389,11.311053984575835
27745,330630505000468,19,15,45,29,20,28,17,16,156,33,189,17.46031746031746
27747,330630505000470,2,4,2,5,1,3,2,2,17,4,21,19.047619047619047
27748,330630505000471,9,7,10,6,10,13,7,5,55,12,67,17.91044776119403
27749,330630505000472,26,30,73,74,49,47,19,44,299,63,362,17.403314917127073
27750,330630505000473,20,18,44,51,25,37,16,13,195,29,224,12.946428571428571
27752,330630505000475,17,16,24,8,14,10,7,2,89,9,98,9.183673469387756
27753,330630505000476,88,129,98,111,114,96,35,31,636,66,702,9.401709401709402
27754,330630505000477,8,8,11,11,8,8,5,2,54,7,61,11.475409836065573
27755,330630505000479,93,133,159,134,128,117,38,23,764,61,825,7.393939393939394
27756,330630505000480,44,58,80,43,48,41,22,19,314,41,355,11.549295774647888
27757,330630505000481,150,142,128,212,136,85,45,17,853,62,915,6.775956284153006
27758,330630505000482,40,62,59,63,56,48,44,21,328,65,393,16.53944020356234
27759,330630505000483,207,160,127,318,224,103,27,21,1139,48,1187,4.043807919123841
27761,330630505000485,19,23,21,22,18,11,9,3,114,12,126,9.523809523809524
27762,330630505000486,5,6,5,5,3,10,5,2,34,7,41,17.073170731707318
27763,330630505000487,12,31,40,20,34,25,11,5,162,16,178,8.98876404494382
27764,330630505000488,84,126,93,85,108,54,37,19,550,56,606,9.24092409240924
27765,330630505000489,31,43,28,28,21,12,15,2,163,17,180,9.444444444444445
27766,330630505000490,257,319,274,214,181,125,50,42,1370,92,1462,6.292749658002736
27767,330630505000491,235,300,235,197,172,115,54,25,1254,79,1333,5.926481620405101
27768,330630505000492,115,173,213,187,200,170,55,36,1058,91,1149,7.919930374238469
